year,district,dname,region,LANGUAGE,GRADE,rla_docs,rla_all_unsatgl_nm,rla_all_approgl_nm,rla_all_meetsgl_nm,rla_all_mastrgl_nm,m_docs,m_all_unsatgl_nm,m_all_approgl_nm,m_all_meetsgl_nm,m_all_mastrgl_nm
23,1902,CAYUGA ISD,7,english,3,35,7,28,16,4,35,12,23,17,3
23,1903,ELKHART ISD,7,english,3,85,20,65,40,8,85,29,56,30,9
23,1904,FRANKSTON ISD,7,english,3,62,6,56,28,5,62,7,55,41,9
23,1906,NECHES ISD,7,english,3,19,2,17,7,3,19,7,12,8,1
23,1907,PALESTINE ISD,7,english,3,214,65,149,77,18,226,76,150,77,23
23,1908,WESTWOOD ISD,7,english,3,109,50,59,30,8,109,52,57,28,7
23,1909,SLOCUM ISD,7,english,3,22,9,13,7,1,21,8,13,5,1
23,2901,ANDREWS ISD,18,english,3,269,59,210,123,34,282,71,211,112,30
23,3801,PINEYWOODS COMM,7,english,3,87,18,69,34,9,87,27,60,38,10
23,3902,HUDSON ISD,7,english,3,192,24,168,106,43,194,31,163,101,46
23,3903,LUFKIN ISD,7,english,3,504,120,384,233,77,506,166,340,190,67
23,3904,HUNTINGTON ISD,7,english,3,129,39,90,51,11,129,54,75,21,9
23,3905,DIBOLL ISD,7,english,3,107,19,88,49,15,107,32,75,32,10
23,3906,ZAVALLA ISD,7,english,3,17,2,15,11,3,17,4,13,8,2
23,3907,CENTRAL ISD,7,english,3,115,23,92,62,16,115,25,90,53,12
23,4901,ARANSAS COUNTY,2,english,3,215,92,123,66,21,215,94,121,58,19
23,5901,ARCHER CITY ISD,9,english,3,36,0,36,32,14,36,1,35,28,12
23,5902,HOLLIDAY ISD,9,english,3,78,7,71,47,26,78,15,63,33,14
23,5904,WINDTHORST ISD,9,english,3,34,4,30,23,3,34,2,32,24,10
23,6902,CLAUDE ISD,16,english,3,32,5,27,21,9,32,4,28,16,6
23,7901,CHARLOTTE ISD,20,english,3,39,15,24,13,2,39,15,24,13,2
23,7902,JOURDANTON ISD,20,english,3,104,27,77,46,15,103,31,72,34,13
23,7904,LYTLE ISD,20,english,3,137,53,84,38,6,137,64,73,20,9
23,7905,PLEASANTON ISD,20,english,3,225,73,152,83,34,227,51,176,88,31
23,7906,POTEET ISD,20,english,3,112,31,81,47,6,111,40,71,33,10
23,8901,BELLVILLE ISD,6,english,3,135,32,103,69,21,135,36,99,63,26
23,8902,SEALY ISD,6,english,3,164,37,127,80,28,184,60,124,72,29
23,8903,BRAZOS ISD,6,english,3,55,20,35,23,3,55,25,30,11,2
23,9901,MULESHOE ISD,17,english,3,100,28,72,39,18,100,26,74,37,12
23,10901,MEDINA ISD,20,english,3,14,4,10,4,2,14,5,9,4,0
23,10902,BANDERA ISD,20,english,3,161,48,113,68,23,162,70,92,46,18
23,11901,BASTROP ISD,13,english,3,846,296,550,306,106,848,341,507,246,75
23,11902,ELGIN ISD,13,english,3,288,98,190,87,33,380,156,224,80,18
23,11904,SMITHVILLE ISD,13,english,3,123,28,95,57,23,122,28,94,62,13
23,11905,MCDADE ISD,13,english,3,24,12,12,7,1,24,11,13,8,5
23,12901,SEYMOUR ISD,9,english,3,41,2,39,27,5,41,4,37,20,4
23,13801,ST MARY'S ACADE,2,english,3,51,8,43,22,9,51,12,39,16,7
23,13901,BEEVILLE ISD,2,english,3,203,49,154,86,25,203,60,143,81,38
23,13902,PAWNEE ISD,2,english,3,11,1,10,8,0,11,1,10,8,2
23,13903,PETTUS ISD,2,english,3,23,5,18,10,2,23,6,17,9,5
23,13905,SKIDMORE-TYNAN,2,english,3,63,23,40,24,11,63,21,42,25,8
23,14803,PRIORITY CHARTE,12,english,3,34,10,24,15,4,34,12,22,8,5
23,14804,ORENDA CHARTER,12,english,3,145,18,127,101,39,149,24,125,93,49
23,14901,ACADEMY ISD,12,english,3,136,21,115,75,22,137,40,97,51,21
23,14902,BARTLETT ISD,13,english,3,37,18,19,7,1,37,16,21,9,3
23,14903,BELTON ISD,12,english,3,969,203,766,486,171,1006,301,705,397,163
23,14905,HOLLAND ISD,12,english,3,47,6,41,29,14,47,3,44,30,10
23,14906,KILLEEN ISD,12,english,3,3201,798,2403,1440,479,3195,942,2253,1204,455
23,14907,ROGERS ISD,12,english,3,61,10,51,30,7,61,11,50,30,14
23,14908,SALADO ISD,12,english,3,152,28,124,74,24,153,38,115,75,26
23,14909,TEMPLE ISD,12,english,3,581,174,407,250,87,613,217,396,223,91
23,14910,TROY ISD,12,english,3,123,29,94,53,17,123,21,102,60,19
23,15802,GEORGE GERVIN A,20,english,3,28,17,11,3,1,28,19,9,1,0
23,15806,LEGACY TRADITIO,20,english,3,79,22,57,30,6,77,28,49,20,3
23,15807,SOUTHWEST PREPA,20,english,3,67,27,40,16,2,68,44,24,9,1
23,15808,INSPIRE ACADEMI,20,english,3,46,12,34,19,7,44,17,27,16,7
23,15809,BEXAR COUNTY AC,20,english,3,23,11,12,9,0,22,7,15,5,1
23,15815,HERITAGE ACADEM,20,english,3,9,5,4,2,1,9,6,3,1,1
23,15822,JUBILEE ACADEMI,20,english,3,512,196,316,163,50,510,212,298,130,43
23,15825,LIGHTHOUSE PUBL,20,english,3,33,13,20,4,1,33,19,14,5,1
23,15827,SCHOOL OF SCIEN,20,english,3,360,69,291,212,87,361,98,263,152,61
23,15828,HARMONY PUBLIC,20,english,3,278,96,182,103,39,281,105,176,84,36
23,15830,BROOKS ACADEMIE,20,english,3,226,59,167,91,29,228,89,139,67,24
23,15831,SCHOOL OF SCIEN,20,english,3,518,101,417,269,114,520,160,360,196,91
23,15834,BASIS TEXAS,20,english,3,552,34,518,424,227,552,49,503,389,230
23,15835,GREAT HEARTS TE,20,english,3,1026,182,844,579,197,1026,250,776,478,196
23,15836,ELEANOR KOLITZ,20,english,3,62,2,60,41,20,61,6,55,35,19
23,15838,COMPASS ROSE PU,20,english,3,245,105,140,62,8,241,100,141,64,15
23,15839,PROMESA ACADEMY,20,english,3,44,22,22,12,4,44,25,19,5,1
23,15841,THE GATHERING P,20,english,3,91,52,39,17,3,96,62,34,9,1
23,15842,ROYAL PUBLIC SC,20,english,3,48,21,27,17,3,48,25,23,9,1
23,15843,PRELUDE PREPARA,20,english,3,6,1,5,2,1,6,4,2,1,1
23,15844,ESSENCE PREPARA,20,english,3,12,5,7,2,0,12,7,5,2,0
23,15901,ALAMO HEIGHTS I,20,english,3,307,33,274,218,86,308,42,266,184,97
23,15904,HARLANDALE ISD,20,english,3,672,247,425,199,46,649,274,375,153,34
23,15905,EDGEWOOD ISD,20,english,3,421,219,202,85,19,509,267,242,89,19
23,15906,RANDOLPH FIELD,20,english,3,109,8,101,77,30,110,11,99,69,36
23,15907,SAN ANTONIO ISD,20,english,3,2524,1087,1437,758,258,2502,1220,1282,596,182
23,15908,SOUTH SAN ANTON,20,english,3,443,203,240,100,32,445,213,232,82,21
23,15909,SOMERSET ISD,20,english,3,240,47,193,121,53,267,54,213,134,46
23,15910,NORTH EAST ISD,20,english,3,3331,652,2679,1862,790,3302,893,2409,1502,684
23,15911,EAST CENTRAL IS,20,english,3,682,273,409,215,63,683,308,375,167,45
23,15912,SOUTHWEST ISD,20,english,3,867,263,604,370,116,865,316,549,279,96
23,15913,LACKLAND ISD,20,english,3,85,17,68,44,10,85,20,65,37,19
23,15914,FT SAM HOUSTON,20,english,3,124,14,110,86,37,124,19,105,70,32
23,15915,NORTHSIDE ISD,20,english,3,6540,1574,4966,3112,1002,6512,1966,4546,2657,1094
23,15916,JUDSON ISD,20,english,3,1688,546,1142,627,188,1684,694,990,483,161
23,15917,SOUTHSIDE ISD,20,english,3,309,96,213,114,31,308,81,227,121,43
23,16901,JOHNSON CITY IS,13,english,3,35,3,32,21,3,35,6,29,17,3
23,16902,BLANCO ISD,13,english,3,82,39,43,18,6,81,36,45,21,5
23,17901,BORDEN COUNTY I,17,english,3,16,3,13,9,2,16,2,14,9,2
23,18901,CLIFTON ISD,12,english,3,60,7,53,35,17,60,25,35,15,2
23,18902,MERIDIAN ISD,12,english,3,26,5,21,12,4,26,5,21,7,3
23,18903,MORGAN ISD,12,english,3,12,8,4,3,0,12,5,7,3,1
23,18904,VALLEY MILLS IS,12,english,3,44,8,36,17,2,44,11,33,14,1
23,18905,WALNUT SPRINGS,12,english,3,9,5,4,1,0,9,5,4,0,0
23,18906,IREDELL ISD,12,english,3,11,1,10,4,0,11,2,9,1,1
23,18907,KOPPERL ISD,12,english,3,13,4,9,4,1,13,2,11,8,2
23,18908,CRANFILLS GAP I,12,english,3,8,1,7,4,1,9,2,7,3,0
23,19901,DEKALB ISD,8,english,3,51,8,43,29,10,52,13,39,20,7
23,19902,HOOKS ISD,8,english,3,61,7,54,38,12,61,4,57,37,19
23,19903,MAUD ISD,8,english,3,33,5,28,17,8,33,9,24,18,5
23,19905,NEW BOSTON ISD,8,english,3,80,28,52,24,3,80,36,44,18,6
23,19906,REDWATER ISD,8,english,3,64,6,58,42,15,64,10,54,37,14
23,19907,TEXARKANA ISD,8,english,3,427,143,284,178,63,454,165,289,143,57
23,19908,LIBERTY-EYLAU I,8,english,3,147,57,90,50,15,147,38,109,69,29
23,19909,SIMMS ISD,8,english,3,22,1,21,15,2,23,0,23,14,4
23,19910,MALTA ISD,8,english,3,25,6,19,12,3,25,5,20,10,5
23,19911,RED LICK ISD,8,english,3,68,1,67,57,27,68,2,66,60,31
23,19912,PLEASANT GROVE,8,english,3,165,13,152,108,29,163,15,148,116,50
23,19913,HUBBARD ISD,8,english,3,0,,,,,,,,,
23,19914,LEARY ISD,8,english,3,9,1,8,5,1,9,3,6,2,0
23,20901,ALVIN ISD,4,english,3,2029,378,1651,1144,484,2055,488,1567,1020,480
23,20902,ANGLETON ISD,4,english,3,506,70,436,303,109,510,109,401,247,98
23,20904,DANBURY ISD,4,english,3,46,3,43,23,5,45,4,41,32,13
23,20905,BRAZOSPORT ISD,4,english,3,800,144,656,431,153,829,148,681,404,173
23,20906,SWEENY ISD,4,english,3,142,31,111,56,13,139,29,110,52,26
23,20907,COLUMBIA-BRAZOR,4,english,3,215,53,162,101,31,215,62,153,82,24
23,20908,PEARLAND ISD,4,english,3,1428,184,1244,980,514,1433,207,1226,898,489
23,20910,DAMON ISD,4,english,3,7,0,7,4,0,7,2,5,1,0
23,21803,BRAZOS SCHOOL F,6,english,3,27,11,16,11,5,27,12,15,6,1
23,21805,ARROW ACADEMY,6,english,3,95,23,72,44,12,95,28,67,37,14
23,21901,COLLEGE STATION,6,english,3,1015,232,783,530,230,1006,224,782,503,259
23,21902,BRYAN ISD,6,english,3,1106,313,793,454,155,1105,306,799,459,168
23,22004,TERLINGUA CSD,18,english,3,5,4,1,1,0,5,5,0,0,0
23,22901,ALPINE ISD,18,english,3,56,12,44,24,3,56,24,32,16,3
23,22902,MARATHON ISD,18,english,3,5,1,4,4,0,5,0,5,2,0
23,23902,SILVERTON ISD,16,english,3,10,2,8,7,5,10,2,8,6,5
23,24901,BROOKS COUNTY I,1,english,3,86,38,48,25,7,88,45,43,27,9
23,25901,BANGS ISD,15,english,3,46,6,40,28,14,46,4,42,29,7
23,25902,BROWNWOOD ISD,15,english,3,251,53,198,116,40,250,53,197,123,49
23,25904,BLANKET ISD,15,english,3,6,1,5,2,0,6,3,3,2,0
23,25905,MAY ISD,15,english,3,19,3,16,9,0,19,8,11,7,1
23,25906,ZEPHYR ISD,15,english,3,18,1,17,11,0,18,1,17,6,1
23,25908,BROOKESMITH ISD,15,english,3,10,4,6,3,0,10,5,5,1,0
23,25909,EARLY ISD,15,english,3,83,9,74,45,14,83,16,67,43,12
23,26901,CALDWELL ISD,6,english,3,142,38,104,64,27,141,34,107,58,25
23,26902,SOMERVILLE ISD,6,english,3,45,20,25,11,0,45,25,20,4,2
23,26903,SNOOK ISD,6,english,3,54,20,34,23,6,54,20,34,17,5
23,27903,BURNET CISD,13,english,3,229,72,157,85,18,230,83,147,63,19
23,27904,MARBLE FALLS IS,13,english,3,248,63,185,111,33,278,78,200,112,43
23,28902,LOCKHART ISD,13,english,3,361,93,268,163,51,371,108,263,125,41
23,28903,LULING ISD,13,english,3,123,31,92,54,24,123,25,98,57,29
23,28906,PRAIRIE LEA ISD,13,english,3,16,12,4,1,0,16,9,7,1,0
23,29901,CALHOUN COUNTY,3,english,3,244,39,205,146,62,244,43,201,137,45
23,30901,CROSS PLAINS IS,14,english,3,21,1,20,13,1,21,2,19,11,5
23,30902,CLYDE CISD,14,english,3,97,34,63,37,9,96,37,59,27,10
23,30903,BAIRD ISD,14,english,3,25,3,22,13,1,25,6,19,8,5
23,30906,EULA ISD,14,english,3,40,6,34,23,6,40,7,33,18,5
23,31901,BROWNSVILLE ISD,1,english,3,2209,482,1727,1145,498,2208,506,1702,1083,432
23,31903,HARLINGEN CISD,1,english,3,1088,318,770,478,178,1088,346,742,410,167
23,31905,LA FERIA ISD,1,english,3,171,33,138,90,28,170,33,137,75,30
23,31906,LOS FRESNOS CIS,1,english,3,660,121,539,390,191,659,127,532,353,136
23,31909,POINT ISABEL IS,1,english,3,128,30,98,62,21,129,34,95,41,14
23,31911,RIO HONDO ISD,1,english,3,115,39,76,47,12,115,48,67,36,7
23,31912,SAN BENITO CISD,1,english,3,614,172,442,265,91,617,167,450,224,75
23,31913,SANTA MARIA ISD,1,english,3,26,5,21,12,1,26,9,17,12,7
23,31914,SANTA ROSA ISD,1,english,3,47,22,25,13,5,47,23,24,10,0
23,32902,PITTSBURG ISD,8,english,3,183,47,136,68,21,183,63,120,38,9
23,33901,GROOM ISD,16,english,3,7,1,6,2,0,7,0,7,4,1
23,33902,PANHANDLE ISD,16,english,3,53,9,44,37,22,53,15,38,25,8
23,33904,WHITE DEER ISD,16,english,3,27,3,24,14,3,27,4,23,9,2
23,34901,ATLANTA ISD,8,english,3,137,19,118,79,31,139,27,112,78,33
23,34902,AVINGER ISD,8,english,3,10,2,8,6,3,10,3,7,6,1
23,34903,HUGHES SPRINGS,8,english,3,68,13,55,28,9,68,28,40,17,6
23,34905,LINDEN-KILDARE,8,english,3,42,20,22,12,6,42,17,25,12,5
23,34906,MCLEOD ISD,8,english,3,31,2,29,18,3,29,1,28,23,8
23,34907,QUEEN CITY ISD,8,english,3,68,12,56,34,15,70,10,60,44,22
23,34909,BLOOMBURG ISD,8,english,3,18,4,14,9,2,18,9,9,5,2
23,35901,DIMMITT ISD,16,english,3,78,34,44,12,0,78,51,27,11,3
23,35902,HART ISD,16,english,3,14,2,12,7,1,14,4,10,2,0
23,35903,NAZARETH ISD,16,english,3,15,2,13,12,7,15,1,14,11,7
23,36901,ANAHUAC ISD,4,english,3,118,49,69,25,3,117,54,63,18,3
23,36902,BARBERS HILL IS,4,english,3,599,39,560,454,231,597,59,538,398,213
23,36903,EAST CHAMBERS I,5,english,3,111,19,92,53,15,111,12,99,74,34
23,37901,ALTO ISD,7,english,3,41,13,28,18,5,41,13,28,16,3
23,37904,JACKSONVILLE IS,7,english,3,244,57,187,121,44,338,74,264,139,61
23,37907,RUSK ISD,7,english,3,129,20,109,66,18,130,25,105,60,18
23,37908,NEW SUMMERFIELD,7,english,3,38,1,37,24,8,38,14,24,8,2
23,37909,WELLS ISD,7,english,3,12,3,9,6,3,12,3,9,2,1
23,38901,CHILDRESS ISD,16,english,3,61,14,47,27,10,61,15,46,29,10
23,39902,HENRIETTA ISD,9,english,3,76,14,62,33,12,76,34,42,16,5
23,39903,PETROLIA CISD,9,english,3,34,11,23,9,1,34,15,19,5,2
23,39904,BELLEVUE ISD,9,english,3,14,2,12,4,1,14,3,11,5,0
23,39905,MIDWAY ISD,9,english,3,8,2,6,5,2,8,3,5,2,1
23,40901,MORTON ISD,17,english,3,26,9,17,12,0,26,6,20,13,4
23,40902,WHITEFACE CISD,17,english,3,23,14,9,4,0,23,7,16,6,3
23,41901,BRONTE ISD,15,english,3,18,4,14,9,1,18,4,14,6,2
23,41902,ROBERT LEE ISD,15,english,3,16,5,11,9,3,16,4,12,6,4
23,42901,COLEMAN ISD,15,english,3,47,15,32,13,4,47,13,34,17,5
23,42903,SANTA ANNA ISD,15,english,3,21,8,13,7,1,21,9,12,6,2
23,42905,PANTHER CREEK C,15,english,3,9,1,8,5,0,9,2,7,5,0
23,43801,IMAGINE INTERNA,10,english,3,124,8,116,91,43,124,9,115,85,47
23,43802,LONE STAR LANGU,10,english,3,17,0,17,14,8,17,0,17,15,11
23,43901,ALLEN ISD,10,english,3,1560,177,1383,1106,537,1559,206,1353,1037,580
23,43902,ANNA ISD,10,english,3,364,83,281,177,49,382,105,277,165,52
23,43903,CELINA ISD,10,english,3,325,49,276,201,62,324,67,257,160,71
23,43904,FARMERSVILLE IS,10,english,3,135,43,92,61,22,137,44,93,49,12
23,43905,FRISCO ISD,10,english,3,4565,405,4160,3344,1766,4576,599,3977,3029,1734
23,43907,MCKINNEY ISD,10,english,3,1550,260,1290,959,385,1569,324,1245,801,387
23,43908,MELISSA ISD,10,english,3,473,52,421,340,182,473,60,413,319,178
23,43910,PLANO ISD,10,english,3,2962,445,2517,1921,979,2941,537,2404,1767,1065
23,43911,PRINCETON ISD,10,english,3,610,131,479,308,119,610,155,455,263,103
23,43912,PROSPER ISD,10,english,3,2162,226,1936,1459,656,2159,279,1880,1420,777
23,43914,WYLIE ISD,10,english,3,1326,117,1209,1005,517,1359,115,1244,982,602
23,43917,BLUE RIDGE ISD,10,english,3,76,15,61,41,10,76,20,56,41,12
23,43918,COMMUNITY ISD,10,english,3,272,67,205,127,44,301,87,214,119,55
23,43919,LOVEJOY ISD,10,english,3,248,11,237,204,122,248,12,236,214,145
23,44902,WELLINGTON ISD,16,english,3,42,9,33,19,6,42,7,35,19,8
23,45902,COLUMBUS ISD,4,english,3,109,29,80,48,20,109,39,70,34,14
23,45903,RICE CISD,3,english,3,71,14,57,33,16,71,18,53,33,10
23,45905,WEIMAR ISD,3,english,3,58,8,50,36,9,58,11,47,34,9
23,46802,TRINITY CHARTER,20,english,3,0,,,,,0,,,,
23,46901,NEW BRAUNFELS I,20,english,3,695,110,585,387,158,713,181,532,311,119
23,46902,COMAL ISD,20,english,3,2045,268,1777,1284,543,2049,324,1725,1239,619
23,47901,COMANCHE ISD,14,english,3,90,16,74,40,10,91,25,66,39,16
23,47902,DE LEON ISD,14,english,3,46,2,44,38,18,46,3,43,27,10
23,47903,GUSTINE ISD,14,english,3,9,5,4,2,0,9,6,3,2,0
23,47905,SIDNEY ISD,14,english,3,10,4,6,2,0,10,5,5,2,0
23,48901,EDEN CISD,15,english,3,15,3,12,6,1,15,2,13,7,1
23,48903,PAINT ROCK ISD,15,english,3,10,2,8,7,2,10,1,9,4,2
23,49901,GAINESVILLE ISD,11,english,3,179,78,101,51,12,207,84,123,53,11
23,49902,MUENSTER ISD,11,english,3,41,1,40,31,17,41,4,37,29,22
23,49903,VALLEY VIEW ISD,11,english,3,52,20,32,17,6,52,14,38,21,8
23,49905,CALLISBURG ISD,11,english,3,86,17,69,37,6,87,15,72,48,11
23,49906,ERA ISD,11,english,3,40,10,30,17,3,40,17,23,7,2
23,49907,LINDSAY ISD,11,english,3,34,3,31,20,6,34,5,29,18,6
23,49908,WALNUT BEND ISD,11,english,3,6,2,4,2,0,6,1,5,2,0
23,49909,SIVELLS BEND IS,11,english,3,0,,,,,0,,,,
23,50901,EVANT ISD,12,english,3,9,3,6,4,2,9,2,7,4,3
23,50902,GATESVILLE ISD,12,english,3,200,34,166,115,36,200,38,162,102,39
23,50904,OGLESBY ISD,12,english,3,12,2,10,2,1,12,7,5,2,0
23,50909,JONESBORO ISD,12,english,3,29,8,21,12,3,29,8,21,9,1
23,50910,COPPERAS COVE I,12,english,3,566,134,432,265,96,565,132,433,270,104
23,51901,PADUCAH ISD,17,english,3,6,3,3,1,0,6,4,2,1,0
23,52901,CRANE ISD,15,english,3,87,24,63,33,7,86,36,50,29,16
23,53001,CROCKETT COUNTY,15,english,3,46,4,42,30,6,46,6,40,19,6
23,54901,CROSBYTON CISD,17,english,3,14,3,11,5,0,14,8,6,1,1
23,54902,LORENZO ISD,17,english,3,9,6,3,2,0,9,6,3,1,0
23,54903,RALLS ISD,17,english,3,22,7,15,3,0,22,14,8,0,0
23,55901,CULBERSON COUNT,18,english,3,25,6,19,10,3,25,10,15,6,1
23,56901,DALHART ISD,16,english,3,133,57,76,45,4,133,58,75,33,2
23,56902,TEXLINE ISD,16,english,3,18,0,18,14,6,18,0,18,15,11
23,57802,PEGASUS SCHOOL,10,english,3,38,19,19,12,1,38,21,17,7,1
23,57803,UPLIFT EDUCATIO,10,english,3,1730,615,1115,631,202,1725,640,1085,571,205
23,57805,LUMIN EDUCATION,10,english,3,27,8,19,7,2,27,12,15,7,2
23,57806,ADVANTAGE ACADE,10,english,3,75,33,42,16,0,74,47,27,12,1
23,57807,LIFE SCHOOL,10,english,3,438,161,277,145,31,440,186,254,111,32
23,57808,UNIVERSAL ACADE,10,english,3,182,32,150,112,49,182,37,145,104,68
23,57809,NOVA ACADEMY,10,english,3,7,2,5,4,0,7,2,5,2,1
23,57810,ACADEMY OF DALL,10,english,3,17,11,6,2,0,17,15,2,1,0
23,57813,TRINITY BASIN P,10,english,3,403,165,238,127,31,405,167,238,101,21
23,57816,A W BROWN LEADE,10,english,3,82,32,50,26,3,81,38,43,17,2
23,57819,JEAN MASSIEU AC,10,english,3,18,8,10,5,0,18,8,10,5,2
23,57827,NOVA ACADEMY SO,10,english,3,36,15,21,12,3,36,14,22,13,8
23,57829,A+ ACADEMY,10,english,3,96,44,52,22,5,96,37,59,22,6
23,57830,INSPIRED VISION,10,english,3,89,45,44,20,3,89,50,39,8,2
23,57831,GATEWAY CHARTER,10,english,3,40,19,21,11,2,37,17,20,6,2
23,57833,EDUCATION CENTE,10,english,3,60,14,46,29,8,60,14,46,29,8
23,57835,GOLDEN RULE CHA,10,english,3,136,21,115,70,21,137,29,108,61,24
23,57836,ST ANTHONY SCHO,10,english,3,35,2,33,19,5,34,7,27,16,10
23,57839,LA ACADEMIA DE,10,english,3,87,22,65,29,4,87,20,67,25,6
23,57841,CITYSCAPE SCHOO,10,english,3,77,29,48,22,7,106,41,65,24,5
23,57844,MANARA ACADEMY,10,english,3,40,17,23,10,0,39,18,21,4,1
23,57845,UME PREPARATORY,10,english,3,122,17,105,69,15,124,34,90,56,25
23,57846,LEGACY PREPARAT,10,english,3,86,35,51,27,6,86,37,49,23,9
23,57847,VILLAGE TECH SC,10,english,3,106,47,59,26,3,106,57,49,16,3
23,57848,INTERNATIONAL L,10,english,3,1903,762,1141,581,160,1900,820,1080,487,173
23,57850,PIONEER TECHNOL,10,english,3,178,31,147,91,30,178,66,112,63,26
23,57851,BRIDGEWAY PREPA,10,english,3,12,5,7,4,0,11,6,5,1,0
23,57903,CARROLLTON-FARM,10,english,3,1451,292,1159,783,355,1749,469,1280,812,353
23,57904,CEDAR HILL ISD,10,english,3,438,124,314,185,64,440,145,295,155,60
23,57905,DALLAS ISD,10,english,3,6115,1747,4368,2863,1110,9331,2924,6407,3823,1454
23,57906,DESOTO ISD,10,english,3,334,118,216,119,40,348,150,198,85,19
23,57907,DUNCANVILLE ISD,10,english,3,533,203,330,157,42,656,280,376,191,56
23,57909,GARLAND ISD,10,english,3,2764,642,2122,1486,657,3492,909,2583,1596,717
23,57910,GRAND PRAIRIE I,10,english,3,1305,339,966,619,257,1714,529,1185,678,263
23,57911,HIGHLAND PARK I,10,english,3,449,4,445,403,274,450,13,437,373,236
23,57912,IRVING ISD,10,english,3,1536,571,965,486,121,1676,683,993,484,140
23,57913,LANCASTER ISD,10,english,3,422,124,298,173,55,438,157,281,132,37
23,57914,MESQUITE ISD,10,english,3,2102,641,1461,831,219,2138,710,1428,802,282
23,57916,RICHARDSON ISD,10,english,3,2497,588,1909,1365,611,2578,719,1859,1244,618
23,57919,SUNNYVALE ISD,10,english,3,164,16,148,119,60,164,36,128,79,32
23,57922,COPPELL ISD,10,english,3,969,105,864,728,419,973,112,861,674,425
23,58902,DAWSON ISD,17,english,3,10,2,8,4,1,10,4,6,2,0
23,58905,KLONDIKE ISD,17,english,3,17,1,16,13,8,17,3,14,9,5
23,58906,LAMESA ISD,17,english,3,92,36,56,24,2,90,45,45,17,5
23,58909,SANDS CISD,17,english,3,19,3,16,10,1,19,3,16,6,2
23,59901,HEREFORD ISD,16,english,3,223,63,160,90,27,223,56,167,90,33
23,59902,WALCOTT ISD,16,english,3,20,0,20,13,6,20,2,18,15,4
23,60902,COOPER ISD,8,english,3,66,20,46,27,9,66,29,37,22,6
23,60914,FANNINDEL ISD,8,english,3,12,7,5,2,1,12,7,5,1,0
23,61802,NORTH TEXAS COL,11,english,3,81,20,61,34,13,81,28,53,26,11
23,61804,LEADERSHIP PREP,10,english,3,100,5,95,77,37,98,4,94,74,46
23,61805,TRIVIUM ACADEMY,11,english,3,65,5,60,50,29,65,8,57,45,20
23,61901,DENTON ISD,11,english,3,2140,485,1655,1087,422,2257,670,1587,931,392
23,61902,LEWISVILLE ISD,11,english,3,3192,519,2673,1946,889,3187,660,2527,1737,905
23,61903,PILOT POINT ISD,11,english,3,91,23,68,41,13,116,45,71,33,11
23,61905,KRUM ISD,11,english,3,180,35,145,87,31,179,42,137,67,20
23,61906,PONDER ISD,11,english,3,132,38,94,57,14,132,41,91,54,13
23,61907,AUBREY ISD,11,english,3,274,49,225,171,69,275,52,223,143,64
23,61908,SANGER ISD,11,english,3,222,46,176,115,45,223,64,159,88,28
23,61910,ARGYLE ISD,11,english,3,414,30,384,306,141,414,55,359,241,112
23,61911,NORTHWEST ISD,11,english,3,2225,397,1828,1288,532,2197,551,1646,1036,430
23,61912,LAKE DALLAS ISD,11,english,3,274,73,201,117,34,276,85,191,102,44
23,61914,LITTLE ELM ISD,11,english,3,586,127,459,310,111,613,163,450,280,129
23,62901,CUERO ISD,3,english,3,125,42,83,35,15,124,42,82,41,11
23,62902,NORDHEIM ISD,3,english,3,11,3,8,6,0,11,6,5,5,2
23,62903,YOAKUM ISD,3,english,3,113,38,75,36,9,112,35,77,37,11
23,62904,YORKTOWN ISD,3,english,3,37,5,32,12,3,37,5,32,13,7
23,62905,WESTHOFF ISD,3,english,3,11,0,11,10,4,11,0,11,10,4
23,62906,MEYERSVILLE ISD,3,english,3,15,2,13,12,5,15,3,12,7,4
23,63903,SPUR ISD,17,english,3,14,3,11,8,2,14,4,10,2,1
23,63906,PATTON SPRINGS,17,english,3,6,2,4,3,2,6,2,4,0,0
23,64903,CARRIZO SPRINGS,20,english,3,145,40,105,58,16,144,41,103,46,13
23,65901,CLARENDON ISD,16,english,3,28,6,22,14,4,28,9,19,14,3
23,65902,HEDLEY ISD,16,english,3,6,0,6,6,5,6,0,6,6,4
23,66005,RAMIREZ CSD,2,english,3,0,,,,,0,,,,
23,66901,BENAVIDES ISD,2,english,3,8,5,3,2,0,8,4,4,1,0
23,66902,SAN DIEGO ISD,2,english,3,112,38,74,41,10,111,50,61,28,7
23,66903,FREER ISD,2,english,3,52,20,32,17,2,52,24,28,15,4
23,67902,CISCO ISD,14,english,3,58,11,47,36,15,58,11,47,25,8
23,67903,EASTLAND ISD,14,english,3,75,6,69,51,22,75,12,63,38,16
23,67904,GORMAN ISD,14,english,3,19,3,16,7,2,19,3,16,8,2
23,67907,RANGER ISD,14,english,3,21,6,15,6,2,21,9,12,4,2
23,67908,RISING STAR ISD,14,english,3,10,5,5,0,0,10,4,6,0,0
23,68802,COMPASS ACADEMY,18,english,3,118,12,106,75,21,118,25,93,62,24
23,68901,ECTOR COUNTY IS,18,english,3,2161,691,1470,851,251,2189,762,1427,743,258
23,69901,ROCKSPRINGS ISD,15,english,3,18,5,13,7,2,18,9,9,3,2
23,69902,NUECES CANYON C,15,english,3,20,10,10,4,2,20,10,10,4,1
23,70801,WAXAHACHIE FAIT,10,english,3,116,55,61,23,4,151,91,60,22,7
23,70901,AVALON ISD,10,english,3,29,6,23,7,0,29,12,17,6,2
23,70903,ENNIS ISD,10,english,3,443,85,358,223,64,444,91,353,213,89
23,70905,FERRIS ISD,10,english,3,152,30,122,71,20,182,56,126,47,12
23,70907,ITALY ISD,10,english,3,39,12,27,16,5,39,11,28,16,5
23,70908,MIDLOTHIAN ISD,10,english,3,737,137,600,402,135,750,161,589,370,162
23,70909,MILFORD ISD,10,english,3,11,5,6,3,0,11,5,6,0,0
23,70910,PALMER ISD,10,english,3,98,16,82,50,24,98,17,81,52,17
23,70911,RED OAK ISD,10,english,3,406,92,314,195,64,419,124,295,169,54
23,70912,WAXAHACHIE ISD,10,english,3,758,162,596,382,122,781,214,567,347,139
23,70915,MAYPEARL ISD,10,english,3,101,21,80,48,15,99,33,66,47,23
23,71801,BURNHAM WOOD CH,19,english,3,74,8,66,58,27,74,11,63,44,19
23,71806,HARMONY PUBLIC,19,english,3,385,101,284,195,67,390,107,283,165,53
23,71807,LA FE PREPARATO,19,english,3,0,,,,,0,,,,
23,71809,VISTA DEL FUTUR,19,english,3,37,4,33,23,9,37,8,29,17,8
23,71901,CLINT ISD,19,english,3,588,188,400,221,53,592,217,375,168,51
23,71902,EL PASO ISD,19,english,3,2669,539,2130,1402,576,2684,723,1961,1110,406
23,71903,FABENS ISD,19,english,3,88,27,61,38,10,96,45,51,21,2
23,71904,SAN ELIZARIO IS,19,english,3,124,31,93,53,18,167,46,121,47,18
23,71905,YSLETA ISD,19,english,3,1713,273,1440,988,385,1920,334,1586,1034,419
23,71906,ANTHONY ISD,19,english,3,49,15,34,14,2,50,20,30,8,0
23,71907,CANUTILLO ISD,19,english,3,326,53,273,189,73,329,46,283,185,88
23,71908,TORNILLO ISD,19,english,3,23,6,17,13,4,50,8,42,20,6
23,71909,SOCORRO ISD,19,english,3,3058,650,2408,1633,640,3073,754,2319,1394,505
23,72901,THREE WAY ISD,11,english,3,16,8,8,2,1,16,8,8,1,0
23,72902,DUBLIN ISD,11,english,3,75,11,64,38,12,76,10,66,33,7
23,72903,STEPHENVILLE IS,11,english,3,258,33,225,153,60,273,32,241,173,91
23,72904,BLUFF DALE ISD,11,english,3,16,2,14,9,3,16,4,12,9,3
23,72908,HUCKABAY ISD,11,english,3,24,3,21,11,4,24,3,21,16,6
23,72909,LINGLEVILLE ISD,11,english,3,16,8,8,7,3,16,8,8,4,1
23,72910,MORGAN MILL ISD,11,english,3,18,7,11,7,1,18,6,12,3,1
23,73901,CHILTON ISD,12,english,3,43,13,30,13,4,43,13,30,14,3
23,73903,MARLIN ISD,12,english,3,60,33,27,16,2,60,29,31,12,2
23,73904,WESTPHALIA ISD,12,english,3,16,1,15,12,3,16,2,14,9,2
23,73905,ROSEBUD-LOTT IS,12,english,3,55,10,45,22,5,55,19,36,17,5
23,74903,BONHAM ISD,10,english,3,129,37,92,44,13,126,46,80,45,12
23,74904,DODD CITY ISD,10,english,3,22,2,20,11,3,22,2,20,5,2
23,74905,ECTOR ISD,10,english,3,13,4,9,4,0,13,3,10,7,1
23,74907,HONEY GROVE ISD,8,english,3,47,3,44,32,14,47,7,40,33,15
23,74909,LEONARD ISD,10,english,3,52,10,42,24,8,52,6,46,33,11
23,74911,SAVOY ISD,10,english,3,22,1,21,16,7,22,2,20,15,7
23,74912,TRENTON ISD,10,english,3,59,15,44,28,5,59,25,34,15,4
23,74917,SAM RAYBURN ISD,10,english,3,37,5,32,20,3,37,7,30,17,6
23,75901,FLATONIA ISD,13,english,3,45,2,43,37,11,44,0,44,30,9
23,75902,LA GRANGE ISD,13,english,3,119,25,94,69,23,119,26,93,48,22
23,75903,SCHULENBURG ISD,13,english,3,45,9,36,20,8,45,17,28,19,8
23,75906,FAYETTEVILLE IS,13,english,3,16,1,15,10,5,16,2,14,8,5
23,75908,ROUND TOP-CARMI,13,english,3,19,1,18,8,1,19,5,14,9,2
23,76903,ROBY CISD,14,english,3,22,7,15,6,2,22,9,13,7,2
23,76904,ROTAN ISD,14,english,3,26,5,21,16,5,26,4,22,17,7
23,77901,FLOYDADA COLLEG,17,english,3,38,6,32,21,7,38,6,32,19,5
23,77902,LOCKNEY ISD,17,english,3,23,7,16,10,4,23,12,11,5,2
23,78901,CROWELL ISD,9,english,3,15,7,8,4,1,15,4,11,6,3
23,79901,LAMAR CISD,4,english,3,3138,426,2712,2008,977,3200,581,2619,1739,736
23,79906,NEEDVILLE ISD,4,english,3,258,22,236,172,71,259,22,237,173,78
23,79907,FORT BEND ISD,4,english,3,5431,966,4465,3180,1384,5449,1221,4228,2805,1414
23,79910,STAFFORD MSD,4,english,3,228,75,153,107,39,230,65,165,101,48
23,80901,MOUNT VERNON IS,8,english,3,102,15,87,62,28,103,19,84,58,25
23,81902,FAIRFIELD ISD,12,english,3,121,31,90,53,22,121,36,85,39,13
23,81904,TEAGUE ISD,12,english,3,76,15,61,47,25,76,10,66,51,19
23,81905,WORTHAM ISD,12,english,3,36,8,28,19,3,36,11,25,16,6
23,81906,DEW ISD,12,english,3,14,0,14,12,3,14,0,14,12,7
23,82902,DILLEY ISD,20,english,3,57,30,27,12,4,57,28,29,13,5
23,82903,PEARSALL ISD,20,english,3,138,43,95,56,13,134,51,83,36,14
23,83901,SEAGRAVES ISD,17,english,3,29,11,18,8,2,29,15,14,5,1
23,83902,LOOP ISD,17,english,3,11,1,10,5,2,11,1,10,4,2
23,83903,SEMINOLE ISD,17,english,3,209,51,158,82,28,209,42,167,100,49
23,84802,ODYSSEY ACADEMY,4,english,3,123,44,79,42,14,122,62,60,22,8
23,84804,AMBASSADORS PRE,4,english,3,19,3,16,10,1,19,4,15,11,4
23,84901,DICKINSON ISD,4,english,3,781,191,590,359,133,809,250,559,318,128
23,84902,GALVESTON ISD,4,english,3,386,105,281,169,68,401,132,269,154,67
23,84903,HIGH ISLAND ISD,5,english,3,9,0,9,5,1,9,0,9,6,3
23,84906,TEXAS CITY ISD,4,english,3,524,139,385,218,57,525,161,364,198,60
23,84908,HITCHCOCK ISD,4,english,3,107,41,66,30,3,108,54,54,22,8
23,84909,SANTA FE ISD,4,english,3,314,61,253,166,49,315,73,242,156,66
23,84910,CLEAR CREEK ISD,4,english,3,2616,415,2201,1573,703,2608,525,2083,1402,646
23,84911,FRIENDSWOOD ISD,4,english,3,493,39,454,360,194,494,62,432,312,160
23,85902,POST ISD,17,english,3,46,13,33,19,5,46,8,38,26,12
23,85903,SOUTHLAND ISD,17,english,3,12,2,10,4,1,12,2,10,5,1
23,86024,DOSS CONSOLIDAT,13,english,3,0,,,,,0,,,,
23,86901,FREDERICKSBURG,13,english,3,197,41,156,93,36,200,52,148,80,26
23,86902,HARPER ISD,15,english,3,55,6,49,38,11,55,9,46,36,20
23,87901,GLASSCOCK COUNT,18,english,3,22,0,22,17,13,21,0,21,14,4
23,88902,GOLIAD ISD,3,english,3,83,17,66,35,8,83,26,57,41,9
23,89901,GONZALES ISD,13,english,3,162,33,129,83,30,161,38,123,63,20
23,89903,NIXON-SMILEY CI,13,english,3,61,8,53,31,6,61,7,54,43,21
23,89905,WAELDER ISD,13,english,3,13,8,5,2,0,13,9,4,1,0
23,90902,LEFORS ISD,16,english,3,17,5,12,7,2,17,2,15,7,1
23,90903,MCLEAN ISD,16,english,3,19,2,17,9,1,19,2,17,9,3
23,90904,PAMPA ISD,16,english,3,227,82,145,75,22,228,101,127,61,26
23,90905,GRANDVIEW-HOPKI,16,english,3,9,4,5,3,1,9,4,5,2,1
23,91901,BELLS ISD,10,english,3,72,13,59,34,11,71,13,58,34,19
23,91902,COLLINSVILLE IS,10,english,3,41,9,32,17,3,41,4,37,19,9
23,91903,DENISON ISD,10,english,3,357,79,278,183,72,373,84,289,176,66
23,91905,HOWE ISD,10,english,3,105,25,80,46,13,105,35,70,30,4
23,91906,SHERMAN ISD,10,english,3,550,202,348,187,57,549,241,308,151,54
23,91907,TIOGA ISD,10,english,3,51,10,41,23,4,51,15,36,21,6
23,91908,VAN ALSTYNE ISD,10,english,3,183,20,163,124,57,187,41,146,86,32
23,91909,WHITESBORO ISD,10,english,3,146,34,112,57,13,146,39,107,50,12
23,91910,WHITEWRIGHT ISD,10,english,3,66,19,47,33,6,65,20,45,28,10
23,91913,POTTSBORO ISD,10,english,3,104,24,80,57,22,104,30,74,36,12
23,91914,S AND S CISD,10,english,3,69,19,50,29,7,69,20,49,13,2
23,91917,GUNTER ISD,10,english,3,81,19,62,36,9,81,17,64,39,15
23,91918,TOM BEAN ISD,10,english,3,44,17,27,9,2,44,15,29,17,6
23,92901,GLADEWATER ISD,7,english,3,128,37,91,47,8,130,35,95,45,17
23,92902,KILGORE ISD,7,english,3,236,40,196,125,46,258,56,202,121,46
23,92903,LONGVIEW ISD,7,english,3,508,111,397,288,127,546,146,400,241,111
23,92904,PINE TREE ISD,7,english,3,341,67,274,177,81,340,83,257,146,60
23,92906,SABINE ISD,7,english,3,116,25,91,50,18,115,25,90,50,15
23,92907,SPRING HILL ISD,7,english,3,144,13,131,100,56,144,15,129,95,55
23,92908,WHITE OAK ISD,7,english,3,109,10,99,75,23,109,16,93,61,19
23,93901,ANDERSON-SHIRO,6,english,3,76,4,72,56,15,75,5,70,53,20
23,93903,IOLA ISD,6,english,3,51,6,45,34,22,51,7,44,33,14
23,93904,NAVASOTA ISD,6,english,3,208,63,145,90,23,207,67,140,61,22
23,93905,RICHARDS ISD,6,english,3,9,0,9,6,1,9,0,9,5,3
23,94901,SEGUIN ISD,20,english,3,472,154,318,192,56,474,142,332,178,58
23,94902,SCHERTZ-CIBOLO-,20,english,3,1043,269,774,407,123,1060,339,721,344,108
23,94903,NAVARRO ISD,20,english,3,166,33,133,81,20,166,22,144,102,38
23,94904,MARION ISD,20,english,3,103,17,86,63,23,102,25,77,48,27
23,95901,ABERNATHY ISD,17,english,3,62,11,51,26,6,62,21,41,25,4
23,95902,COTTON CENTER I,17,english,3,8,1,7,6,0,8,1,7,6,3
23,95903,HALE CENTER ISD,17,english,3,38,11,27,14,4,38,5,33,16,9
23,95904,PETERSBURG ISD,17,english,3,16,1,15,9,5,16,4,12,6,2
23,95905,PLAINVIEW ISD,17,english,3,310,128,182,110,34,310,142,168,78,28
23,96904,MEMPHIS ISD,16,english,3,32,4,28,12,3,32,10,22,11,4
23,96905,TURKEY-QUITAQUE,16,english,3,13,1,12,10,6,13,1,12,9,6
23,97902,HAMILTON ISD,12,english,3,47,6,41,29,14,47,6,41,30,14
23,97903,HICO ISD,12,english,3,51,10,41,30,5,51,8,43,24,6
23,98901,GRUVER ISD,16,english,3,31,0,31,27,13,31,0,31,19,9
23,98903,PRINGLE-MORSE C,16,english,3,12,2,10,8,2,12,3,9,4,0
23,98904,SPEARMAN ISD,16,english,3,46,7,39,27,15,46,6,40,32,12
23,99902,CHILLICOTHE ISD,9,english,3,12,1,11,5,1,12,2,10,3,1
23,99903,QUANAH ISD,9,english,3,23,5,18,12,5,23,7,16,10,4
23,100903,KOUNTZE ISD,5,english,3,83,13,70,47,25,84,23,61,45,17
23,100904,SILSBEE ISD,5,english,3,174,40,134,78,20,172,51,121,57,24
23,100905,HARDIN-JEFFERSO,5,english,3,210,40,170,100,24,211,35,176,97,30
23,100907,LUMBERTON ISD,5,english,3,313,61,252,161,52,312,83,229,145,58
23,100908,WEST HARDIN COU,5,english,3,34,8,26,15,4,34,12,22,7,2
23,101802,SER-NINOS CHART,4,english,3,53,10,43,28,12,53,14,39,26,9
23,101803,ARISTOI CLASSIC,4,english,3,131,23,108,86,26,131,35,96,63,25
23,101806,RAUL YZAGUIRRE,4,english,3,71,17,54,33,12,106,18,88,56,14
23,101810,ACADEMY OF ACCE,4,english,3,83,29,54,35,14,83,24,59,24,11
23,101814,THE VARNETT PUB,4,english,3,101,45,56,29,6,101,35,66,31,14
23,101815,ALIEF MONTESSOR,4,english,3,33,6,27,19,5,33,8,25,13,4
23,101819,AMIGOS POR VIDA,4,english,3,49,5,44,35,15,49,8,41,25,12
23,101828,HOUSTON GATEWAY,4,english,3,181,37,144,100,34,180,24,156,109,41
23,101838,SOUTHWEST SCHOO,4,english,3,124,64,60,32,3,124,52,72,29,6
23,101840,TWO DIMENSIONS,4,english,3,36,9,27,15,3,36,24,12,5,0
23,101842,COMQUEST ACADEM,4,english,3,0,,,,,0,,,,
23,101845,YES PREP PUBLIC,4,english,3,244,68,176,108,37,244,58,186,107,43
23,101846,HARMONY PUBLIC,4,english,3,209,48,161,99,32,208,62,146,69,19
23,101847,BEATRICE MAYES,4,english,3,57,10,47,24,4,57,8,49,28,4
23,101849,ACCELERATED INT,4,english,3,18,8,10,5,2,18,6,12,3,1
23,101853,BAKERRIPLEY COM,4,english,3,91,43,48,21,4,91,49,42,15,2
23,101855,MEYERPARK ELEME,4,english,3,28,5,23,15,1,28,13,15,5,0
23,101856,DRAW ACADEMY,4,english,3,53,14,39,18,5,53,17,36,14,3
23,101858,HARMONY PUBLIC,4,english,3,531,101,430,290,122,532,146,386,224,99
23,101859,STEP CHARTER SC,4,english,3,66,24,42,27,10,65,23,42,21,12
23,101861,THE RHODES SCHO,4,english,3,59,24,35,15,2,59,34,25,15,4
23,101862,HARMONY PUBLIC,4,english,3,425,50,375,297,160,425,66,359,260,130
23,101868,THE PRO-VISION,4,english,3,9,5,4,0,0,9,9,0,0,0
23,101870,BETA ACADEMY,4,english,3,148,26,122,76,22,148,35,113,65,18
23,101875,BLOOM ACADEMY C,4,english,3,45,19,26,14,5,45,27,18,9,3
23,101876,REVE PREPARATOR,4,english,3,47,29,18,3,1,48,33,15,2,1
23,101877,ELEVATE COLLEGI,4,english,3,19,8,11,7,2,17,6,11,4,0
23,101878,HOUSTON CLASSIC,4,english,3,26,5,21,16,10,26,7,19,12,7
23,101902,ALDINE ISD,4,english,3,3479,1345,2134,1084,286,3542,1362,2180,1075,340
23,101903,ALIEF ISD,4,english,3,1742,546,1196,720,265,2934,1189,1745,841,343
23,101905,CHANNELVIEW ISD,4,english,3,555,148,407,232,57,614,170,444,249,85
23,101906,CROSBY ISD,4,english,3,437,80,357,238,91,438,111,327,176,70
23,101907,CYPRESS-FAIRBAN,4,english,3,8117,1678,6439,4429,1946,8120,2112,6008,3700,1618
23,101908,DEER PARK ISD,4,english,3,712,138,574,379,141,714,154,560,349,141
23,101910,GALENA PARK ISD,4,english,3,1008,228,780,511,176,1062,291,771,443,152
23,101911,GOOSE CREEK CIS,4,english,3,1695,534,1161,663,212,1696,561,1135,559,196
23,101912,HOUSTON ISD,4,english,3,10559,2954,7605,4805,1923,10846,3488,7358,4407,2084
23,101913,HUMBLE ISD,4,english,3,3209,736,2473,1582,493,3225,960,2265,1309,528
23,101914,KATY ISD,4,english,3,6239,805,5434,4177,1974,6394,1177,5217,3661,1898
23,101915,KLEIN ISD,4,english,3,3523,610,2913,2052,832,3546,729,2817,1828,782
23,101916,LA PORTE ISD,4,english,3,495,77,418,279,112,495,93,402,247,94
23,101917,PASADENA ISD,4,english,3,2184,518,1666,995,324,2126,689,1437,769,224
23,101919,SPRING ISD,4,english,3,2127,772,1355,738,196,2281,853,1428,726,246
23,101920,SPRING BRANCH I,4,english,3,2174,444,1730,1331,705,2237,511,1726,1167,555
23,101921,TOMBALL ISD,4,english,3,1586,134,1452,1162,587,1661,216,1445,1069,582
23,101924,SHELDON ISD,4,english,3,674,232,442,240,78,682,221,461,238,75
23,101925,HUFFMAN ISD,4,english,3,232,68,164,95,24,231,76,155,89,24
23,102901,KARNACK ISD,7,english,3,11,2,9,3,0,11,6,5,1,1
23,102902,MARSHALL ISD,7,english,3,318,105,213,139,54,335,113,222,126,51
23,102903,WASKOM ISD,7,english,3,68,17,51,26,3,68,19,49,15,4
23,102904,HALLSVILLE ISD,7,english,3,562,166,396,237,83,563,199,364,208,85
23,102905,HARLETON ISD,7,english,3,49,4,45,29,6,48,10,38,25,8
23,102906,ELYSIAN FIELDS,7,english,3,65,8,57,46,28,65,9,56,30,9
23,103901,CHANNING ISD,16,english,3,10,3,7,5,1,10,5,5,3,1
23,103902,HARTLEY ISD,16,english,3,13,7,6,5,1,13,8,5,2,0
23,104901,HASKELL CISD,14,english,3,25,8,17,12,8,25,10,15,4,3
23,104903,RULE ISD,14,english,3,5,0,5,4,1,5,1,4,3,2
23,104907,PAINT CREEK ISD,14,english,3,9,0,9,4,3,9,0,9,6,2
23,105802,TEXAS PREPARATO,13,english,3,11,4,7,4,0,11,6,5,0,0
23,105803,KI CHARTER ACAD,13,english,3,10,6,4,1,1,9,8,1,0,0
23,105804,DORAL ACADEMY O,13,english,3,32,3,29,18,12,32,6,26,21,12
23,105902,SAN MARCOS CISD,13,english,3,527,169,358,208,67,558,214,344,175,62
23,105904,DRIPPING SPRING,13,english,3,585,44,541,416,212,583,64,519,373,183
23,105905,WIMBERLEY ISD,13,english,3,161,12,149,113,47,161,22,139,95,33
23,105906,HAYS CISD,13,english,3,1481,294,1187,804,320,1566,399,1167,692,278
23,106901,CANADIAN ISD,16,english,3,40,3,37,27,8,40,6,34,15,3
23,107901,ATHENS ISD,10,english,3,223,44,179,111,44,222,64,158,110,56
23,107902,BROWNSBORO ISD,7,english,3,189,39,150,96,30,189,46,143,76,28
23,107904,CROSS ROADS ISD,7,english,3,42,9,33,17,4,42,9,33,17,3
23,107905,EUSTACE ISD,7,english,3,125,20,105,69,24,125,25,100,56,21
23,107906,MALAKOFF ISD,7,english,3,110,9,101,68,23,110,9,101,65,23
23,107907,TRINIDAD ISD,7,english,3,8,2,6,4,0,8,4,4,2,0
23,107908,MURCHISON ISD,7,english,3,18,2,16,8,2,18,5,13,6,4
23,107910,LAPOYNOR ISD,7,english,3,31,7,24,17,8,31,5,26,13,4
23,108802,HORIZON MONTESS,1,english,3,127,28,99,60,20,126,29,97,54,23
23,108807,IDEA PUBLIC SCH,1,english,3,6727,1797,4930,3179,1367,6736,2220,4516,2389,800
23,108808,VANGUARD ACADEM,1,english,3,423,84,339,244,124,461,97,364,244,104
23,108809,EXCELLENCE IN L,1,english,3,18,11,7,5,0,18,6,12,5,2
23,108902,DONNA ISD,1,english,3,650,240,410,226,62,824,310,514,213,56
23,108903,EDCOUCH-ELSA IS,1,english,3,269,109,160,73,13,269,100,169,58,13
23,108904,EDINBURG CISD,1,english,3,2132,481,1651,1041,422,2151,487,1664,1033,374
23,108905,HIDALGO ISD,1,english,3,107,17,90,61,21,134,15,119,84,46
23,108906,MCALLEN ISD,1,english,3,1190,244,946,627,298,1239,291,948,579,209
23,108907,MERCEDES ISD,1,english,3,255,87,168,77,30,287,109,178,91,23
23,108908,MISSION CISD,1,english,3,692,155,537,354,143,893,257,636,361,126
23,108909,PHARR-SAN JUAN-,1,english,3,1530,412,1118,705,285,1959,581,1378,782,280
23,108910,PROGRESO ISD,1,english,3,58,14,44,27,7,91,17,74,32,6
23,108911,SHARYLAND ISD,1,english,3,554,91,463,349,182,554,121,433,274,144
23,108912,LA JOYA ISD,1,english,3,834,180,654,448,190,1434,408,1026,614,239
23,108913,WESLACO ISD,1,english,3,1083,231,852,530,216,1083,274,809,470,192
23,108914,LA VILLA ISD,1,english,3,31,15,16,4,0,31,18,13,5,0
23,108915,MONTE ALTO ISD,1,english,3,56,19,37,20,8,54,15,39,17,3
23,108916,VALLEY VIEW ISD,1,english,3,178,27,151,108,55,186,24,162,91,35
23,109901,ABBOTT ISD,12,english,3,22,1,21,14,4,22,4,18,6,1
23,109902,BYNUM ISD,12,english,3,11,3,8,6,2,11,5,6,4,2
23,109903,COVINGTON ISD,12,english,3,22,6,16,7,1,22,3,19,8,3
23,109904,HILLSBORO ISD,12,english,3,140,31,109,65,20,140,46,94,40,15
23,109905,HUBBARD ISD,12,english,3,31,15,16,8,2,31,16,15,4,1
23,109907,ITASCA ISD,12,english,3,28,9,19,9,0,28,10,18,8,2
23,109908,MALONE ISD,12,english,3,12,1,11,7,4,12,2,10,6,0
23,109910,MOUNT CALM ISD,12,english,3,11,3,8,3,0,11,5,6,4,1
23,109911,WHITNEY ISD,12,english,3,109,40,69,27,6,109,43,66,28,7
23,109912,AQUILLA ISD,12,english,3,32,8,24,12,4,32,10,22,13,4
23,109913,BLUM ISD,12,english,3,22,4,18,5,1,22,6,16,7,0
23,109914,PENELOPE ISD,12,english,3,18,4,14,8,0,18,6,12,2,1
23,110901,ANTON ISD,17,english,3,8,3,5,1,0,8,2,6,2,1
23,110902,LEVELLAND ISD,17,english,3,175,36,139,85,21,174,40,134,78,26
23,110905,ROPES ISD,17,english,3,39,2,37,28,14,39,6,33,24,7
23,110906,SMYER ISD,17,english,3,36,7,29,18,4,35,6,29,17,5
23,110907,SUNDOWN ISD,17,english,3,35,1,34,24,13,35,0,35,30,19
23,110908,WHITHARRAL ISD,17,english,3,15,0,15,7,2,15,3,12,7,1
23,111901,GRANBURY ISD,11,english,3,537,112,425,300,126,542,129,413,253,95
23,111902,LIPAN ISD,11,english,3,30,2,28,20,4,30,1,29,26,10
23,111903,TOLAR ISD,11,english,3,72,18,54,21,3,72,26,46,15,5
23,112901,SULPHUR SPRINGS,8,english,3,259,67,192,125,44,300,75,225,136,52
23,112905,CUMBY COLLEGIAT,8,english,3,23,2,21,13,5,22,3,19,13,2
23,112906,NORTH HOPKINS I,8,english,3,35,8,27,18,4,35,6,29,23,15
23,112907,MILLER GROVE IS,8,english,3,22,0,22,10,2,22,4,18,4,1
23,112908,COMO-PICKTON CI,8,english,3,52,15,37,15,1,52,14,38,20,4
23,112909,SALTILLO ISD,8,english,3,16,0,16,15,6,16,0,16,11,3
23,112910,SULPHUR BLUFF I,8,english,3,8,1,7,4,2,8,3,5,2,0
23,113901,CROCKETT ISD,6,english,3,76,39,37,18,3,78,55,23,4,1
23,113902,GRAPELAND ISD,6,english,3,38,8,30,14,4,39,13,26,11,3
23,113903,LOVELADY ISD,6,english,3,37,8,29,13,3,38,8,30,12,5
23,113905,LATEXO ISD,6,english,3,40,9,31,20,4,40,9,31,15,5
23,113906,KENNARD ISD,6,english,3,13,2,11,7,3,13,0,13,10,4
23,114901,BIG SPRING ISD,18,english,3,247,71,176,93,17,246,56,190,107,40
23,114902,COAHOMA ISD,18,english,3,90,22,68,41,15,90,23,67,38,16
23,114904,FORSAN ISD,18,english,3,54,9,45,23,6,54,14,40,22,10
23,115901,FT HANCOCK ISD,19,english,3,14,2,12,3,1,14,6,8,2,0
23,115902,SIERRA BLANCA I,19,english,3,5,4,1,0,0,5,5,0,0,0
23,115903,DELL CITY ISD,19,english,3,11,5,6,3,0,10,2,8,5,1
23,116901,CADDO MILLS ISD,10,english,3,206,23,183,137,51,206,20,186,137,56
23,116902,CELESTE ISD,10,english,3,34,9,25,12,2,33,15,18,11,2
23,116903,COMMERCE ISD,10,english,3,111,33,78,38,14,110,45,65,29,9
23,116905,GREENVILLE ISD,10,english,3,344,152,192,103,30,387,193,194,99,34
23,116906,LONE OAK ISD,10,english,3,82,10,72,44,18,82,21,61,29,10
23,116908,QUINLAN ISD,10,english,3,211,81,130,58,11,209,87,122,51,15
23,116909,WOLFE CITY ISD,10,english,3,55,8,47,30,9,55,7,48,37,20
23,116910,CAMPBELL ISD,10,english,3,23,12,11,5,1,23,9,14,5,2
23,116915,BLAND ISD,10,english,3,53,12,41,33,16,53,4,49,33,16
23,116916,BOLES ISD,10,english,3,26,6,20,13,4,26,8,18,9,4
23,117901,BORGER ISD,16,english,3,172,61,111,65,17,177,62,115,61,20
23,117903,SANFORD-FRITCH,16,english,3,42,5,37,26,9,42,9,33,21,11
23,117904,PLEMONS-STINNET,16,english,3,39,1,38,28,14,39,2,37,28,13
23,117907,SPRING CREEK IS,16,english,3,10,4,6,3,0,10,1,9,4,1
23,118902,IRION COUNTY IS,15,english,3,27,3,24,18,7,27,7,20,13,5
23,119901,BRYSON ISD,9,english,3,19,5,14,7,1,19,10,9,2,1
23,119902,JACKSBORO ISD,9,english,3,76,15,61,46,12,77,20,57,32,16
23,119903,PERRIN-WHITT CI,9,english,3,15,4,11,7,5,15,3,12,7,2
23,120901,EDNA ISD,3,english,3,112,25,87,56,17,114,38,76,33,11
23,120902,GANADO ISD,3,english,3,48,10,38,26,9,48,10,38,24,12
23,120905,INDUSTRIAL ISD,3,english,3,84,7,77,52,23,84,17,67,47,21
23,121902,BROOKELAND ISD,5,english,3,28,5,23,17,4,28,8,20,10,4
23,121903,BUNA ISD,5,english,3,81,9,72,50,18,82,9,73,52,16
23,121904,JASPER ISD,5,english,3,122,52,70,34,12,122,65,57,18,4
23,121905,KIRBYVILLE CISD,5,english,3,93,19,74,45,16,93,11,82,53,22
23,121906,EVADALE ISD,5,english,3,25,5,20,11,4,26,4,22,13,0
23,122901,FT DAVIS ISD,18,english,3,9,2,7,3,0,9,5,4,0,0
23,122902,VALENTINE ISD,18,english,3,0,,,,,0,,,,
23,123803,TEKOA ACADEMY O,5,english,3,20,10,10,7,5,20,6,14,11,6
23,123805,EHRHART SCHOOL,5,english,3,55,14,41,32,9,55,13,42,20,7
23,123807,BOB HOPE SCHOOL,5,english,3,98,20,78,43,16,103,24,79,42,14
23,123905,NEDERLAND ISD,5,english,3,372,43,329,232,112,372,61,311,193,76
23,123907,PORT ARTHUR ISD,5,english,3,632,221,411,199,37,633,262,371,136,41
23,123908,PORT NECHES-GRO,5,english,3,383,72,311,206,72,385,102,283,155,61
23,123910,BEAUMONT ISD,5,english,3,1134,476,658,341,108,1135,558,577,246,72
23,123913,SABINE PASS ISD,5,english,3,20,4,16,12,5,20,5,15,9,6
23,123914,HAMSHIRE-FANNET,5,english,3,137,8,129,92,35,138,19,119,70,27
23,124901,JIM HOGG COUNTY,1,english,3,83,28,55,29,12,84,35,49,16,2
23,125901,ALICE ISD,2,english,3,341,105,236,137,37,340,125,215,119,32
23,125902,BEN BOLT-PALITO,2,english,3,31,10,21,9,1,31,17,14,7,1
23,125903,ORANGE GROVE IS,2,english,3,121,18,103,87,42,122,22,100,73,34
23,125905,PREMONT ISD,2,english,3,62,12,50,33,4,63,11,52,30,10
23,125906,LA GLORIA ISD,2,english,3,14,1,13,8,2,14,7,7,4,0
23,126901,ALVARADO ISD,11,english,3,237,46,191,115,41,262,79,183,89,34
23,126902,BURLESON ISD,11,english,3,874,162,712,477,196,875,225,650,409,171
23,126903,CLEBURNE ISD,11,english,3,453,136,317,183,42,456,159,297,149,46
23,126904,GRANDVIEW ISD,11,english,3,117,14,103,80,30,117,19,98,62,24
23,126905,JOSHUA ISD,11,english,3,413,60,353,241,93,431,76,355,231,88
23,126906,KEENE ISD,11,english,3,64,12,52,37,11,63,11,52,28,14
23,126907,RIO VISTA ISD,11,english,3,71,17,54,31,12,71,15,56,26,9
23,126908,VENUS ISD,11,english,3,120,49,71,38,12,160,66,94,48,16
23,126911,GODLEY ISD,11,english,3,210,49,161,86,21,209,57,152,80,28
23,127901,ANSON ISD,14,english,3,43,5,38,24,7,42,6,36,22,7
23,127903,HAMLIN COLLEGIA,14,english,3,22,9,13,8,4,22,8,14,7,2
23,127904,HAWLEY ISD,14,english,3,65,32,33,18,4,65,31,34,19,4
23,127905,LUEDERS-AVOCA I,14,english,3,0,,,,,0,,,,
23,127906,STAMFORD ISD,14,english,3,41,5,36,18,8,41,15,26,9,2
23,128901,KARNES CITY ISD,20,english,3,145,39,106,58,6,145,63,82,44,15
23,128902,KENEDY ISD,3,english,3,51,17,34,20,3,50,22,28,9,1
23,128903,RUNGE ISD,3,english,3,17,10,7,3,1,17,12,5,3,0
23,128904,FALLS CITY ISD,20,english,3,42,7,35,23,10,42,4,38,24,8
23,129901,CRANDALL ISD,10,english,3,423,121,302,175,46,431,165,266,135,35
23,129902,FORNEY ISD,10,english,3,1216,293,923,601,230,1243,355,888,506,209
23,129903,KAUFMAN ISD,10,english,3,302,70,232,130,40,302,66,236,129,49
23,129904,KEMP ISD,10,english,3,129,38,91,49,8,129,40,89,41,14
23,129905,MABANK ISD,10,english,3,296,73,223,127,40,296,80,216,130,49
23,129906,TERRELL ISD,10,english,3,379,161,218,104,27,380,177,203,95,33
23,129910,SCURRY-ROSSER I,10,english,3,75,11,64,38,11,75,11,64,42,12
23,130801,MEADOWLAND CHAR,20,english,3,0,,,,,0,,,,
23,130901,BOERNE ISD,20,english,3,759,60,699,557,280,759,86,673,515,291
23,130902,COMFORT ISD,13,english,3,70,18,52,26,1,70,22,48,17,6
23,131001,KENEDY COUNTY W,2,english,3,12,0,12,10,1,12,0,12,6,2
23,132902,JAYTON-GIRARD I,17,english,3,13,1,12,10,5,13,1,12,4,0
23,133901,CENTER POINT IS,20,english,3,45,9,36,14,3,45,17,28,13,4
23,133902,HUNT ISD,20,english,3,24,2,22,18,8,24,3,21,9,4
23,133903,KERRVILLE ISD,20,english,3,318,46,272,197,92,317,56,261,180,104
23,133904,INGRAM ISD,20,english,3,69,14,55,41,18,68,9,59,41,15
23,133905,DIVIDE ISD,20,english,3,7,0,7,5,3,7,1,6,4,1
23,134901,JUNCTION ISD,15,english,3,53,20,33,18,3,53,24,29,13,3
23,135001,GUTHRIE CSD,17,english,3,7,0,7,3,0,7,1,6,4,3
23,136901,BRACKETT ISD,20,english,3,38,9,29,17,2,38,9,29,16,2
23,137901,KINGSVILLE ISD,2,english,3,209,91,118,69,20,209,100,109,47,10
23,137902,RICARDO ISD,2,english,3,72,8,64,41,18,72,11,61,38,16
23,137903,RIVIERA ISD,2,english,3,21,5,16,10,1,21,9,12,5,1
23,137904,SANTA GERTRUDIS,2,english,3,42,5,37,23,16,42,10,32,23,9
23,138902,KNOX CITY-O'BRI,9,english,3,17,3,14,7,3,17,0,17,14,7
23,138903,MUNDAY CISD,9,english,3,20,2,18,11,6,20,5,15,7,2
23,138904,BENJAMIN ISD,9,english,3,8,0,8,4,2,8,4,4,1,0
23,139905,CHISUM ISD,8,english,3,97,16,81,64,19,97,22,75,43,5
23,139909,PARIS ISD,8,english,3,294,100,194,101,32,303,135,168,82,17
23,139911,NORTH LAMAR ISD,8,english,3,179,41,138,80,31,179,49,130,82,35
23,139912,PRAIRILAND ISD,8,english,3,72,12,60,42,13,74,10,64,47,21
23,140901,AMHERST ISD,17,english,3,8,3,5,1,0,8,6,2,0,0
23,140904,LITTLEFIELD ISD,17,english,3,71,13,58,32,9,71,15,56,35,11
23,140905,OLTON ISD,17,english,3,29,9,20,11,5,29,14,15,9,4
23,140907,SPRINGLAKE-EART,17,english,3,15,2,13,8,4,15,2,13,6,2
23,140908,SUDAN ISD,17,english,3,28,11,17,12,0,28,8,20,12,7
23,141901,LAMPASAS ISD,12,english,3,273,51,222,150,50,273,68,205,129,47
23,141902,LOMETA ISD,12,english,3,15,8,7,1,0,15,6,9,2,0
23,142901,COTULLA ISD,20,english,3,83,35,48,27,8,85,32,53,27,8
23,143901,HALLETTSVILLE I,3,english,3,75,6,69,44,15,75,10,65,50,21
23,143902,MOULTON ISD,3,english,3,23,6,17,10,3,23,8,15,7,3
23,143903,SHINER ISD,3,english,3,44,3,41,31,15,44,6,38,32,17
23,143904,VYSEHRAD ISD,3,english,3,10,2,8,8,3,10,0,10,6,4
23,143905,SWEET HOME ISD,3,english,3,17,1,16,8,4,17,0,17,12,5
23,143906,EZZELL ISD,3,english,3,12,0,12,6,4,12,0,12,6,1
23,144901,GIDDINGS ISD,13,english,3,121,29,92,57,13,121,28,93,47,12
23,144902,LEXINGTON ISD,13,english,3,69,9,60,39,11,69,15,54,32,14
23,144903,DIME BOX ISD,13,english,3,13,5,8,0,0,13,12,1,0,0
23,145901,BUFFALO ISD,6,english,3,71,10,61,32,9,70,16,54,30,9
23,145902,CENTERVILLE ISD,6,english,3,37,6,31,14,4,37,15,22,10,0
23,145906,NORMANGEE ISD,6,english,3,45,3,42,31,12,45,13,32,17,4
23,145907,OAKWOOD ISD,6,english,3,15,7,8,2,1,15,3,12,4,2
23,145911,LEON ISD,6,english,3,49,8,41,28,6,49,15,34,16,5
23,146901,CLEVELAND ISD,4,english,3,718,310,408,168,37,853,409,444,157,42
23,146902,DAYTON ISD,4,english,3,383,95,288,157,48,412,113,299,135,34
23,146903,DEVERS ISD,4,english,3,18,0,18,14,6,18,1,17,13,5
23,146904,HARDIN ISD,5,english,3,101,25,76,52,14,99,31,68,39,11
23,146905,HULL-DAISETTA I,5,english,3,36,21,15,5,0,36,17,19,8,1
23,146906,LIBERTY ISD,5,english,3,150,46,104,58,17,150,50,100,53,16
23,146907,TARKINGTON ISD,4,english,3,172,44,128,69,9,172,46,126,85,27
23,147901,COOLIDGE ISD,12,english,3,29,3,26,16,2,29,1,28,20,6
23,147902,GROESBECK ISD,12,english,3,112,46,66,31,7,111,56,55,19,7
23,147903,MEXIA ISD,12,english,3,135,41,94,43,9,135,57,78,33,9
23,148901,BOOKER ISD,16,english,3,26,2,24,21,7,27,2,25,21,10
23,148902,FOLLETT ISD,16,english,3,16,7,9,4,0,16,10,6,2,0
23,148905,DARROUZETT ISD,16,english,3,7,2,5,2,0,7,1,6,1,0
23,149901,GEORGE WEST ISD,2,english,3,71,7,64,53,22,71,6,65,58,32
23,149902,THREE RIVERS IS,2,english,3,39,10,29,19,5,39,10,29,20,2
23,150901,LLANO ISD,13,english,3,149,36,113,73,19,148,41,107,67,28
23,152504,TEXAS TECH UNIV,17,english,3,30,3,27,17,8,30,10,20,10,6
23,152802,RISE ACADEMY,17,english,3,25,0,25,25,16,25,1,24,18,4
23,152806,BETTY M CONDRA,17,english,3,32,13,19,6,0,32,17,15,3,0
23,152901,LUBBOCK ISD,17,english,3,1746,338,1408,927,348,1780,436,1344,814,346
23,152902,NEW DEAL ISD,17,english,3,49,12,37,19,3,49,22,27,10,3
23,152903,SLATON ISD,17,english,3,85,24,61,33,9,85,32,53,22,5
23,152906,LUBBOCK-COOPER,17,english,3,533,63,470,351,161,550,88,462,324,155
23,152907,FRENSHIP ISD,17,english,3,778,158,620,417,168,784,180,604,391,172
23,152908,ROOSEVELT ISD,17,english,3,69,16,53,31,14,69,21,48,29,8
23,152909,SHALLOWATER ISD,17,english,3,122,9,113,82,37,122,13,109,78,30
23,152910,IDALOU ISD,17,english,3,69,12,57,41,13,69,16,53,28,11
23,153903,O'DONNELL ISD,17,english,3,17,5,12,5,1,17,2,15,8,3
23,153904,TAHOKA ISD,17,english,3,48,16,32,17,7,48,22,26,13,2
23,153905,NEW HOME ISD,17,english,3,58,1,57,42,17,59,2,57,39,17
23,153907,WILSON ISD,17,english,3,10,3,7,4,0,10,5,5,1,0
23,154901,MADISONVILLE CI,6,english,3,138,23,115,81,31,138,23,115,71,31
23,154903,NORTH ZULCH ISD,6,english,3,32,4,28,20,5,32,9,23,11,3
23,155901,JEFFERSON ISD,8,english,3,64,17,47,35,10,64,20,44,23,9
23,156902,STANTON ISD,18,english,3,78,13,65,45,10,78,14,64,43,19
23,156905,GRADY ISD,18,english,3,16,0,16,13,9,15,1,14,12,5
23,157901,MASON ISD,15,english,3,51,6,45,24,4,51,5,46,38,9
23,158901,BAY CITY ISD,3,english,3,273,133,140,64,22,270,129,141,51,19
23,158902,TIDEHAVEN ISD,3,english,3,70,2,68,51,21,70,2,68,49,21
23,158904,MATAGORDA ISD,3,english,3,8,0,8,3,0,8,2,6,5,2
23,158905,PALACIOS ISD,3,english,3,87,14,73,43,14,87,16,71,49,13
23,158906,VAN VLECK ISD,3,english,3,80,10,70,44,15,80,11,69,39,18
23,159901,EAGLE PASS ISD,20,english,3,779,206,573,322,94,784,199,585,326,103
23,160901,BRADY ISD,15,english,3,48,1,47,40,12,48,8,40,22,10
23,160904,ROCHELLE ISD,15,english,3,14,1,13,9,4,14,1,13,9,3
23,160905,LOHN ISD,15,english,3,9,4,5,2,0,9,4,5,3,0
23,161801,WACO CHARTER SC,12,english,3,29,16,13,3,2,29,17,12,3,0
23,161802,RAPOPORT ACADEM,12,english,3,68,36,32,15,4,68,41,27,10,3
23,161807,HARMONY PUBLIC,12,english,3,753,201,552,341,131,752,224,528,311,130
23,161901,CRAWFORD ISD,12,english,3,44,5,39,27,8,44,9,35,19,10
23,161903,MIDWAY ISD,12,english,3,621,76,545,415,185,621,70,551,396,225
23,161906,LA VEGA ISD,12,english,3,218,53,165,80,22,216,75,141,65,16
23,161907,LORENA ISD,12,english,3,129,16,113,81,39,130,29,101,63,23
23,161908,MART ISD,12,english,3,36,6,30,21,2,37,4,33,22,10
23,161909,MCGREGOR ISD,12,english,3,110,28,82,51,16,110,29,81,46,17
23,161910,MOODY ISD,12,english,3,52,6,46,34,12,52,11,41,24,4
23,161912,RIESEL ISD,12,english,3,43,5,38,23,8,43,9,34,22,7
23,161914,WACO ISD,12,english,3,1020,471,549,279,68,1020,533,487,202,63
23,161916,WEST ISD,12,english,3,84,12,72,52,22,84,8,76,44,19
23,161918,AXTELL ISD,12,english,3,56,6,50,33,19,56,18,38,18,6
23,161919,BRUCEVILLE-EDDY,12,english,3,38,14,24,9,0,38,10,28,15,5
23,161920,CHINA SPRING IS,12,english,3,213,30,183,135,50,213,38,175,113,40
23,161921,CONNALLY ISD,12,english,3,184,63,121,65,11,183,45,138,63,16
23,161922,ROBINSON ISD,12,english,3,196,29,167,106,40,196,33,163,109,45
23,161923,BOSQUEVILLE ISD,12,english,3,50,2,48,34,9,49,9,40,19,2
23,161924,HALLSBURG ISD,12,english,3,19,5,14,7,2,19,6,13,7,3
23,161925,GHOLSON ISD,12,english,3,13,3,10,6,1,13,3,10,3,1
23,162904,MCMULLEN COUNTY,2,english,3,20,1,19,16,3,20,0,20,15,7
23,163901,DEVINE ISD,20,english,3,143,26,117,69,22,144,51,93,45,13
23,163902,D'HANIS ISD,20,english,3,25,1,24,21,10,25,2,23,18,7
23,163903,NATALIA ISD,20,english,3,90,31,59,39,7,90,32,58,28,5
23,163904,HONDO ISD,20,english,3,128,36,92,47,6,128,61,67,27,8
23,163908,MEDINA VALLEY I,20,english,3,617,103,514,354,141,617,133,484,325,137
23,164901,MENARD ISD,15,english,3,16,6,10,9,5,16,6,10,8,3
23,165802,MIDLAND ACADEMY,18,english,3,51,2,49,37,20,51,7,44,33,9
23,165901,MIDLAND ISD,18,english,3,1926,547,1379,788,275,1937,640,1297,730,282
23,165902,GREENWOOD ISD,18,english,3,257,67,190,115,29,257,76,181,105,44
23,166901,CAMERON ISD,6,english,3,97,13,84,50,14,97,35,62,30,8
23,166902,GAUSE ISD,6,english,3,18,3,15,12,1,17,0,17,10,1
23,166903,MILANO ISD,6,english,3,18,2,16,10,6,18,1,17,13,5
23,166904,ROCKDALE ISD,6,english,3,104,19,85,46,9,104,35,69,24,7
23,166905,THORNDALE ISD,13,english,3,36,11,25,13,2,36,20,16,7,3
23,166907,BUCKHOLTS ISD,12,english,3,7,2,5,1,0,7,3,4,1,1
23,167901,GOLDTHWAITE ISD,12,english,3,36,4,32,21,12,36,4,32,22,11
23,167902,MULLIN ISD,12,english,3,7,1,6,1,1,7,4,3,1,0
23,167904,PRIDDY ISD,12,english,3,5,2,3,2,0,5,2,3,1,1
23,168901,COLORADO ISD,14,english,3,79,23,56,28,8,79,41,38,15,4
23,168902,LORAINE ISD,14,english,3,0,,,,,0,,,,
23,168903,WESTBROOK ISD,14,english,3,14,3,11,8,4,14,5,9,6,5
23,169901,BOWIE ISD,9,english,3,122,27,95,49,4,122,38,84,36,10
23,169902,NOCONA ISD,9,english,3,42,9,33,16,6,42,9,33,15,8
23,169906,GOLD BURG ISD,9,english,3,10,3,7,5,2,10,2,8,4,1
23,169908,MONTAGUE ISD,9,english,3,15,3,12,8,4,15,4,11,6,1
23,169909,PRAIRIE VALLEY,9,english,3,11,5,6,4,2,11,7,4,4,1
23,169910,FORESTBURG ISD,9,english,3,13,4,9,6,0,13,4,9,3,1
23,169911,SAINT JO ISD,9,english,3,16,1,15,9,5,16,2,14,9,2
23,170801,TEXAS SERENITY,4,english,3,19,15,4,0,0,19,16,3,0,0
23,170802,THRIVE CENTER F,6,english,3,6,4,2,0,0,9,7,2,0,0
23,170902,CONROE ISD,6,english,3,4789,693,4096,3020,1362,4832,780,4052,2907,1487
23,170903,MONTGOMERY ISD,6,english,3,684,66,618,464,208,685,98,587,384,174
23,170904,WILLIS ISD,6,english,3,654,149,505,327,110,662,178,484,290,100
23,170906,MAGNOLIA ISD,6,english,3,941,167,774,563,255,969,208,761,501,225
23,170907,SPLENDORA ISD,6,english,3,338,123,215,116,18,347,153,194,91,23
23,170908,NEW CANEY ISD,6,english,3,1163,341,822,481,157,1165,392,773,399,135
23,171901,DUMAS ISD,16,english,3,315,78,237,161,56,318,90,228,129,39
23,171902,SUNRAY COLLEGIA,16,english,3,42,8,34,18,6,42,6,36,28,8
23,172902,DAINGERFIELD-LO,8,english,3,69,23,46,20,5,69,38,31,15,4
23,172905,PEWITT CISD,8,english,3,41,4,37,28,9,41,5,36,23,8
23,173901,MOTLEY COUNTY I,17,english,3,11,3,8,4,2,11,2,9,5,2
23,174801,STEPHEN F AUSTI,7,english,3,40,4,36,27,16,40,2,38,27,10
23,174901,CHIRENO ISD,7,english,3,28,7,21,10,2,28,12,16,8,2
23,174902,CUSHING ISD,7,english,3,35,5,30,19,3,35,6,29,17,4
23,174903,GARRISON ISD,7,english,3,51,15,36,14,2,51,18,33,14,2
23,174904,NACOGDOCHES ISD,7,english,3,352,147,205,100,28,381,193,188,78,23
23,174906,WODEN ISD,7,english,3,65,10,55,28,8,65,14,51,29,9
23,174908,CENTRAL HEIGHTS,7,english,3,88,11,77,57,16,88,17,71,50,10
23,174909,MARTINSVILLE IS,7,english,3,28,4,24,22,6,28,4,24,12,2
23,174911,DOUGLASS ISD,7,english,3,25,1,24,20,12,25,2,23,17,9
23,175902,BLOOMING GROVE,12,english,3,68,18,50,28,7,68,22,46,27,8
23,175903,CORSICANA ISD,12,english,3,409,163,246,123,30,433,192,241,90,26
23,175904,DAWSON ISD,12,english,3,44,8,36,21,9,44,6,38,24,7
23,175905,FROST ISD,12,english,3,40,13,27,16,4,40,10,30,20,7
23,175907,KERENS ISD,12,english,3,56,15,41,26,11,56,21,35,16,7
23,175910,MILDRED ISD,12,english,3,80,8,72,48,22,80,12,68,42,12
23,175911,RICE ISD,12,english,3,72,11,61,40,14,72,24,48,28,9
23,176901,BURKEVILLE ISD,5,english,3,13,3,10,4,1,13,5,8,3,0
23,176902,NEWTON ISD,5,english,3,64,20,44,26,6,65,22,43,19,4
23,176903,DEWEYVILLE ISD,5,english,3,35,15,20,14,1,35,11,24,15,2
23,177901,ROSCOE COLLEGIA,14,english,3,844,346,498,249,63,853,494,359,127,31
23,177902,SWEETWATER ISD,14,english,3,123,45,78,46,11,124,58,66,28,11
23,177903,BLACKWELL CISD,14,english,3,12,1,11,9,3,13,2,11,8,3
23,177905,HIGHLAND ISD,14,english,3,16,1,15,10,4,16,1,15,13,7
23,178801,DR M L GARZA-GO,2,english,3,12,1,11,7,1,12,3,9,3,1
23,178807,CORPUS CHRISTI,2,english,3,20,1,19,8,2,20,7,13,5,1
23,178808,SEASHORE CHARTE,2,english,3,43,2,41,27,6,43,6,37,18,6
23,178901,AGUA DULCE ISD,2,english,3,33,11,22,12,3,33,13,20,9,2
23,178902,BISHOP CISD,2,english,3,83,19,64,43,12,83,20,63,38,10
23,178903,CALALLEN ISD,2,english,3,306,65,241,170,62,305,55,250,172,67
23,178904,CORPUS CHRISTI,2,english,3,2349,596,1753,1104,419,2345,673,1672,971,380
23,178905,DRISCOLL ISD,2,english,3,23,3,20,13,3,23,9,14,8,1
23,178906,LONDON ISD,2,english,3,111,8,103,80,32,111,10,101,68,24
23,178908,PORT ARANSAS IS,2,english,3,35,6,29,17,8,36,5,31,18,8
23,178909,ROBSTOWN ISD,2,english,3,179,70,109,53,15,179,74,105,50,14
23,178912,TULOSO-MIDWAY I,2,english,3,303,81,222,123,41,307,123,184,92,24
23,178913,BANQUETE ISD,2,english,3,69,22,47,26,5,68,29,39,24,7
23,178914,FLOUR BLUFF ISD,2,english,3,339,56,283,185,64,340,60,280,171,78
23,178915,WEST OSO ISD,2,english,3,110,30,80,37,2,110,40,70,27,6
23,179901,PERRYTON ISD,16,english,3,146,24,122,87,33,146,16,130,79,22
23,180901,BOYS RANCH ISD,16,english,3,5,1,4,3,1,5,1,4,2,1
23,180902,VEGA ISD,16,english,3,26,1,25,23,11,26,1,25,22,12
23,180903,ADRIAN ISD,16,english,3,6,0,6,2,0,6,2,4,3,1
23,180904,WILDORADO ISD,16,english,3,14,3,11,6,1,14,4,10,4,1
23,181901,BRIDGE CITY ISD,5,english,3,242,26,216,146,65,241,37,204,126,44
23,181905,ORANGEFIELD ISD,5,english,3,135,21,114,72,24,135,30,105,69,21
23,181906,WEST ORANGE-COV,5,english,3,171,83,88,45,10,172,104,68,21,3
23,181907,VIDOR ISD,5,english,3,323,76,247,145,36,320,88,232,135,54
23,181908,LITTLE CYPRESS-,5,english,3,230,45,185,127,53,229,70,159,90,33
23,182901,GORDON ISD,11,english,3,23,4,19,10,6,23,7,16,8,2
23,182902,GRAFORD ISD,11,english,3,27,6,21,10,2,27,10,17,11,3
23,182903,MINERAL WELLS I,11,english,3,216,60,156,96,35,231,73,158,88,29
23,182904,SANTO ISD,11,english,3,31,1,30,29,19,31,1,30,25,11
23,182905,STRAWN ISD,11,english,3,12,5,7,3,1,13,8,5,2,0
23,182906,PALO PINTO ISD,11,english,3,9,0,9,9,6,9,0,9,9,6
23,183901,BECKVILLE ISD,7,english,3,49,9,40,22,4,50,24,26,9,4
23,183902,CARTHAGE ISD,7,english,3,176,28,148,101,31,175,23,152,81,27
23,183904,GARY ISD,7,english,3,39,6,33,17,7,39,9,30,12,3
23,184901,POOLVILLE ISD,11,english,3,61,8,53,29,2,61,10,51,31,11
23,184902,SPRINGTOWN ISD,11,english,3,312,75,237,121,40,319,86,233,145,66
23,184903,WEATHERFORD ISD,11,english,3,614,124,490,311,109,614,177,437,263,123
23,184904,MILLSAP ISD,11,english,3,75,20,55,31,8,75,22,53,26,9
23,184907,ALEDO ISD,11,english,3,611,48,563,447,225,606,75,531,383,212
23,184908,PEASTER ISD,11,english,3,134,27,107,68,25,135,32,103,65,27
23,184909,BROCK ISD,11,english,3,162,19,143,101,42,162,22,140,100,43
23,184911,GARNER ISD,11,english,3,25,7,18,10,4,25,6,19,9,4
23,185901,BOVINA ISD,16,english,3,28,12,16,5,2,28,18,10,1,1
23,185902,FARWELL ISD,16,english,3,36,1,35,24,10,36,4,32,19,5
23,185903,FRIONA ISD,16,english,3,82,35,47,20,3,82,42,40,10,1
23,185904,LAZBUDDIE ISD,16,english,3,8,1,7,3,0,9,2,7,2,1
23,186901,BUENA VISTA ISD,18,english,3,19,6,13,7,0,19,5,14,7,2
23,186902,FORT STOCKTON I,18,english,3,156,51,105,57,12,156,43,113,62,17
23,186903,IRAAN-SHEFFIELD,18,english,3,21,9,12,7,5,21,10,11,7,4
23,187901,BIG SANDY ISD,6,english,3,45,5,40,24,4,45,9,36,20,9
23,187903,GOODRICH ISD,6,english,3,19,7,12,7,3,19,11,8,1,0
23,187904,CORRIGAN-CAMDEN,6,english,3,59,19,40,22,9,58,9,49,30,11
23,187906,LEGGETT ISD,6,english,3,11,5,6,3,0,11,5,6,1,0
23,187907,LIVINGSTON ISD,6,english,3,267,57,210,128,38,268,53,215,118,46
23,187910,ONALASKA ISD,6,english,3,108,25,83,49,14,108,23,85,49,17
23,188901,AMARILLO ISD,16,english,3,2101,445,1656,1041,380,2216,555,1661,1033,421
23,188902,RIVER ROAD ISD,16,english,3,76,25,51,22,5,76,21,55,30,12
23,188903,HIGHLAND PARK I,16,english,3,57,16,41,22,7,58,19,39,22,4
23,188904,BUSHLAND ISD,16,english,3,102,14,88,55,14,102,17,85,52,24
23,189901,MARFA ISD,18,english,3,13,1,12,8,2,13,5,8,3,1
23,189902,PRESIDIO ISD,18,english,3,54,30,24,12,4,54,32,22,9,1
23,190903,RAINS ISD,7,english,3,129,29,100,53,17,128,61,67,25,8
23,191901,CANYON ISD,16,english,3,835,112,723,499,185,835,141,694,449,187
23,192901,REAGAN COUNTY I,18,english,3,65,15,50,29,7,65,17,48,21,7
23,193801,BIG SPRINGS CHA,20,english,3,8,5,3,2,0,8,4,4,2,1
23,193902,LEAKEY ISD,20,english,3,24,6,18,6,1,24,4,20,9,0
23,194902,AVERY ISD,8,english,3,19,1,18,10,3,19,2,17,13,3
23,194903,RIVERCREST ISD,8,english,3,55,6,49,28,5,55,8,47,22,4
23,194904,CLARKSVILLE ISD,8,english,3,38,17,21,9,2,38,13,25,10,4
23,194905,DETROIT ISD,8,english,3,33,11,22,12,0,33,10,23,9,2
23,195901,PECOS-BARSTOW-T,18,english,3,185,59,126,68,13,185,46,139,89,39
23,195902,BALMORHEA ISD,18,english,3,11,3,8,5,2,11,3,8,4,1
23,196901,AUSTWELL-TIVOLI,3,english,3,6,0,6,3,0,6,0,6,4,3
23,196902,WOODSBORO ISD,3,english,3,27,9,18,10,0,27,9,18,8,1
23,196903,REFUGIO ISD,3,english,3,45,14,31,11,2,45,25,20,5,3
23,197902,MIAMI ISD,16,english,3,17,2,15,8,2,17,5,12,5,2
23,198901,BREMOND ISD,6,english,3,38,5,33,27,9,38,5,33,18,5
23,198902,CALVERT ISD,6,english,3,11,7,4,1,0,11,6,5,0,0
23,198903,FRANKLIN ISD,6,english,3,90,8,82,63,24,91,8,83,58,22
23,198905,HEARNE ISD,6,english,3,51,34,17,8,1,51,38,13,3,1
23,198906,MUMFORD ISD,6,english,3,40,1,39,33,18,40,0,40,32,18
23,199901,ROCKWALL ISD,10,english,3,1316,186,1130,833,407,1332,239,1093,746,389
23,199902,ROYSE CITY ISD,10,english,3,592,122,470,294,123,620,152,468,294,123
23,200901,BALLINGER ISD,15,english,3,50,13,37,18,3,50,17,33,15,3
23,200902,MILES ISD,15,english,3,43,5,38,27,16,43,9,34,28,18
23,200904,WINTERS ISD,15,english,3,34,5,29,15,6,34,9,25,15,5
23,200906,OLFEN ISD,15,english,3,15,2,13,7,2,15,8,7,4,1
23,201902,HENDERSON ISD,7,english,3,221,83,138,77,25,221,96,125,61,15
23,201903,LANEVILLE ISD,7,english,3,12,3,9,4,0,12,5,7,3,1
23,201904,LEVERETTS CHAPE,7,english,3,18,5,13,7,3,17,8,9,5,2
23,201907,MOUNT ENTERPRIS,7,english,3,24,4,20,11,4,24,6,18,14,5
23,201908,OVERTON ISD,7,english,3,30,5,25,13,8,30,8,22,11,6
23,201910,TATUM ISD,7,english,3,96,18,78,54,14,96,20,76,51,19
23,201913,CARLISLE ISD,7,english,3,43,10,33,24,7,43,12,31,15,6
23,201914,WEST RUSK COUNT,7,english,3,71,12,59,36,11,71,21,50,18,6
23,202903,HEMPHILL ISD,7,english,3,56,15,41,23,7,56,17,39,24,10
23,202905,WEST SABINE ISD,7,english,3,41,11,30,18,4,41,7,34,20,8
23,203901,SAN AUGUSTINE I,7,english,3,30,13,17,12,3,30,11,19,9,3
23,203902,BROADDUS ISD,7,english,3,20,2,18,10,3,19,1,18,10,3
23,204901,COLDSPRING-OAKH,6,english,3,128,54,74,36,8,128,64,64,20,8
23,204904,SHEPHERD ISD,6,english,3,117,37,80,39,10,118,42,76,38,10
23,205901,ARANSAS PASS IS,2,english,3,122,34,88,44,10,121,46,75,29,6
23,205902,GREGORY-PORTLAN,2,english,3,355,70,285,195,86,353,74,279,200,90
23,205903,INGLESIDE ISD,2,english,3,166,34,132,71,26,166,45,121,53,17
23,205904,MATHIS ISD,2,english,3,92,13,79,51,22,92,20,72,40,12
23,205905,ODEM-EDROY ISD,2,english,3,67,14,53,38,13,67,16,51,28,7
23,205906,SINTON ISD,2,english,3,150,39,111,63,18,151,46,105,65,20
23,205907,TAFT ISD,2,english,3,53,19,34,13,2,52,21,31,12,4
23,206901,SAN SABA ISD,15,english,3,51,11,40,22,2,51,12,39,23,5
23,206902,RICHLAND SPRING,15,english,3,14,6,8,2,0,14,7,7,0,0
23,206903,CHEROKEE ISD,15,english,3,8,1,7,2,0,8,5,3,0,0
23,207901,SCHLEICHER ISD,15,english,3,28,4,24,13,0,28,9,19,11,1
23,208901,HERMLEIGH ISD,14,english,3,17,6,11,6,1,17,8,9,4,2
23,208902,SNYDER ISD,14,english,3,153,57,96,51,8,166,68,98,59,20
23,208903,IRA ISD,14,english,3,22,0,22,15,7,22,3,19,11,3
23,209901,ALBANY ISD,14,english,3,32,7,25,11,3,32,4,28,12,3
23,209902,MORAN ISD,14,english,3,8,1,7,5,1,8,2,6,5,0
23,210901,CENTER ISD,7,english,3,159,29,130,86,24,160,29,131,75,24
23,210902,JOAQUIN ISD,7,english,3,42,13,29,18,3,42,14,28,20,6
23,210903,SHELBYVILLE ISD,7,english,3,59,8,51,35,11,59,10,49,38,19
23,210904,TENAHA ISD,7,english,3,20,5,15,11,2,20,7,13,7,3
23,210905,TIMPSON ISD,7,english,3,56,17,39,21,7,57,21,36,23,9
23,210906,EXCELSIOR ISD,7,english,3,8,4,4,1,0,8,4,4,1,0
23,211901,TEXHOMA ISD,16,english,3,14,0,14,12,0,14,3,11,8,2
23,211902,STRATFORD ISD,16,english,3,31,8,23,13,5,31,13,18,11,3
23,212801,CUMBERLAND ACAD,7,english,3,158,44,114,65,28,158,69,89,47,14
23,212804,UT TYLER UNIVER,7,english,3,81,8,73,47,12,81,17,64,42,14
23,212901,ARP ISD,7,english,3,67,16,51,32,10,67,15,52,22,6
23,212902,BULLARD ISD,7,english,3,209,25,184,122,47,211,35,176,112,55
23,212903,LINDALE ISD,7,english,3,346,49,297,231,107,348,30,318,238,120
23,212904,TROUP ISD,7,english,3,77,10,67,48,19,78,20,58,32,8
23,212905,TYLER ISD,7,english,3,1341,388,953,601,248,1406,438,968,592,237
23,212906,WHITEHOUSE ISD,7,english,3,324,34,290,216,105,324,36,288,217,106
23,212909,CHAPEL HILL ISD,7,english,3,173,36,137,90,35,224,51,173,105,46
23,212910,WINONA ISD,7,english,3,80,33,47,22,4,80,36,44,18,4
23,213901,GLEN ROSE ISD,11,english,3,136,15,121,94,26,135,21,114,76,36
23,214901,RIO GRANDE CITY,1,english,3,611,189,422,230,75,610,215,395,241,71
23,214902,SAN ISIDRO ISD,1,english,3,13,5,8,3,1,13,7,6,2,0
23,214903,ROMA ISD,1,english,3,420,33,387,336,210,419,19,400,354,220
23,215901,BRECKENRIDGE IS,14,english,3,98,23,75,48,14,98,17,81,43,16
23,216901,STERLING CITY I,15,english,3,26,2,24,18,8,26,5,21,15,6
23,217901,ASPERMONT ISD,14,english,3,16,5,11,8,2,16,3,13,6,0
23,218901,SONORA ISD,15,english,3,49,18,31,15,3,49,11,38,12,4
23,219901,HAPPY ISD,16,english,3,11,2,9,5,1,11,5,6,4,3
23,219903,TULIA ISD,16,english,3,71,31,40,23,2,70,31,39,18,2
23,219905,KRESS ISD,16,english,3,15,7,8,2,2,15,6,9,4,2
23,220801,TREETOPS SCHOOL,11,english,3,32,2,30,23,4,32,4,28,25,13
23,220802,ARLINGTON CLASS,11,english,3,171,10,161,120,56,170,8,162,116,64
23,220809,FORT WORTH ACAD,11,english,3,37,2,35,32,16,37,2,35,29,12
23,220810,WESTLAKE ACADEM,11,english,3,56,2,54,46,27,56,2,54,42,24
23,220811,EAST FORT WORTH,11,english,3,24,6,18,11,5,23,5,18,9,2
23,220814,TEXAS SCHOOL OF,11,english,3,37,7,30,23,11,37,11,26,15,6
23,220815,CHAPEL HILL ACA,11,english,3,69,24,45,21,2,69,12,57,36,14
23,220817,NEWMAN INTERNAT,11,english,3,242,47,195,114,44,242,68,174,104,35
23,220819,HIGH POINT ACAD,11,english,3,153,30,123,80,26,153,40,113,56,21
23,220820,ROCKETSHIP PUBL,11,english,3,44,25,19,10,4,44,26,18,4,3
23,220901,ARLINGTON ISD,11,english,3,3346,1142,2204,1310,394,3529,1357,2172,1164,437
23,220902,BIRDVILLE ISD,11,english,3,1381,301,1080,708,293,1374,336,1038,599,263
23,220904,EVERMAN ISD,11,english,3,338,117,221,120,34,363,125,238,102,37
23,220905,FORT WORTH ISD,11,english,3,4439,1786,2653,1433,446,4854,2094,2760,1299,458
23,220906,GRAPEVINE-COLLE,11,english,3,879,135,744,590,290,826,131,695,499,260
23,220907,KELLER ISD,11,english,3,2280,315,1965,1386,558,2321,438,1883,1271,632
23,220908,MANSFIELD ISD,11,english,3,2428,437,1991,1338,504,2432,544,1888,1238,541
23,220910,LAKE WORTH ISD,11,english,3,210,98,112,52,7,232,142,90,36,8
23,220912,CROWLEY ISD,11,english,3,1028,278,750,456,161,1109,361,748,392,143
23,220914,KENNEDALE ISD,11,english,3,163,65,98,55,11,164,60,104,51,16
23,220915,AZLE ISD,11,english,3,538,112,426,263,93,547,158,389,208,72
23,220916,HURST-EULESS-BE,11,english,3,1475,264,1211,858,383,1477,324,1153,781,374
23,220917,CASTLEBERRY ISD,11,english,3,215,68,147,96,32,259,103,156,76,32
23,220918,EAGLE MT-SAGINA,11,english,3,1662,430,1232,766,247,1689,562,1127,632,245
23,220919,CARROLL ISD,11,english,3,595,13,582,518,342,592,18,574,501,364
23,220920,WHITE SETTLEMEN,11,english,3,456,73,383,243,88,451,119,332,198,73
23,221801,TEXAS COLLEGE P,14,english,3,1393,288,1105,752,273,1392,373,1019,599,268
23,221901,ABILENE ISD,14,english,3,1003,291,712,426,144,1017,356,661,355,144
23,221904,MERKEL ISD,14,english,3,63,11,52,23,7,63,18,45,33,12
23,221905,TRENT ISD,14,english,3,10,3,7,5,0,10,4,6,1,0
23,221911,JIM NED CISD,14,english,3,118,7,111,89,35,118,14,104,64,23
23,221912,WYLIE ISD,14,english,3,423,42,381,275,103,424,51,373,229,91
23,222901,TERRELL COUNTY,18,english,3,9,3,6,4,2,9,2,7,3,2
23,223901,BROWNFIELD ISD,17,english,3,109,58,51,23,7,110,58,52,18,7
23,223902,MEADOW ISD,17,english,3,19,5,14,5,1,19,5,14,6,1
23,223904,WELLMAN-UNION C,17,english,3,28,6,22,15,5,28,9,19,10,3
23,224901,THROCKMORTON CO,9,english,3,7,0,7,4,2,7,1,6,2,0
23,224902,WOODSON ISD,9,english,3,14,4,10,8,4,14,6,8,6,1
23,225902,MOUNT PLEASANT,8,english,3,228,43,185,129,53,336,85,251,155,49
23,225906,CHAPEL HILL ISD,8,english,3,76,11,65,45,17,76,23,53,34,17
23,225907,HARTS BLUFF ISD,8,english,3,59,13,46,28,14,78,20,58,30,9
23,226801,TEXAS LEADERSHI,15,english,3,313,107,206,100,26,313,137,176,80,23
23,226901,CHRISTOVAL ISD,15,english,3,42,7,35,20,3,43,13,30,16,2
23,226903,SAN ANGELO ISD,15,english,3,962,304,658,368,115,958,355,603,300,114
23,226905,WATER VALLEY IS,15,english,3,21,4,17,7,1,21,3,18,10,3
23,226906,WALL ISD,15,english,3,114,13,101,80,25,114,6,108,86,38
23,226907,GRAPE CREEK ISD,15,english,3,90,21,69,34,11,90,22,68,31,10
23,226908,VERIBEST ISD,15,english,3,12,2,10,6,2,12,4,8,5,0
23,227803,WAYSIDE SCHOOLS,13,english,3,128,47,81,52,19,167,62,105,59,18
23,227804,NYOS CHARTER SC,13,english,3,143,19,124,89,52,143,33,110,66,40
23,227805,TEXAS EMPOWERME,13,english,3,29,11,18,5,1,27,14,13,3,0
23,227806,UNIVERSITY OF T,13,english,3,8,4,4,3,1,8,4,4,2,1
23,227814,CHAPARRAL STAR,13,english,3,30,1,29,25,17,30,2,28,22,16
23,227816,HARMONY PUBLIC,13,english,3,372,80,292,214,108,372,91,281,183,99
23,227817,CEDARS INTERNAT,13,english,3,35,14,21,6,1,36,15,21,7,3
23,227819,UNIVERSITY OF T,13,english,3,42,10,32,23,8,42,15,27,14,3
23,227820,KIPP TEXAS PUBL,4,english,3,2301,791,1510,901,293,2301,956,1345,665,218
23,227821,AUSTIN DISCOVER,13,english,3,49,21,28,16,6,49,25,24,7,0
23,227824,VALERE PUBLIC S,13,english,3,79,21,58,32,14,80,15,65,31,13
23,227825,AUSTIN ACHIEVE,13,english,3,148,66,82,36,7,145,60,85,37,11
23,227826,MONTESSORI FOR,13,english,3,53,15,38,26,6,55,22,33,13,3
23,227829,VALOR PUBLIC SC,13,english,3,224,34,190,118,42,224,60,164,121,58
23,227901,AUSTIN ISD,13,english,3,4362,935,3427,2494,1212,4979,1471,3508,2270,1097
23,227904,PFLUGERVILLE IS,13,english,3,1576,301,1275,909,420,1756,436,1320,864,436
23,227905,TEXAS SCH FOR T,13,english,3,0,,,,,0,,,,
23,227906,TEXAS SCH FOR T,13,english,3,14,9,5,0,0,14,11,3,1,0
23,227907,MANOR ISD,13,english,3,538,204,334,178,59,558,217,341,163,55
23,227909,EANES ISD,13,english,3,501,32,469,384,179,498,37,461,361,217
23,227910,DEL VALLE ISD,13,english,3,415,172,243,116,39,642,293,349,159,36
23,227912,LAGO VISTA ISD,13,english,3,112,21,91,63,24,111,25,86,54,16
23,227913,LAKE TRAVIS ISD,13,english,3,806,80,726,531,218,831,121,710,502,236
23,228901,GROVETON ISD,6,english,3,42,4,38,17,4,42,8,34,13,7
23,228903,TRINITY ISD,6,english,3,90,33,57,31,5,90,48,42,12,6
23,228904,CENTERVILLE ISD,6,english,3,13,4,9,4,0,13,8,5,0,0
23,228905,APPLE SPRINGS I,6,english,3,11,5,6,3,1,11,5,6,4,1
23,229901,COLMESNEIL ISD,5,english,3,33,4,29,19,7,33,6,27,18,3
23,229903,WOODVILLE ISD,5,english,3,71,25,46,26,7,72,39,33,16,5
23,229904,WARREN ISD,5,english,3,92,15,77,56,25,90,26,64,30,9
23,229905,SPURGER ISD,5,english,3,22,3,19,7,0,22,5,17,6,0
23,229906,CHESTER ISD,5,english,3,10,1,9,5,2,10,2,8,7,1
23,230901,BIG SANDY ISD,7,english,3,52,13,39,26,10,52,13,39,26,10
23,230902,GILMER ISD,7,english,3,202,44,158,101,33,199,36,163,113,48
23,230903,ORE CITY ISD,7,english,3,70,26,44,24,5,71,31,40,16,5
23,230904,UNION HILL ISD,7,english,3,20,4,16,10,5,20,6,14,7,1
23,230905,HARMONY ISD,7,english,3,78,11,67,43,12,78,13,65,36,15
23,230906,NEW DIANA ISD,7,english,3,91,3,88,76,46,91,6,85,67,39
23,230908,UNION GROVE ISD,7,english,3,63,13,50,32,9,63,13,50,28,13
23,231901,MCCAMEY ISD,18,english,3,37,11,26,11,1,37,16,21,12,3
23,231902,RANKIN ISD,18,english,3,18,1,17,10,3,18,2,16,13,5
23,232901,KNIPPA ISD,20,english,3,38,1,37,29,8,38,6,32,22,6
23,232902,SABINAL ISD,20,english,3,28,10,18,13,2,28,8,20,11,3
23,232903,UVALDE CISD,20,english,3,243,98,145,75,14,227,116,111,48,10
23,232904,UTOPIA ISD,20,english,3,15,5,10,4,2,15,5,10,0,0
23,233901,SAN FELIPE-DEL,15,english,3,686,196,490,294,93,685,230,455,218,62
23,233903,COMSTOCK ISD,15,english,3,19,1,18,13,2,19,1,18,14,3
23,234902,CANTON ISD,10,english,3,169,22,147,95,23,169,17,152,98,25
23,234903,EDGEWOOD ISD,7,english,3,78,12,66,45,14,79,17,62,42,14
23,234904,GRAND SALINE IS,7,english,3,84,27,57,31,5,84,13,71,46,18
23,234905,MARTINS MILL IS,7,english,3,34,6,28,14,4,36,11,25,8,3
23,234906,VAN ISD,7,english,3,154,42,112,57,16,154,55,99,49,14
23,234907,WILLS POINT ISD,10,english,3,174,66,108,53,18,178,64,114,51,20
23,234909,FRUITVALE ISD,7,english,3,26,5,21,14,5,26,5,21,9,3
23,235901,BLOOMINGTON ISD,3,english,3,45,14,31,16,1,45,17,28,16,3
23,235902,VICTORIA ISD,3,english,3,861,251,610,361,112,860,359,501,272,98
23,235904,NURSERY ISD,3,english,3,13,2,11,10,3,13,1,12,9,8
23,236802,SAM HOUSTON STA,6,english,3,70,8,62,47,29,70,11,59,44,27
23,236901,NEW WAVERLY ISD,6,english,3,87,14,73,52,14,87,17,70,43,15
23,236902,HUNTSVILLE ISD,6,english,3,495,157,338,194,65,491,182,309,149,49
23,237902,HEMPSTEAD ISD,4,english,3,107,62,45,15,4,106,70,36,14,6
23,237904,WALLER ISD,4,english,3,639,170,469,289,109,640,161,479,295,129
23,237905,ROYAL ISD,4,english,3,180,89,91,40,8,178,72,106,40,11
23,238902,MONAHANS-WICKET,18,english,3,167,40,127,74,22,167,53,114,61,19
23,238904,GRANDFALLS-ROYA,18,english,3,11,4,7,3,0,11,6,5,1,0
23,239901,BRENHAM ISD,6,english,3,315,75,240,144,49,314,98,216,133,52
23,239903,BURTON ISD,6,english,3,45,6,39,35,17,45,4,41,36,16
23,240901,LAREDO ISD,1,english,3,1389,378,1011,657,300,1386,380,1006,534,190
23,240903,UNITED ISD,1,english,3,2688,534,2154,1495,689,2692,565,2127,1313,497
23,240904,WEBB CISD,1,english,3,17,3,14,8,1,17,4,13,10,3
23,241901,BOLING ISD,3,english,3,74,11,63,41,15,74,16,58,36,9
23,241902,EAST BERNARD IS,3,english,3,72,10,62,43,21,71,11,60,38,16
23,241903,EL CAMPO ISD,3,english,3,219,60,159,97,29,222,67,155,87,36
23,241904,WHARTON ISD,3,english,3,121,43,78,36,10,119,46,73,33,7
23,241906,LOUISE ISD,3,english,3,39,15,24,11,4,39,15,24,14,5
23,242902,SHAMROCK ISD,16,english,3,19,3,16,8,1,19,7,12,4,0
23,242903,WHEELER ISD,16,english,3,32,4,28,15,4,32,4,28,19,5
23,242905,KELTON ISD,16,english,3,12,4,8,2,1,12,4,8,5,2
23,242906,FORT ELLIOTT CI,16,english,3,10,3,7,3,1,10,3,7,3,1
23,243901,BURKBURNETT ISD,9,english,3,233,53,180,104,36,230,55,175,99,40
23,243902,ELECTRA ISD,9,english,3,40,16,24,9,0,40,14,26,10,3
23,243903,IOWA PARK CISD,9,english,3,160,20,140,90,37,161,30,131,72,22
23,243905,WICHITA FALLS I,9,english,3,948,295,653,352,107,959,356,603,319,119
23,243906,CITY VIEW ISD,9,english,3,70,21,49,30,5,69,25,44,25,10
23,244901,HARROLD ISD,9,english,3,15,3,12,6,2,15,6,9,1,0
23,244903,VERNON ISD,9,english,3,116,43,73,39,11,116,39,77,35,15
23,244905,NORTHSIDE ISD,9,english,3,18,0,18,16,5,18,1,17,10,2
23,245901,LASARA ISD,1,english,3,22,8,14,8,1,22,9,13,7,1
23,245902,LYFORD CISD,1,english,3,66,27,39,7,2,66,36,30,9,3
23,245903,RAYMONDVILLE IS,1,english,3,140,30,110,72,26,138,32,106,56,21
23,245904,SAN PERLITA ISD,1,english,3,11,3,8,4,2,11,2,9,6,2
23,246801,MERIDIAN WORLD,13,english,3,153,11,142,109,57,153,19,134,97,43
23,246802,GOODWATER MONTE,13,english,3,51,18,33,12,4,52,25,27,12,4
23,246902,FLORENCE ISD,13,english,3,72,23,49,23,7,75,21,54,30,6
23,246904,GEORGETOWN ISD,13,english,3,918,235,683,424,131,934,287,647,340,130
23,246905,GRANGER ISD,13,english,3,42,17,25,13,2,42,17,25,11,3
23,246906,HUTTO ISD,13,english,3,726,125,601,397,140,749,190,559,323,128
23,246907,JARRELL ISD,13,english,3,262,117,145,73,14,264,125,139,62,22
23,246908,LIBERTY HILL IS,13,english,3,667,70,597,442,193,667,116,551,385,171
23,246909,ROUND ROCK ISD,13,english,3,3164,471,2693,2073,1105,3201,574,2627,1944,1124
23,246911,TAYLOR ISD,13,english,3,209,89,120,60,16,209,93,116,55,18
23,246912,THRALL ISD,13,english,3,66,4,62,49,23,66,4,62,46,25
23,246913,LEANDER ISD,13,english,3,3004,426,2578,1872,842,3046,607,2439,1628,760
23,246914,COUPLAND ISD,13,english,3,28,9,19,10,1,28,9,19,8,4
23,247901,FLORESVILLE ISD,20,english,3,275,93,182,97,35,280,110,170,88,34
23,247903,LA VERNIA ISD,20,english,3,261,37,224,150,55,264,57,207,126,55
23,247904,POTH ISD,20,english,3,81,15,66,39,11,81,25,56,25,6
23,247906,STOCKDALE ISD,20,english,3,60,8,52,38,12,60,11,49,32,15
23,248901,KERMIT ISD,18,english,3,85,27,58,31,5,84,27,57,28,9
23,248902,WINK-LOVING ISD,18,english,3,25,5,20,9,1,25,8,17,9,4
23,249901,ALVORD ISD,11,english,3,51,8,43,27,12,51,10,41,27,9
23,249902,BOYD ISD,11,english,3,83,26,57,37,10,83,25,58,34,11
23,249903,BRIDGEPORT ISD,11,english,3,118,50,68,43,9,127,49,78,36,13
23,249904,CHICO ISD,11,english,3,40,6,34,14,3,40,6,34,20,5
23,249905,DECATUR ISD,11,english,3,282,68,214,124,41,289,79,210,120,51
23,249906,PARADISE ISD,11,english,3,116,25,91,61,21,116,20,96,59,30
23,249908,SLIDELL ISD,11,english,3,35,9,26,10,1,35,10,25,10,3
23,250902,HAWKINS ISD,7,english,3,55,11,44,27,7,55,11,44,28,10
23,250903,MINEOLA ISD,7,english,3,124,19,105,64,22,123,23,100,58,16
23,250904,QUITMAN ISD,7,english,3,89,13,76,52,15,90,10,80,61,21
23,250905,YANTIS ISD,7,english,3,25,3,22,13,3,25,5,20,11,3
23,250906,ALBA-GOLDEN ISD,7,english,3,54,8,46,27,5,54,13,41,24,9
23,250907,WINNSBORO ISD,7,english,3,100,19,81,55,14,100,20,80,43,7
23,251901,DENVER CITY ISD,17,english,3,101,25,76,51,19,101,36,65,31,6
23,251902,PLAINS ISD,17,english,3,28,8,20,11,2,27,9,18,7,1
23,252901,GRAHAM ISD,9,english,3,145,40,105,47,16,148,53,95,48,11
23,252902,NEWCASTLE ISD,9,english,3,11,0,11,5,0,11,1,10,4,1
23,252903,OLNEY ISD,9,english,3,53,9,44,25,12,53,23,30,12,4
23,253901,ZAPATA COUNTY I,1,english,3,237,77,160,96,26,236,76,160,106,49
23,254901,CRYSTAL CITY IS,20,english,3,124,49,75,32,7,124,48,76,35,17
23,254902,LA PRYOR ISD,20,english,3,29,4,25,19,7,29,4,25,12,3
23,1904,FRANKSTON ISD,7,spanish,3,0,,,,,0,,,,
23,1907,PALESTINE ISD,7,spanish,3,13,5,8,3,1,0,,,,
23,1908,WESTWOOD ISD,7,spanish,3,0,,,,,0,,,,
23,2901,ANDREWS ISD,18,spanish,3,19,8,11,3,3,6,3,3,2,0
23,3903,LUFKIN ISD,7,spanish,3,5,2,3,2,0,5,4,1,0,0
23,3905,DIBOLL ISD,7,spanish,3,0,,,,,0,,,,
23,5902,HOLLIDAY ISD,9,spanish,3,0,,,,,0,,,,
23,7901,CHARLOTTE ISD,20,spanish,3,0,,,,,0,,,,
23,7905,PLEASANTON ISD,20,spanish,3,8,6,2,0,0,6,3,3,1,0
23,7906,POTEET ISD,20,spanish,3,5,1,4,3,1,5,1,4,3,0
23,8902,SEALY ISD,6,spanish,3,22,4,18,6,5,0,,,,
23,10902,BANDERA ISD,20,spanish,3,0,,,,,0,,,,
23,11901,BASTROP ISD,13,spanish,3,21,18,3,1,0,15,9,6,1,0
23,11902,ELGIN ISD,13,spanish,3,100,45,55,26,11,5,2,3,0,0
23,14903,BELTON ISD,12,spanish,3,39,23,16,6,2,0,,,,
23,14905,HOLLAND ISD,12,spanish,3,0,,,,,0,,,,
23,14906,KILLEEN ISD,12,spanish,3,22,10,12,4,2,22,13,9,3,3
23,14909,TEMPLE ISD,12,spanish,3,30,16,14,6,2,6,1,5,1,0
23,15802,GEORGE GERVIN A,20,spanish,3,23,9,14,7,4,23,8,15,9,4
23,15822,JUBILEE ACADEMI,20,spanish,3,14,7,7,4,1,14,6,8,6,2
23,15828,HARMONY PUBLIC,20,spanish,3,11,8,3,1,0,0,,,,
23,15830,BROOKS ACADEMIE,20,spanish,3,0,,,,,0,,,,
23,15838,COMPASS ROSE PU,20,spanish,3,0,,,,,0,,,,
23,15843,PRELUDE PREPARA,20,spanish,3,0,,,,,0,,,,
23,15901,ALAMO HEIGHTS I,20,spanish,3,12,2,10,5,3,11,6,5,2,0
23,15904,HARLANDALE ISD,20,spanish,3,158,92,66,21,9,178,85,93,34,7
23,15905,EDGEWOOD ISD,20,spanish,3,133,79,54,21,12,43,21,22,4,0
23,15907,SAN ANTONIO ISD,20,spanish,3,637,311,326,147,83,658,275,383,163,49
23,15908,SOUTH SAN ANTON,20,spanish,3,94,60,34,16,8,93,58,35,15,4
23,15909,SOMERSET ISD,20,spanish,3,35,16,19,9,6,9,2,7,2,1
23,15910,NORTH EAST ISD,20,spanish,3,622,222,400,226,142,647,200,447,234,98
23,15911,EAST CENTRAL IS,20,spanish,3,61,27,34,13,6,60,23,37,13,3
23,15912,SOUTHWEST ISD,20,spanish,3,39,22,17,8,6,44,19,25,9,2
23,15915,NORTHSIDE ISD,20,spanish,3,386,168,218,100,50,424,155,269,133,34
23,15916,JUDSON ISD,20,spanish,3,50,33,17,9,1,48,25,23,7,2
23,15917,SOUTHSIDE ISD,20,spanish,3,100,49,51,31,18,99,27,72,35,11
23,18901,CLIFTON ISD,12,spanish,3,0,,,,,0,,,,
23,19907,TEXARKANA ISD,8,spanish,3,31,16,15,5,2,7,6,1,0,0
23,20901,ALVIN ISD,4,spanish,3,105,47,58,16,4,74,39,35,7,1
23,20902,ANGLETON ISD,4,spanish,3,0,,,,,0,,,,
23,20905,BRAZOSPORT ISD,4,spanish,3,15,3,12,8,7,8,2,6,3,0
23,20908,PEARLAND ISD,4,spanish,3,10,8,2,1,0,9,5,4,1,0
23,21901,COLLEGE STATION,6,spanish,3,28,21,7,2,1,36,17,19,1,0
23,21902,BRYAN ISD,6,spanish,3,22,12,10,8,5,20,9,11,4,1
23,22004,TERLINGUA CSD,18,spanish,3,0,,,,,0,,,,
23,26901,CALDWELL ISD,6,spanish,3,0,,,,,0,,,,
23,27903,BURNET CISD,13,spanish,3,0,,,,,0,,,,
23,27904,MARBLE FALLS IS,13,spanish,3,39,18,21,7,5,7,6,1,0,0
23,28902,LOCKHART ISD,13,spanish,3,75,44,31,10,6,64,40,24,4,0
23,31901,BROWNSVILLE ISD,1,spanish,3,77,38,39,17,10,74,31,43,19,2
23,31903,HARLINGEN CISD,1,spanish,3,16,9,7,1,1,14,8,6,2,0
23,31906,LOS FRESNOS CIS,1,spanish,3,0,,,,,0,,,,
23,31909,POINT ISABEL IS,1,spanish,3,5,3,2,1,1,0,,,,
23,31911,RIO HONDO ISD,1,spanish,3,0,,,,,0,,,,
23,31912,SAN BENITO CISD,1,spanish,3,20,11,9,3,3,14,6,8,3,0
23,35901,DIMMITT ISD,16,spanish,3,0,,,,,0,,,,
23,35902,HART ISD,16,spanish,3,0,,,,,0,,,,
23,36902,BARBERS HILL IS,4,spanish,3,0,,,,,0,,,,
23,36903,EAST CHAMBERS I,5,spanish,3,0,,,,,0,,,,
23,37904,JACKSONVILLE IS,7,spanish,3,95,31,64,34,17,0,,,,
23,37907,RUSK ISD,7,spanish,3,0,,,,,0,,,,
23,40901,MORTON ISD,17,spanish,3,0,,,,,0,,,,
23,43901,ALLEN ISD,10,spanish,3,11,10,1,0,0,11,3,8,0,0
23,43902,ANNA ISD,10,spanish,3,18,6,12,6,1,0,,,,
23,43903,CELINA ISD,10,spanish,3,0,,,,,0,,,,
23,43904,FARMERSVILLE IS,10,spanish,3,0,,,,,0,,,,
23,43905,FRISCO ISD,10,spanish,3,41,22,19,11,3,22,16,6,1,0
23,43907,MCKINNEY ISD,10,spanish,3,92,48,44,17,10,77,45,32,11,3
23,43910,PLANO ISD,10,spanish,3,337,171,166,68,35,360,163,197,83,22
23,43911,PRINCETON ISD,10,spanish,3,0,,,,,0,,,,
23,43914,WYLIE ISD,10,spanish,3,36,5,31,20,13,0,,,,
23,43917,BLUE RIDGE ISD,10,spanish,3,0,,,,,0,,,,
23,43918,COMMUNITY ISD,10,spanish,3,34,17,17,6,1,5,2,3,0,0
23,46901,NEW BRAUNFELS I,20,spanish,3,34,14,20,8,5,17,6,11,3,0
23,46902,COMAL ISD,20,spanish,3,7,2,5,3,1,5,2,3,2,0
23,47901,COMANCHE ISD,14,spanish,3,0,,,,,0,,,,
23,49901,GAINESVILLE ISD,11,spanish,3,28,14,14,8,4,0,,,,
23,50901,EVANT ISD,12,spanish,3,0,,,,,0,,,,
23,50910,COPPERAS COVE I,12,spanish,3,0,,,,,0,,,,
23,52901,CRANE ISD,15,spanish,3,0,,,,,0,,,,
23,56901,DALHART ISD,16,spanish,3,0,,,,,0,,,,
23,57803,UPLIFT EDUCATIO,10,spanish,3,0,,,,,0,,,,
23,57807,LIFE SCHOOL,10,spanish,3,6,3,3,1,0,6,5,1,1,0
23,57808,UNIVERSAL ACADE,10,spanish,3,0,,,,,0,,,,
23,57835,GOLDEN RULE CHA,10,spanish,3,9,3,6,1,0,8,4,4,1,0
23,57841,CITYSCAPE SCHOO,10,spanish,3,32,15,17,11,3,0,,,,
23,57848,INTERNATIONAL L,10,spanish,3,62,44,18,4,1,62,35,27,9,1
23,57903,CARROLLTON-FARM,10,spanish,3,409,141,268,153,102,79,47,32,13,3
23,57904,CEDAR HILL ISD,10,spanish,3,0,,,,,0,,,,
23,57905,DALLAS ISD,10,spanish,3,3518,1467,2051,1089,628,307,160,147,40,9
23,57906,DESOTO ISD,10,spanish,3,24,20,4,1,0,9,8,1,0,0
23,57907,DUNCANVILLE ISD,10,spanish,3,139,64,75,36,19,17,12,5,2,0
23,57909,GARLAND ISD,10,spanish,3,828,302,526,254,138,106,52,54,20,7
23,57910,GRAND PRAIRIE I,10,spanish,3,449,192,257,123,69,38,19,19,5,1
23,57912,IRVING ISD,10,spanish,3,568,335,233,93,36,429,250,179,52,10
23,57913,LANCASTER ISD,10,spanish,3,20,8,12,7,3,5,1,4,1,0
23,57914,MESQUITE ISD,10,spanish,3,357,184,173,65,39,330,120,210,85,22
23,57916,RICHARDSON ISD,10,spanish,3,230,128,102,52,25,142,81,61,23,3
23,57922,COPPELL ISD,10,spanish,3,15,10,5,3,2,14,7,7,3,1
23,59901,HEREFORD ISD,16,spanish,3,0,,,,,0,,,,
23,61805,TRIVIUM ACADEMY,11,spanish,3,0,,,,,0,,,,
23,61901,DENTON ISD,11,spanish,3,155,82,73,38,14,36,26,10,2,0
23,61902,LEWISVILLE ISD,11,spanish,3,194,112,82,37,23,195,106,89,31,4
23,61903,PILOT POINT ISD,11,spanish,3,25,12,13,8,0,0,,,,
23,61905,KRUM ISD,11,spanish,3,0,,,,,0,,,,
23,61911,NORTHWEST ISD,11,spanish,3,16,5,11,5,2,9,4,5,0,0
23,61912,LAKE DALLAS ISD,11,spanish,3,9,8,1,1,0,8,8,0,0,0
23,61914,LITTLE ELM ISD,11,spanish,3,44,26,18,6,2,16,12,4,1,0
23,62901,CUERO ISD,3,spanish,3,0,,,,,0,,,,
23,68901,ECTOR COUNTY IS,18,spanish,3,378,189,189,81,31,349,171,178,46,11
23,70801,WAXAHACHIE FAIT,10,spanish,3,74,57,17,4,1,38,29,9,4,0
23,70903,ENNIS ISD,10,spanish,3,5,1,4,2,1,0,,,,
23,70905,FERRIS ISD,10,spanish,3,34,13,21,7,3,0,,,,
23,70908,MIDLOTHIAN ISD,10,spanish,3,11,2,9,4,2,0,,,,
23,70911,RED OAK ISD,10,spanish,3,16,8,8,6,3,0,,,,
23,70912,WAXAHACHIE ISD,10,spanish,3,21,8,13,5,0,0,,,,
23,71801,BURNHAM WOOD CH,19,spanish,3,14,6,8,4,3,14,4,10,5,1
23,71806,HARMONY PUBLIC,19,spanish,3,11,5,6,5,3,8,4,4,1,0
23,71807,LA FE PREPARATO,19,spanish,3,23,11,12,5,1,23,8,15,8,2
23,71809,VISTA DEL FUTUR,19,spanish,3,8,2,6,4,1,9,3,6,3,2
23,71901,CLINT ISD,19,spanish,3,94,37,57,21,10,88,40,48,16,4
23,71902,EL PASO ISD,19,spanish,3,563,217,346,172,105,524,191,333,131,35
23,71903,FABENS ISD,19,spanish,3,41,24,17,7,5,34,26,8,2,1
23,71904,SAN ELIZARIO IS,19,spanish,3,61,35,26,10,6,18,9,9,2,1
23,71905,YSLETA ISD,19,spanish,3,476,131,345,189,104,268,53,215,121,50
23,71906,ANTHONY ISD,19,spanish,3,8,5,3,0,0,8,7,1,0,0
23,71907,CANUTILLO ISD,19,spanish,3,74,24,50,23,15,71,21,50,31,4
23,71908,TORNILLO ISD,19,spanish,3,27,12,15,5,4,0,,,,
23,71909,SOCORRO ISD,19,spanish,3,52,30,22,10,7,37,19,18,6,2
23,72902,DUBLIN ISD,11,spanish,3,0,,,,,0,,,,
23,72903,STEPHENVILLE IS,11,spanish,3,16,5,11,5,2,0,,,,
23,75902,LA GRANGE ISD,13,spanish,3,0,,,,,0,,,,
23,79901,LAMAR CISD,4,spanish,3,88,33,55,28,13,29,9,20,5,1
23,79907,FORT BEND ISD,4,spanish,3,56,29,27,7,2,40,24,16,6,1
23,79910,STAFFORD MSD,4,spanish,3,11,7,4,2,0,9,7,2,1,0
23,80901,MOUNT VERNON IS,8,spanish,3,0,,,,,0,,,,
23,83903,SEMINOLE ISD,17,spanish,3,6,3,3,1,0,5,3,2,0,0
23,84901,DICKINSON ISD,4,spanish,3,92,39,53,25,9,66,26,40,13,2
23,84902,GALVESTON ISD,4,spanish,3,68,25,43,25,10,56,19,37,20,4
23,84906,TEXAS CITY ISD,4,spanish,3,6,2,4,3,2,5,1,4,3,0
23,84910,CLEAR CREEK ISD,4,spanish,3,169,66,103,50,25,179,67,112,46,16
23,86901,FREDERICKSBURG,13,spanish,3,0,,,,,0,,,,
23,90904,PAMPA ISD,16,spanish,3,6,3,3,0,0,6,4,2,0,0
23,91902,COLLINSVILLE IS,10,spanish,3,0,,,,,0,,,,
23,91903,DENISON ISD,10,spanish,3,21,7,14,5,2,0,,,,
23,91905,HOWE ISD,10,spanish,3,0,,,,,0,,,,
23,91906,SHERMAN ISD,10,spanish,3,9,6,3,0,0,9,6,3,2,1
23,91917,GUNTER ISD,10,spanish,3,0,,,,,0,,,,
23,92901,GLADEWATER ISD,7,spanish,3,0,,,,,0,,,,
23,92902,KILGORE ISD,7,spanish,3,25,10,15,2,1,0,,,,
23,92903,LONGVIEW ISD,7,spanish,3,41,17,24,6,2,0,,,,
23,92904,PINE TREE ISD,7,spanish,3,0,,,,,0,,,,
23,92907,SPRING HILL ISD,7,spanish,3,0,,,,,0,,,,
23,93904,NAVASOTA ISD,6,spanish,3,0,,,,,0,,,,
23,94901,SEGUIN ISD,20,spanish,3,31,18,13,3,1,28,13,15,2,0
23,94902,SCHERTZ-CIBOLO-,20,spanish,3,29,12,17,8,5,6,5,1,0,0
23,98904,SPEARMAN ISD,16,spanish,3,0,,,,,0,,,,
23,99902,CHILLICOTHE ISD,9,spanish,3,0,,,,,0,,,,
23,100904,SILSBEE ISD,5,spanish,3,0,,,,,0,,,,
23,101802,SER-NINOS CHART,4,spanish,3,58,28,30,13,10,58,26,32,14,3
23,101806,RAUL YZAGUIRRE,4,spanish,3,35,7,28,21,17,0,,,,
23,101814,THE VARNETT PUB,4,spanish,3,0,,,,,0,,,,
23,101838,SOUTHWEST SCHOO,4,spanish,3,8,3,5,3,1,8,4,4,1,0
23,101845,YES PREP PUBLIC,4,spanish,3,140,52,88,42,26,139,34,105,73,32
23,101846,HARMONY PUBLIC,4,spanish,3,0,,,,,0,,,,
23,101853,BAKERRIPLEY COM,4,spanish,3,0,,,,,0,,,,
23,101856,DRAW ACADEMY,4,spanish,3,9,6,3,0,0,9,3,6,0,0
23,101858,HARMONY PUBLIC,4,spanish,3,0,,,,,0,,,,
23,101859,STEP CHARTER SC,4,spanish,3,0,,,,,0,,,,
23,101902,ALDINE ISD,4,spanish,3,570,369,201,63,26,501,295,206,54,5
23,101903,ALIEF ISD,4,spanish,3,1198,507,691,306,149,9,7,2,0,0
23,101905,CHANNELVIEW ISD,4,spanish,3,115,59,56,28,15,53,22,31,15,3
23,101906,CROSBY ISD,4,spanish,3,23,11,12,5,3,22,6,16,5,2
23,101907,CYPRESS-FAIRBAN,4,spanish,3,20,9,11,6,3,19,12,7,0,0
23,101908,DEER PARK ISD,4,spanish,3,74,28,46,25,15,74,22,52,27,5
23,101910,GALENA PARK ISD,4,spanish,3,342,130,212,106,69,290,93,197,89,22
23,101911,GOOSE CREEK CIS,4,spanish,3,46,29,17,6,2,45,27,18,4,0
23,101912,HOUSTON ISD,4,spanish,3,3026,1289,1737,795,429,2734,1030,1704,765,237
23,101913,HUMBLE ISD,4,spanish,3,124,59,65,29,11,115,62,53,17,5
23,101914,KATY ISD,4,spanish,3,390,130,260,147,70,242,94,148,73,25
23,101915,KLEIN ISD,4,spanish,3,107,52,55,26,11,92,43,49,18,3
23,101916,LA PORTE ISD,4,spanish,3,9,6,3,1,0,9,4,5,1,0
23,101917,PASADENA ISD,4,spanish,3,867,279,588,295,174,919,261,658,304,86
23,101919,SPRING ISD,4,spanish,3,406,201,205,93,46,251,124,127,41,9
23,101920,SPRING BRANCH I,4,spanish,3,215,118,97,39,20,75,40,35,13,2
23,101921,TOMBALL ISD,4,spanish,3,76,26,50,36,19,6,3,3,2,0
23,101924,SHELDON ISD,4,spanish,3,55,37,18,6,5,45,19,26,10,3
23,101925,HUFFMAN ISD,4,spanish,3,11,7,4,4,2,11,7,4,1,0
23,102901,KARNACK ISD,7,spanish,3,0,,,,,0,,,,
23,102902,MARSHALL ISD,7,spanish,3,24,9,15,6,1,0,,,,
23,105802,TEXAS PREPARATO,13,spanish,3,0,,,,,0,,,,
23,105804,DORAL ACADEMY O,13,spanish,3,0,,,,,0,,,,
23,105902,SAN MARCOS CISD,13,spanish,3,61,28,33,14,5,27,19,8,3,0
23,105904,DRIPPING SPRING,13,spanish,3,11,4,7,4,2,0,,,,
23,105905,WIMBERLEY ISD,13,spanish,3,0,,,,,0,,,,
23,105906,HAYS CISD,13,spanish,3,102,56,46,15,6,15,11,4,2,1
23,106901,CANADIAN ISD,16,spanish,3,0,,,,,0,,,,
23,107901,ATHENS ISD,10,spanish,3,0,,,,,0,,,,
23,108802,HORIZON MONTESS,1,spanish,3,0,,,,,0,,,,
23,108807,IDEA PUBLIC SCH,1,spanish,3,43,26,17,8,2,37,20,17,5,0
23,108808,VANGUARD ACADEM,1,spanish,3,47,13,34,29,14,9,1,8,5,0
23,108902,DONNA ISD,1,spanish,3,264,171,93,32,14,87,52,35,8,0
23,108903,EDCOUCH-ELSA IS,1,spanish,3,8,5,3,2,0,8,6,2,1,0
23,108904,EDINBURG CISD,1,spanish,3,64,40,24,11,5,48,21,27,10,4
23,108905,HIDALGO ISD,1,spanish,3,54,22,32,15,10,27,4,23,13,4
23,108906,MCALLEN ISD,1,spanish,3,91,49,42,21,10,45,24,21,7,2
23,108907,MERCEDES ISD,1,spanish,3,31,12,19,4,3,0,,,,
23,108908,MISSION CISD,1,spanish,3,215,98,117,60,30,14,6,8,3,0
23,108909,PHARR-SAN JUAN-,1,spanish,3,455,201,254,115,70,22,9,13,6,1
23,108910,PROGRESO ISD,1,spanish,3,33,14,19,8,5,0,,,,
23,108911,SHARYLAND ISD,1,spanish,3,118,44,74,40,25,118,47,71,26,3
23,108912,LA JOYA ISD,1,spanish,3,625,236,389,228,144,19,5,14,2,0
23,108913,WESLACO ISD,1,spanish,3,9,4,5,3,1,7,3,4,2,1
23,108915,MONTE ALTO ISD,1,spanish,3,0,,,,,0,,,,
23,108916,VALLEY VIEW ISD,1,spanish,3,27,6,21,11,3,16,5,11,6,2
23,109904,HILLSBORO ISD,12,spanish,3,0,,,,,0,,,,
23,109907,ITASCA ISD,12,spanish,3,0,,,,,0,,,,
23,111901,GRANBURY ISD,11,spanish,3,8,5,3,1,1,5,2,3,0,0
23,112901,SULPHUR SPRINGS,8,spanish,3,41,11,30,17,11,0,,,,
23,114901,BIG SPRING ISD,18,spanish,3,0,,,,,0,,,,
23,115901,FT HANCOCK ISD,19,spanish,3,9,6,3,2,0,9,7,2,1,0
23,116901,CADDO MILLS ISD,10,spanish,3,0,,,,,0,,,,
23,116903,COMMERCE ISD,10,spanish,3,0,,,,,0,,,,
23,116905,GREENVILLE ISD,10,spanish,3,46,24,22,11,5,0,,,,
23,117901,BORGER ISD,16,spanish,3,8,4,4,3,1,0,,,,
23,120902,GANADO ISD,3,spanish,3,0,,,,,0,,,,
23,123807,BOB HOPE SCHOOL,5,spanish,3,20,9,11,5,2,15,4,11,2,0
23,123905,NEDERLAND ISD,5,spanish,3,6,3,3,2,1,6,3,3,0,0
23,123907,PORT ARTHUR ISD,5,spanish,3,27,18,9,1,0,25,13,12,1,0
23,123910,BEAUMONT ISD,5,spanish,3,12,8,4,2,0,12,6,6,1,0
23,126901,ALVARADO ISD,11,spanish,3,27,17,10,3,2,0,,,,
23,126902,BURLESON ISD,11,spanish,3,14,3,11,5,1,13,0,13,4,3
23,126903,CLEBURNE ISD,11,spanish,3,33,14,19,10,8,31,16,15,6,2
23,126905,JOSHUA ISD,11,spanish,3,17,11,6,2,1,0,,,,
23,126906,KEENE ISD,11,spanish,3,0,,,,,0,,,,
23,126908,VENUS ISD,11,spanish,3,40,22,18,3,1,0,,,,
23,128901,KARNES CITY ISD,20,spanish,3,0,,,,,0,,,,
23,129901,CRANDALL ISD,10,spanish,3,11,7,4,0,0,0,,,,
23,129902,FORNEY ISD,10,spanish,3,34,16,18,12,9,9,6,3,0,0
23,129904,KEMP ISD,10,spanish,3,0,,,,,0,,,,
23,129905,MABANK ISD,10,spanish,3,0,,,,,0,,,,
23,129906,TERRELL ISD,10,spanish,3,0,,,,,0,,,,
23,130901,BOERNE ISD,20,spanish,3,33,7,26,13,5,33,13,20,12,4
23,133903,KERRVILLE ISD,20,spanish,3,0,,,,,0,,,,
23,139909,PARIS ISD,8,spanish,3,11,6,5,0,0,0,,,,
23,139912,PRAIRILAND ISD,8,spanish,3,0,,,,,0,,,,
23,142901,COTULLA ISD,20,spanish,3,0,,,,,0,,,,
23,146901,CLEVELAND ISD,4,spanish,3,158,114,44,8,3,27,22,5,0,0
23,146902,DAYTON ISD,4,spanish,3,35,29,6,3,1,0,,,,
23,146904,HARDIN ISD,5,spanish,3,0,,,,,0,,,,
23,146906,LIBERTY ISD,5,spanish,3,0,,,,,5,3,2,0,0
23,152901,LUBBOCK ISD,17,spanish,3,66,26,40,20,16,30,10,20,6,1
23,152906,LUBBOCK-COOPER,17,spanish,3,17,8,9,3,2,0,,,,
23,152907,FRENSHIP ISD,17,spanish,3,10,4,6,5,0,0,,,,
23,152908,ROOSEVELT ISD,17,spanish,3,0,,,,,0,,,,
23,154901,MADISONVILLE CI,6,spanish,3,0,,,,,0,,,,
23,159901,EAGLE PASS ISD,20,spanish,3,114,42,72,31,15,107,35,72,30,9
23,160901,BRADY ISD,15,spanish,3,0,,,,,0,,,,
23,161807,HARMONY PUBLIC,12,spanish,3,6,5,1,1,0,6,2,4,1,0
23,161906,LA VEGA ISD,12,spanish,3,0,,,,,0,,,,
23,161914,WACO ISD,12,spanish,3,7,5,2,0,0,7,5,2,1,0
23,161919,BRUCEVILLE-EDDY,12,spanish,3,0,,,,,0,,,,
23,163901,DEVINE ISD,20,spanish,3,0,,,,,0,,,,
23,163908,MEDINA VALLEY I,20,spanish,3,0,,,,,0,,,,
23,165901,MIDLAND ISD,18,spanish,3,275,91,184,91,36,265,93,172,80,20
23,165902,GREENWOOD ISD,18,spanish,3,5,3,2,1,0,5,2,3,0,0
23,166904,ROCKDALE ISD,6,spanish,3,0,,,,,0,,,,
23,170902,CONROE ISD,6,spanish,3,395,179,216,95,42,351,118,233,92,21
23,170903,MONTGOMERY ISD,6,spanish,3,6,2,4,3,3,0,,,,
23,170904,WILLIS ISD,6,spanish,3,14,10,4,2,1,7,6,1,0,0
23,170906,MAGNOLIA ISD,6,spanish,3,38,12,26,15,11,13,6,7,1,0
23,170907,SPLENDORA ISD,6,spanish,3,30,17,13,8,7,21,11,10,5,2
23,170908,NEW CANEY ISD,6,spanish,3,109,72,37,14,5,106,48,58,10,1
23,174904,NACOGDOCHES ISD,7,spanish,3,34,23,11,3,1,0,,,,
23,175903,CORSICANA ISD,12,spanish,3,26,14,12,8,3,0,,,,
23,175911,RICE ISD,12,spanish,3,0,,,,,0,,,,
23,177901,ROSCOE COLLEGIA,14,spanish,3,0,,,,,0,,,,
23,178901,AGUA DULCE ISD,2,spanish,3,0,,,,,0,,,,
23,178904,CORPUS CHRISTI,2,spanish,3,23,15,8,4,2,24,14,10,4,0
23,178909,ROBSTOWN ISD,2,spanish,3,0,,,,,0,,,,
23,178915,WEST OSO ISD,2,spanish,3,0,,,,,0,,,,
23,181908,LITTLE CYPRESS-,5,spanish,3,0,,,,,0,,,,
23,182903,MINERAL WELLS I,11,spanish,3,16,6,10,5,2,0,,,,
23,184901,POOLVILLE ISD,11,spanish,3,0,,,,,0,,,,
23,184902,SPRINGTOWN ISD,11,spanish,3,5,1,4,0,0,0,,,,
23,184903,WEATHERFORD ISD,11,spanish,3,32,17,15,4,2,31,16,15,7,1
23,187907,LIVINGSTON ISD,6,spanish,3,0,,,,,0,,,,
23,188901,AMARILLO ISD,16,spanish,3,137,46,91,46,23,22,9,13,4,1
23,189902,PRESIDIO ISD,18,spanish,3,8,8,0,0,0,8,4,4,1,0
23,190903,RAINS ISD,7,spanish,3,0,,,,,0,,,,
23,195901,PECOS-BARSTOW-T,18,spanish,3,19,6,13,6,1,19,4,15,6,1
23,199901,ROCKWALL ISD,10,spanish,3,14,6,8,6,4,5,0,5,2,0
23,199902,ROYSE CITY ISD,10,spanish,3,45,9,36,21,11,15,8,7,1,0
23,201902,HENDERSON ISD,7,spanish,3,0,,,,,0,,,,
23,201913,CARLISLE ISD,7,spanish,3,0,,,,,0,,,,
23,205901,ARANSAS PASS IS,2,spanish,3,0,,,,,0,,,,
23,205902,GREGORY-PORTLAN,2,spanish,3,0,,,,,0,,,,
23,205903,INGLESIDE ISD,2,spanish,3,0,,,,,0,,,,
23,205906,SINTON ISD,2,spanish,3,0,,,,,0,,,,
23,208902,SNYDER ISD,14,spanish,3,23,5,18,10,7,8,1,7,1,0
23,210901,CENTER ISD,7,spanish,3,0,,,,,0,,,,
23,211901,TEXHOMA ISD,16,spanish,3,0,,,,,0,,,,
23,212905,TYLER ISD,7,spanish,3,77,21,56,33,20,9,5,4,1,0
23,212909,CHAPEL HILL ISD,7,spanish,3,51,12,39,19,11,0,,,,
23,213901,GLEN ROSE ISD,11,spanish,3,0,,,,,0,,,,
23,214901,RIO GRANDE CITY,1,spanish,3,14,10,4,3,1,13,9,4,4,3
23,214903,ROMA ISD,1,spanish,3,11,2,9,5,5,10,1,9,8,5
23,219901,HAPPY ISD,16,spanish,3,0,,,,,0,,,,
23,219903,TULIA ISD,16,spanish,3,0,,,,,0,,,,
23,220815,CHAPEL HILL ACA,11,spanish,3,0,,,,,0,,,,
23,220901,ARLINGTON ISD,11,spanish,3,414,253,161,60,29,222,134,88,27,9
23,220902,BIRDVILLE ISD,11,spanish,3,158,75,83,35,15,169,69,100,43,8
23,220904,EVERMAN ISD,11,spanish,3,27,15,12,5,2,0,,,,
23,220905,FORT WORTH ISD,11,spanish,3,520,331,189,61,28,105,76,29,5,0
23,220906,GRAPEVINE-COLLE,11,spanish,3,7,2,5,2,1,7,2,5,1,1
23,220907,KELLER ISD,11,spanish,3,60,19,41,23,13,6,4,2,0,0
23,220908,MANSFIELD ISD,11,spanish,3,36,21,15,10,6,34,15,19,7,2
23,220910,LAKE WORTH ISD,11,spanish,3,26,22,4,0,0,0,,,,
23,220912,CROWLEY ISD,11,spanish,3,97,40,57,31,20,16,6,10,4,1
23,220914,KENNEDALE ISD,11,spanish,3,0,,,,,0,,,,
23,220915,AZLE ISD,11,spanish,3,13,1,12,4,2,0,,,,
23,220916,HURST-EULESS-BE,11,spanish,3,127,33,94,48,31,125,29,96,50,22
23,220917,CASTLEBERRY ISD,11,spanish,3,48,16,32,14,7,0,,,,
23,220918,EAGLE MT-SAGINA,11,spanish,3,36,18,18,8,4,0,,,,
23,220920,WHITE SETTLEMEN,11,spanish,3,46,15,31,18,7,46,16,30,15,4
23,221801,TEXAS COLLEGE P,14,spanish,3,5,4,1,1,0,5,4,1,0,0
23,221901,ABILENE ISD,14,spanish,3,19,13,6,4,2,5,4,1,0,0
23,225902,MOUNT PLEASANT,8,spanish,3,115,39,76,41,27,7,2,5,2,0
23,225907,HARTS BLUFF ISD,8,spanish,3,19,6,13,7,1,0,,,,
23,226801,TEXAS LEADERSHI,15,spanish,3,0,,,,,0,,,,
23,226903,SAN ANGELO ISD,15,spanish,3,0,,,,,0,,,,
23,227803,WAYSIDE SCHOOLS,13,spanish,3,38,29,9,3,1,0,,,,
23,227816,HARMONY PUBLIC,13,spanish,3,5,4,1,0,0,5,4,1,0,0
23,227817,CEDARS INTERNAT,13,spanish,3,0,,,,,0,,,,
23,227820,KIPP TEXAS PUBL,4,spanish,3,14,13,1,0,0,11,7,4,0,0
23,227824,VALERE PUBLIC S,13,spanish,3,0,,,,,0,,,,
23,227901,AUSTIN ISD,13,spanish,3,957,526,431,181,98,347,233,114,22,2
23,227904,PFLUGERVILLE IS,13,spanish,3,278,127,151,69,31,92,58,34,5,0
23,227907,MANOR ISD,13,spanish,3,89,66,23,8,3,71,40,31,7,0
23,227910,DEL VALLE ISD,13,spanish,3,289,180,109,41,14,61,35,26,8,1
23,227912,LAGO VISTA ISD,13,spanish,3,0,,,,,0,,,,
23,227913,LAKE TRAVIS ISD,13,spanish,3,31,25,6,3,0,7,4,3,0,0
23,229903,WOODVILLE ISD,5,spanish,3,0,,,,,0,,,,
23,230902,GILMER ISD,7,spanish,3,0,,,,,0,,,,
23,230905,HARMONY ISD,7,spanish,3,0,,,,,0,,,,
23,231901,MCCAMEY ISD,18,spanish,3,0,,,,,0,,,,
23,232903,UVALDE CISD,20,spanish,3,0,,,,,18,7,11,4,1
23,234905,MARTINS MILL IS,7,spanish,3,0,,,,,0,,,,
23,234906,VAN ISD,7,spanish,3,0,,,,,0,,,,
23,234907,WILLS POINT ISD,10,spanish,3,7,4,3,0,0,0,,,,
23,235902,VICTORIA ISD,3,spanish,3,39,18,21,12,6,39,22,17,7,4
23,236902,HUNTSVILLE ISD,6,spanish,3,0,,,,,0,,,,
23,237902,HEMPSTEAD ISD,4,spanish,3,0,,,,,0,,,,
23,237904,WALLER ISD,4,spanish,3,10,7,3,1,1,9,5,4,1,0
23,237905,ROYAL ISD,4,spanish,3,6,4,2,1,0,6,3,3,2,1
23,238902,MONAHANS-WICKET,18,spanish,3,0,,,,,0,,,,
23,239901,BRENHAM ISD,6,spanish,3,13,7,6,2,1,13,6,7,1,0
23,240901,LAREDO ISD,1,spanish,3,25,11,14,6,5,27,14,13,5,1
23,240903,UNITED ISD,1,spanish,3,47,18,29,21,9,45,15,30,22,7
23,241901,BOLING ISD,3,spanish,3,0,,,,,0,,,,
23,241903,EL CAMPO ISD,3,spanish,3,0,,,,,0,,,,
23,243905,WICHITA FALLS I,9,spanish,3,11,5,6,4,3,0,,,,
23,245903,RAYMONDVILLE IS,1,spanish,3,0,,,,,0,,,,
23,246902,FLORENCE ISD,13,spanish,3,8,5,3,0,0,5,4,1,0,0
23,246904,GEORGETOWN ISD,13,spanish,3,30,17,13,4,2,13,10,3,0,0
23,246906,HUTTO ISD,13,spanish,3,24,15,9,1,0,7,5,2,0,0
23,246907,JARRELL ISD,13,spanish,3,9,7,2,0,0,8,8,0,0,0
23,246908,LIBERTY HILL IS,13,spanish,3,5,4,1,0,0,10,4,6,2,0
23,246909,ROUND ROCK ISD,13,spanish,3,158,70,88,32,14,116,73,43,11,3
23,246911,TAYLOR ISD,13,spanish,3,0,,,,,0,,,,
23,246913,LEANDER ISD,13,spanish,3,69,32,37,19,8,30,15,15,2,1
23,247901,FLORESVILLE ISD,20,spanish,3,14,4,10,6,2,8,4,4,3,0
23,247903,LA VERNIA ISD,20,spanish,3,5,2,3,0,0,0,,,,
23,248901,KERMIT ISD,18,spanish,3,7,4,3,2,2,7,3,4,2,0
23,249903,BRIDGEPORT ISD,11,spanish,3,9,4,5,2,0,0,,,,
23,249905,DECATUR ISD,11,spanish,3,6,2,4,3,2,0,,,,
23,250903,MINEOLA ISD,7,spanish,3,0,,,,,0,,,,
23,250904,QUITMAN ISD,7,spanish,3,0,,,,,0,,,,
23,251901,DENVER CITY ISD,17,spanish,3,0,,,,,0,,,,
23,252903,OLNEY ISD,9,spanish,3,0,,,,,0,,,,
23,253901,ZAPATA COUNTY I,1,spanish,3,0,,,,,0,,,,
23,1902,CAYUGA ISD,7,english,4,39,7,32,19,8,38,14,24,18,8
23,1903,ELKHART ISD,7,english,4,86,9,77,43,11,86,15,71,47,20
23,1904,FRANKSTON ISD,7,english,4,63,7,56,32,11,63,19,44,34,11
23,1906,NECHES ISD,7,english,4,20,0,20,9,3,20,8,12,9,2
23,1907,PALESTINE ISD,7,english,4,231,90,141,56,20,231,103,128,78,34
23,1908,WESTWOOD ISD,7,english,4,99,25,74,35,15,100,34,66,38,17
23,1909,SLOCUM ISD,7,english,4,33,4,29,14,3,33,6,27,14,5
23,2901,ANDREWS ISD,18,english,4,317,80,237,115,36,328,171,157,79,19
23,3801,PINEYWOODS COMM,7,english,4,76,17,59,27,12,76,35,41,18,2
23,3902,HUDSON ISD,7,english,4,205,26,179,120,47,204,51,153,101,38
23,3903,LUFKIN ISD,7,english,4,468,122,346,181,76,467,177,290,179,65
23,3904,HUNTINGTON ISD,7,english,4,118,26,92,44,17,120,38,82,38,12
23,3905,DIBOLL ISD,7,english,4,127,35,92,41,12,127,52,75,36,13
23,3906,ZAVALLA ISD,7,english,4,16,3,13,3,0,16,10,6,2,0
23,3907,CENTRAL ISD,7,english,4,101,24,77,42,11,101,40,61,38,18
23,4901,ARANSAS COUNTY,2,english,4,200,60,140,73,34,201,92,109,61,29
23,5901,ARCHER CITY ISD,9,english,4,34,4,30,22,14,34,1,33,26,16
23,5902,HOLLIDAY ISD,9,english,4,94,19,75,41,15,94,21,73,56,21
23,5904,WINDTHORST ISD,9,english,4,31,2,29,21,8,31,1,30,21,11
23,6902,CLAUDE ISD,16,english,4,30,0,30,22,10,30,3,27,17,9
23,7901,CHARLOTTE ISD,20,english,4,27,3,24,10,2,27,6,21,12,2
23,7902,JOURDANTON ISD,20,english,4,101,16,85,47,18,102,33,69,45,23
23,7904,LYTLE ISD,20,english,4,136,46,90,46,11,137,64,73,33,8
23,7905,PLEASANTON ISD,20,english,4,239,82,157,79,31,240,106,134,77,30
23,7906,POTEET ISD,20,english,4,121,48,73,32,12,126,53,73,44,13
23,8901,BELLVILLE ISD,6,english,4,158,33,125,63,23,157,51,106,60,19
23,8902,SEALY ISD,6,english,4,177,39,138,64,27,157,42,115,81,39
23,8903,BRAZOS ISD,6,english,4,52,19,33,16,7,52,18,34,22,6
23,9901,MULESHOE ISD,17,english,4,90,35,55,26,9,90,38,52,31,17
23,10901,MEDINA ISD,20,english,4,23,2,21,12,9,22,4,18,11,5
23,10902,BANDERA ISD,20,english,4,173,42,131,70,32,171,64,107,67,29
23,11901,BASTROP ISD,13,english,4,827,268,559,296,107,820,327,493,296,101
23,11902,ELGIN ISD,13,english,4,324,116,208,115,40,389,196,193,89,31
23,11904,SMITHVILLE ISD,13,english,4,139,34,105,54,22,136,48,88,53,18
23,11905,MCDADE ISD,13,english,4,30,18,12,3,0,30,25,5,2,0
23,12901,SEYMOUR ISD,9,english,4,53,5,48,34,18,53,6,47,31,16
23,13801,ST MARY'S ACADE,2,english,4,63,7,56,22,5,63,24,39,19,2
23,13901,BEEVILLE ISD,2,english,4,206,55,151,69,26,206,57,149,98,39
23,13902,PAWNEE ISD,2,english,4,16,5,11,3,1,16,7,9,3,2
23,13903,PETTUS ISD,2,english,4,28,6,22,19,13,28,6,22,18,10
23,13905,SKIDMORE-TYNAN,2,english,4,52,10,42,24,6,52,17,35,23,11
23,14803,PRIORITY CHARTE,12,english,4,45,12,33,14,4,45,20,25,9,3
23,14804,ORENDA CHARTER,12,english,4,156,20,136,104,60,155,26,129,96,49
23,14901,ACADEMY ISD,12,english,4,141,27,114,62,28,141,43,98,64,25
23,14902,BARTLETT ISD,13,english,4,29,12,17,5,0,29,12,17,5,0
23,14903,BELTON ISD,12,english,4,913,199,714,418,174,940,327,613,396,179
23,14905,HOLLAND ISD,12,english,4,41,3,38,26,11,41,6,35,25,15
23,14906,KILLEEN ISD,12,english,4,3195,703,2492,1353,514,3194,1139,2055,1192,490
23,14907,ROGERS ISD,12,english,4,72,9,63,37,16,72,14,58,37,19
23,14908,SALADO ISD,12,english,4,170,29,141,102,40,168,47,121,88,31
23,14909,TEMPLE ISD,12,english,4,631,187,444,245,82,639,223,416,257,89
23,14910,TROY ISD,12,english,4,114,23,91,50,20,115,21,94,62,30
23,15802,GEORGE GERVIN A,20,english,4,32,16,16,3,1,32,28,4,1,0
23,15806,LEGACY TRADITIO,20,english,4,89,20,69,31,6,88,33,55,30,5
23,15807,SOUTHWEST PREPA,20,english,4,57,23,34,14,3,58,38,20,6,2
23,15808,INSPIRE ACADEMI,20,english,4,44,11,33,18,5,45,20,25,12,1
23,15809,BEXAR COUNTY AC,20,english,4,19,9,10,3,0,19,10,9,1,0
23,15815,HERITAGE ACADEM,20,english,4,15,5,10,6,2,15,7,8,6,3
23,15822,JUBILEE ACADEMI,20,english,4,482,196,286,134,37,481,239,242,142,56
23,15825,LIGHTHOUSE PUBL,20,english,4,30,18,12,7,1,31,27,4,1,1
23,15827,SCHOOL OF SCIEN,20,english,4,305,65,240,158,72,304,75,229,128,59
23,15828,HARMONY PUBLIC,20,english,4,279,113,166,76,25,290,159,131,59,19
23,15830,BROOKS ACADEMIE,20,english,4,242,73,169,74,23,244,127,117,65,33
23,15831,SCHOOL OF SCIEN,20,english,4,469,88,381,220,115,469,149,320,186,71
23,15834,BASIS TEXAS,20,english,4,539,25,514,438,280,538,64,474,354,194
23,15835,GREAT HEARTS TE,20,english,4,986,104,882,574,232,983,259,724,466,200
23,15836,ELEANOR KOLITZ,20,english,4,60,2,58,45,25,60,9,51,40,15
23,15838,COMPASS ROSE PU,20,english,4,251,103,148,62,19,252,136,116,52,14
23,15839,PROMESA ACADEMY,20,english,4,41,19,22,9,5,41,28,13,4,1
23,15841,THE GATHERING P,20,english,4,89,40,49,20,6,93,76,17,5,2
23,15842,ROYAL PUBLIC SC,20,english,4,9,3,6,3,0,9,5,4,3,1
23,15844,ESSENCE PREPARA,20,english,4,21,8,13,7,2,20,16,4,0,0
23,15901,ALAMO HEIGHTS I,20,english,4,326,23,303,237,139,328,58,270,207,109
23,15904,HARLANDALE ISD,20,english,4,682,237,445,201,63,683,329,354,178,51
23,15905,EDGEWOOD ISD,20,english,4,412,191,221,80,19,511,274,237,126,43
23,15906,RANDOLPH FIELD,20,english,4,99,5,94,57,21,99,13,86,62,39
23,15907,SAN ANTONIO ISD,20,english,4,2387,904,1483,735,278,2420,1194,1226,725,262
23,15908,SOUTH SAN ANTON,20,english,4,468,201,267,99,25,486,263,223,112,26
23,15909,SOMERSET ISD,20,english,4,255,33,222,152,76,282,31,251,198,112
23,15910,NORTH EAST ISD,20,english,4,3564,625,2939,1966,954,3232,1001,2231,1455,625
23,15911,EAST CENTRAL IS,20,english,4,676,266,410,174,58,708,358,350,189,62
23,15912,SOUTHWEST ISD,20,english,4,885,219,666,379,141,889,284,605,374,148
23,15913,LACKLAND ISD,20,english,4,80,16,64,33,14,79,24,55,31,13
23,15914,FT SAM HOUSTON,20,english,4,118,16,102,65,31,114,28,86,59,22
23,15915,NORTHSIDE ISD,20,english,4,6848,1546,5302,3056,1275,6836,2397,4439,2745,1139
23,15916,JUDSON ISD,20,english,4,1673,471,1202,636,211,1669,709,960,550,209
23,15917,SOUTHSIDE ISD,20,english,4,284,80,204,116,58,364,80,284,203,92
23,16901,JOHNSON CITY IS,13,english,4,47,5,42,26,9,47,7,40,26,10
23,16902,BLANCO ISD,13,english,4,69,11,58,33,16,69,15,54,35,17
23,17901,BORDEN COUNTY I,17,english,4,17,0,17,10,4,17,1,16,11,8
23,18901,CLIFTON ISD,12,english,4,83,12,71,42,18,83,36,47,26,11
23,18902,MERIDIAN ISD,12,english,4,30,6,24,13,3,30,7,23,14,5
23,18903,MORGAN ISD,12,english,4,15,8,7,1,0,15,12,3,0,0
23,18904,VALLEY MILLS IS,12,english,4,46,10,36,15,5,46,16,30,18,10
23,18905,WALNUT SPRINGS,12,english,4,13,6,7,3,0,13,9,4,1,0
23,18906,IREDELL ISD,12,english,4,7,2,5,4,0,7,3,4,3,0
23,18907,KOPPERL ISD,12,english,4,15,3,12,6,2,15,7,8,4,2
23,18908,CRANFILLS GAP I,12,english,4,10,1,9,4,3,11,8,3,2,0
23,19901,DEKALB ISD,8,english,4,41,7,34,15,6,41,9,32,19,8
23,19902,HOOKS ISD,8,english,4,41,3,38,29,16,41,3,38,31,20
23,19903,MAUD ISD,8,english,4,33,4,29,14,4,33,11,22,15,5
23,19905,NEW BOSTON ISD,8,english,4,66,19,47,20,7,66,24,42,26,15
23,19906,REDWATER ISD,8,english,4,75,9,66,34,8,75,8,67,48,21
23,19907,TEXARKANA ISD,8,english,4,507,172,335,181,79,530,250,280,170,69
23,19908,LIBERTY-EYLAU I,8,english,4,130,56,74,39,9,131,57,74,46,20
23,19909,SIMMS ISD,8,english,4,33,10,23,7,1,33,10,23,19,6
23,19910,MALTA ISD,8,english,4,18,2,16,8,4,18,5,13,8,1
23,19911,RED LICK ISD,8,english,4,53,1,52,45,28,53,5,48,42,23
23,19912,PLEASANT GROVE,8,english,4,151,9,142,96,48,151,11,140,109,51
23,19913,HUBBARD ISD,8,english,4,9,4,5,1,0,9,3,6,2,1
23,19914,LEARY ISD,8,english,4,7,0,7,3,0,7,3,4,1,1
23,20901,ALVIN ISD,4,english,4,2016,343,1673,1102,550,2029,462,1567,1136,598
23,20902,ANGLETON ISD,4,english,4,465,63,402,255,109,463,92,371,263,126
23,20904,DANBURY ISD,4,english,4,55,7,48,35,11,55,16,39,21,8
23,20905,BRAZOSPORT ISD,4,english,4,812,106,706,453,211,792,173,619,422,190
23,20906,SWEENY ISD,4,english,4,129,38,91,41,13,128,65,63,29,12
23,20907,COLUMBIA-BRAZOR,4,english,4,212,58,154,89,41,212,55,157,104,36
23,20908,PEARLAND ISD,4,english,4,1466,170,1296,969,549,1466,219,1247,995,614
23,20910,DAMON ISD,4,english,4,12,3,9,3,0,12,6,6,4,0
23,21803,BRAZOS SCHOOL F,6,english,4,32,7,25,6,2,32,11,21,13,5
23,21805,ARROW ACADEMY,6,english,4,82,12,70,30,12,81,21,60,33,12
23,21901,COLLEGE STATION,6,english,4,934,192,742,490,262,938,267,671,507,284
23,21902,BRYAN ISD,6,english,4,1090,251,839,469,209,1090,300,790,525,258
23,22004,TERLINGUA CSD,18,english,4,9,4,5,3,1,8,4,4,3,0
23,22901,ALPINE ISD,18,english,4,48,14,34,18,4,48,27,21,6,4
23,22902,MARATHON ISD,18,english,4,0,,,,,0,,,,
23,22903,SAN VICENTE ISD,18,english,4,0,,,,,0,,,,
23,23902,SILVERTON ISD,16,english,4,13,2,11,9,5,13,4,9,7,3
23,24901,BROOKS COUNTY I,1,english,4,68,24,44,19,7,69,34,35,18,3
23,25901,BANGS ISD,15,english,4,62,12,50,26,7,64,25,39,20,7
23,25902,BROWNWOOD ISD,15,english,4,242,58,184,109,51,241,76,165,103,48
23,25904,BLANKET ISD,15,english,4,8,2,6,0,0,8,2,6,1,0
23,25905,MAY ISD,15,english,4,13,1,12,9,3,13,4,9,4,2
23,25906,ZEPHYR ISD,15,english,4,12,2,10,6,2,12,3,9,7,2
23,25908,BROOKESMITH ISD,15,english,4,8,5,3,0,0,8,5,3,1,0
23,25909,EARLY ISD,15,english,4,79,17,62,37,12,79,25,54,35,10
23,26901,CALDWELL ISD,6,english,4,128,20,108,62,31,128,29,99,58,23
23,26902,SOMERVILLE ISD,6,english,4,38,16,22,6,1,38,15,23,16,5
23,26903,SNOOK ISD,6,english,4,42,12,30,16,6,42,14,28,19,8
23,27903,BURNET CISD,13,english,4,230,64,166,86,32,232,83,149,91,29
23,27904,MARBLE FALLS IS,13,english,4,240,50,190,109,47,276,87,189,115,48
23,28902,LOCKHART ISD,13,english,4,423,138,285,148,63,431,154,277,159,65
23,28903,LULING ISD,13,english,4,92,33,59,24,10,92,31,61,41,21
23,28906,PRAIRIE LEA ISD,13,english,4,14,8,6,1,0,14,14,0,0,0
23,29901,CALHOUN COUNTY,3,english,4,252,42,210,128,52,252,40,212,150,63
23,30901,CROSS PLAINS IS,14,english,4,30,3,27,20,14,30,5,25,16,8
23,30902,CLYDE CISD,14,english,4,97,17,80,49,15,97,19,78,53,21
23,30903,BAIRD ISD,14,english,4,31,7,24,15,7,31,7,24,10,7
23,30906,EULA ISD,14,english,4,40,11,29,11,3,40,10,30,17,3
23,31901,BROWNSVILLE ISD,1,english,4,2337,510,1827,1075,434,2345,622,1723,1230,576
23,31903,HARLINGEN CISD,1,english,4,1102,251,851,456,167,1107,335,772,472,177
23,31905,LA FERIA ISD,1,english,4,178,52,126,67,29,178,49,129,85,30
23,31906,LOS FRESNOS CIS,1,english,4,740,125,615,418,219,742,151,591,429,195
23,31909,POINT ISABEL IS,1,english,4,109,17,92,50,23,115,33,82,54,23
23,31911,RIO HONDO ISD,1,english,4,122,31,91,49,19,121,46,75,41,13
23,31912,SAN BENITO CISD,1,english,4,599,144,455,267,104,598,152,446,298,134
23,31913,SANTA MARIA ISD,1,english,4,34,9,25,11,3,34,7,27,12,3
23,31914,SANTA ROSA ISD,1,english,4,55,17,38,13,2,54,23,31,10,1
23,32902,PITTSBURG ISD,8,english,4,183,37,146,61,17,183,69,114,63,18
23,33901,GROOM ISD,16,english,4,8,0,8,5,0,8,2,6,5,0
23,33902,PANHANDLE ISD,16,english,4,38,2,36,22,12,38,9,29,27,9
23,33904,WHITE DEER ISD,16,english,4,23,4,19,13,5,23,6,17,10,7
23,34901,ATLANTA ISD,8,english,4,148,19,129,84,42,148,20,128,94,52
23,34902,AVINGER ISD,8,english,4,6,1,5,3,0,6,3,3,2,1
23,34903,HUGHES SPRINGS,8,english,4,62,12,50,33,12,62,19,43,33,11
23,34905,LINDEN-KILDARE,8,english,4,50,21,29,16,4,49,25,24,13,3
23,34906,MCLEOD ISD,8,english,4,30,2,28,16,3,30,2,28,20,7
23,34907,QUEEN CITY ISD,8,english,4,61,20,41,23,8,61,12,49,33,16
23,34909,BLOOMBURG ISD,8,english,4,15,2,13,7,3,15,3,12,6,5
23,35901,DIMMITT ISD,16,english,4,85,36,49,19,6,85,46,39,18,9
23,35902,HART ISD,16,english,4,13,2,11,3,0,13,7,6,3,0
23,35903,NAZARETH ISD,16,english,4,20,0,20,13,10,20,2,18,16,8
23,36901,ANAHUAC ISD,4,english,4,102,37,65,32,8,102,46,56,35,17
23,36902,BARBERS HILL IS,4,english,4,566,51,515,364,186,568,70,498,397,233
23,36903,EAST CHAMBERS I,5,english,4,100,22,78,35,10,100,21,79,53,28
23,37901,ALTO ISD,7,english,4,39,10,29,12,3,39,6,33,22,7
23,37904,JACKSONVILLE IS,7,english,4,249,62,187,93,26,331,120,211,121,35
23,37907,RUSK ISD,7,english,4,128,29,99,47,16,129,34,95,54,19
23,37908,NEW SUMMERFIELD,7,english,4,41,8,33,26,9,41,8,33,17,8
23,37909,WELLS ISD,7,english,4,10,0,10,6,3,10,2,8,2,0
23,38901,CHILDRESS ISD,16,english,4,60,11,49,31,11,60,19,41,25,7
23,39902,HENRIETTA ISD,9,english,4,76,16,60,23,7,76,27,49,25,2
23,39903,PETROLIA CISD,9,english,4,34,12,22,5,1,34,17,17,5,0
23,39904,BELLEVUE ISD,9,english,4,12,2,10,7,2,12,2,10,7,4
23,39905,MIDWAY ISD,9,english,4,10,2,8,4,2,10,3,7,5,1
23,40901,MORTON ISD,17,english,4,20,8,12,2,0,20,10,10,5,2
23,40902,WHITEFACE CISD,17,english,4,20,5,15,7,4,20,5,15,7,3
23,41901,BRONTE ISD,15,english,4,23,5,18,12,4,23,9,14,9,5
23,41902,ROBERT LEE ISD,15,english,4,16,2,14,7,4,16,3,13,9,2
23,42901,COLEMAN ISD,15,english,4,51,17,34,19,5,50,22,28,17,8
23,42903,SANTA ANNA ISD,15,english,4,18,1,17,8,2,18,4,14,9,4
23,42905,PANTHER CREEK C,15,english,4,14,6,8,6,1,14,5,9,3,1
23,43801,IMAGINE INTERNA,10,english,4,125,10,115,91,49,123,18,105,75,41
23,43802,LONE STAR LANGU,10,english,4,27,4,23,21,13,27,6,21,15,10
23,43901,ALLEN ISD,10,english,4,1597,131,1466,1121,678,1598,220,1378,1105,711
23,43902,ANNA ISD,10,english,4,358,82,276,172,64,356,111,245,153,70
23,43903,CELINA ISD,10,english,4,324,36,288,207,96,329,73,256,161,58
23,43904,FARMERSVILLE IS,10,english,4,145,32,113,69,39,145,48,97,54,18
23,43905,FRISCO ISD,10,english,4,4901,373,4528,3595,2201,4908,688,4220,3377,2070
23,43907,MCKINNEY ISD,10,english,4,1484,210,1274,854,439,1490,352,1138,807,414
23,43908,MELISSA ISD,10,english,4,453,51,402,301,173,454,78,376,298,167
23,43910,PLANO ISD,10,english,4,3213,455,2758,1963,1085,3219,670,2549,1965,1198
23,43911,PRINCETON ISD,10,english,4,601,142,459,262,106,599,192,407,270,112
23,43912,PROSPER ISD,10,english,4,2111,161,1950,1453,738,2119,267,1852,1465,787
23,43914,WYLIE ISD,10,english,4,1492,128,1364,1103,679,1513,139,1374,1178,792
23,43917,BLUE RIDGE ISD,10,english,4,75,18,57,38,14,75,22,53,35,10
23,43918,COMMUNITY ISD,10,english,4,270,54,216,125,41,298,83,215,125,49
23,43919,LOVEJOY ISD,10,english,4,314,15,299,250,158,314,13,301,280,213
23,44902,WELLINGTON ISD,16,english,4,31,6,25,14,9,31,6,25,17,9
23,45902,COLUMBUS ISD,4,english,4,102,29,73,38,16,102,40,62,38,12
23,45903,RICE CISD,3,english,4,110,28,82,47,18,110,17,93,68,23
23,45905,WEIMAR ISD,3,english,4,55,14,41,32,18,55,11,44,29,11
23,46802,TRINITY CHARTER,20,english,4,0,,,,,0,,,,
23,46901,NEW BRAUNFELS I,20,english,4,728,103,625,396,189,732,202,530,349,147
23,46902,COMAL ISD,20,english,4,2088,253,1835,1317,680,2099,402,1697,1273,674
23,47901,COMANCHE ISD,14,english,4,91,21,70,39,16,92,22,70,45,19
23,47902,DE LEON ISD,14,english,4,51,4,47,35,18,51,8,43,28,16
23,47903,GUSTINE ISD,14,english,4,7,0,7,3,1,7,1,6,3,2
23,47905,SIDNEY ISD,14,english,4,14,4,10,6,2,14,5,9,3,0
23,48901,EDEN CISD,15,english,4,7,3,4,3,2,7,3,4,3,1
23,48903,PAINT ROCK ISD,15,english,4,12,3,9,2,1,12,8,4,3,1
23,49901,GAINESVILLE ISD,11,english,4,244,99,145,67,18,262,113,149,75,30
23,49902,MUENSTER ISD,11,english,4,32,2,30,22,9,32,4,28,25,11
23,49903,VALLEY VIEW ISD,11,english,4,68,17,51,18,4,74,22,52,30,13
23,49905,CALLISBURG ISD,11,english,4,91,25,66,33,19,91,29,62,44,17
23,49906,ERA ISD,11,english,4,42,8,34,17,10,42,16,26,17,9
23,49907,LINDSAY ISD,11,english,4,39,5,34,24,13,39,8,31,19,10
23,49908,WALNUT BEND ISD,11,english,4,11,4,7,3,0,11,7,4,1,0
23,49909,SIVELLS BEND IS,11,english,4,10,4,6,4,3,10,5,5,5,1
23,50901,EVANT ISD,12,english,4,13,2,11,8,2,13,6,7,4,0
23,50902,GATESVILLE ISD,12,english,4,182,41,141,79,26,182,71,111,65,29
23,50904,OGLESBY ISD,12,english,4,16,7,9,4,1,16,9,7,2,0
23,50909,JONESBORO ISD,12,english,4,16,6,10,2,0,16,11,5,1,0
23,50910,COPPERAS COVE I,12,english,4,573,101,472,286,115,573,137,436,303,128
23,51901,PADUCAH ISD,17,english,4,14,7,7,1,0,14,8,6,2,0
23,52901,CRANE ISD,15,english,4,91,33,58,27,9,91,35,56,32,9
23,53001,CROCKETT COUNTY,15,english,4,45,1,44,30,9,45,7,38,25,7
23,54901,CROSBYTON CISD,17,english,4,15,4,11,2,0,15,8,7,4,2
23,54902,LORENZO ISD,17,english,4,16,8,8,3,0,16,12,4,0,0
23,54903,RALLS ISD,17,english,4,24,12,12,6,0,24,15,9,6,1
23,55901,CULBERSON COUNT,18,english,4,24,8,16,4,2,23,12,11,5,0
23,56901,DALHART ISD,16,english,4,121,41,80,39,6,121,43,78,39,12
23,56902,TEXLINE ISD,16,english,4,15,2,13,12,8,15,1,14,9,7
23,57802,PEGASUS SCHOOL,10,english,4,33,17,16,2,1,34,27,7,2,0
23,57803,UPLIFT EDUCATIO,10,english,4,1683,535,1148,532,201,1685,706,979,598,247
23,57806,ADVANTAGE ACADE,10,english,4,84,40,44,14,4,82,58,24,9,2
23,57807,LIFE SCHOOL,10,english,4,417,151,266,103,32,419,180,239,128,34
23,57808,UNIVERSAL ACADE,10,english,4,195,23,172,123,70,195,33,162,136,76
23,57809,NOVA ACADEMY,10,english,4,6,1,5,2,1,6,1,5,4,2
23,57810,ACADEMY OF DALL,10,english,4,21,16,5,3,1,20,19,1,0,0
23,57813,TRINITY BASIN P,10,english,4,417,136,281,127,42,416,197,219,114,52
23,57816,A W BROWN LEADE,10,english,4,68,23,45,20,4,68,43,25,5,0
23,57819,JEAN MASSIEU AC,10,english,4,16,6,10,3,1,16,6,10,5,2
23,57827,NOVA ACADEMY SO,10,english,4,35,18,17,9,1,35,21,14,5,1
23,57829,A+ ACADEMY,10,english,4,92,50,42,17,1,91,64,27,12,1
23,57830,INSPIRED VISION,10,english,4,88,37,51,24,7,88,44,44,23,10
23,57831,GATEWAY CHARTER,10,english,4,41,20,21,7,1,40,26,14,4,0
23,57833,EDUCATION CENTE,10,english,4,46,9,37,19,6,46,15,31,20,5
23,57835,GOLDEN RULE CHA,10,english,4,115,25,90,50,18,118,39,79,48,17
23,57836,ST ANTHONY SCHO,10,english,4,41,10,31,6,1,41,22,19,4,0
23,57839,LA ACADEMIA DE,10,english,4,85,23,62,30,6,85,15,70,43,14
23,57841,CITYSCAPE SCHOO,10,english,4,91,38,53,22,6,124,59,65,34,15
23,57844,MANARA ACADEMY,10,english,4,44,17,27,10,3,44,27,17,9,3
23,57845,UME PREPARATORY,10,english,4,125,17,108,72,26,127,36,91,57,18
23,57846,LEGACY PREPARAT,10,english,4,109,56,53,27,12,109,74,35,14,2
23,57847,VILLAGE TECH SC,10,english,4,88,26,62,33,9,88,45,43,16,3
23,57848,INTERNATIONAL L,10,english,4,1875,655,1220,549,174,1881,1054,827,451,170
23,57850,PIONEER TECHNOL,10,english,4,166,31,135,85,24,164,61,103,64,28
23,57851,BRIDGEWAY PREPA,10,english,4,9,4,5,3,3,9,4,5,4,2
23,57903,CARROLLTON-FARM,10,english,4,1467,323,1144,727,377,1672,508,1164,806,382
23,57904,CEDAR HILL ISD,10,english,4,426,123,303,150,58,428,177,251,140,49
23,57905,DALLAS ISD,10,english,4,6483,1745,4738,2704,1190,9258,2801,6457,4233,1784
23,57906,DESOTO ISD,10,english,4,330,109,221,96,23,345,167,178,108,35
23,57907,DUNCANVILLE ISD,10,english,4,575,195,380,184,68,668,285,383,215,86
23,57909,GARLAND ISD,10,english,4,3034,629,2405,1523,709,3575,1075,2500,1732,851
23,57910,GRAND PRAIRIE I,10,english,4,1396,342,1054,620,282,1723,540,1183,781,376
23,57911,HIGHLAND PARK I,10,english,4,418,10,408,369,268,418,19,399,370,262
23,57912,IRVING ISD,10,english,4,1894,712,1182,542,179,1904,816,1088,601,194
23,57913,LANCASTER ISD,10,english,4,480,129,351,182,74,489,199,290,156,55
23,57914,MESQUITE ISD,10,english,4,2337,671,1666,818,286,2383,742,1641,991,370
23,57916,RICHARDSON ISD,10,english,4,2536,619,1917,1282,650,2587,747,1840,1312,703
23,57919,SUNNYVALE ISD,10,english,4,176,11,165,120,71,176,38,138,100,51
23,57922,COPPELL ISD,10,english,4,939,67,872,713,493,945,106,839,688,456
23,58902,DAWSON ISD,17,english,4,12,2,10,5,0,12,7,5,2,0
23,58905,KLONDIKE ISD,17,english,4,25,3,22,17,6,25,4,21,15,3
23,58906,LAMESA ISD,17,english,4,118,38,80,28,8,118,63,55,35,15
23,58909,SANDS CISD,17,english,4,18,5,13,8,2,18,9,9,6,3
23,59901,HEREFORD ISD,16,english,4,266,68,198,82,24,264,106,158,99,28
23,59902,WALCOTT ISD,16,english,4,15,0,15,11,5,15,1,14,9,2
23,60902,COOPER ISD,8,english,4,59,14,45,27,8,59,19,40,23,5
23,60914,FANNINDEL ISD,8,english,4,14,11,3,1,0,14,13,1,0,0
23,61802,NORTH TEXAS COL,11,english,4,59,21,38,16,4,59,26,33,21,7
23,61804,LEADERSHIP PREP,10,english,4,99,9,90,61,27,98,15,83,58,38
23,61805,TRIVIUM ACADEMY,11,english,4,66,4,62,47,23,66,15,51,36,22
23,61901,DENTON ISD,11,english,4,2295,511,1784,1082,482,2366,761,1605,1059,469
23,61902,LEWISVILLE ISD,11,english,4,3184,593,2591,1715,870,3181,860,2321,1618,801
23,61903,PILOT POINT ISD,11,english,4,107,29,78,39,16,107,39,68,32,11
23,61905,KRUM ISD,11,english,4,145,28,117,68,27,147,49,98,63,21
23,61906,PONDER ISD,11,english,4,137,38,99,44,18,137,51,86,49,22
23,61907,AUBREY ISD,11,english,4,284,42,242,170,89,280,64,216,141,57
23,61908,SANGER ISD,11,english,4,193,33,160,96,44,192,47,145,95,37
23,61910,ARGYLE ISD,11,english,4,398,38,360,285,146,399,37,362,306,178
23,61911,NORTHWEST ISD,11,english,4,2245,354,1891,1274,633,2236,648,1588,1071,510
23,61912,LAKE DALLAS ISD,11,english,4,266,71,195,98,37,265,113,152,89,34
23,61914,LITTLE ELM ISD,11,english,4,554,113,441,258,102,577,194,383,221,92
23,62901,CUERO ISD,3,english,4,135,23,112,60,24,136,37,99,66,29
23,62902,NORDHEIM ISD,3,english,4,7,0,7,5,0,7,2,5,3,1
23,62903,YOAKUM ISD,3,english,4,81,4,77,50,12,81,2,79,52,28
23,62904,YORKTOWN ISD,3,english,4,40,10,30,14,6,40,8,32,21,10
23,62905,WESTHOFF ISD,3,english,4,10,0,10,9,6,10,0,10,9,6
23,62906,MEYERSVILLE ISD,3,english,4,14,2,12,10,3,13,0,13,9,4
23,63903,SPUR ISD,17,english,4,13,2,11,7,1,13,5,8,5,2
23,63906,PATTON SPRINGS,17,english,4,0,,,,,0,,,,
23,64903,CARRIZO SPRINGS,20,english,4,151,50,101,54,25,150,57,93,50,16
23,65901,CLARENDON ISD,16,english,4,31,3,28,22,13,30,5,25,15,3
23,65902,HEDLEY ISD,16,english,4,7,1,6,5,1,7,1,6,4,2
23,66005,RAMIREZ CSD,2,english,4,0,,,,,0,,,,
23,66901,BENAVIDES ISD,2,english,4,7,3,4,1,0,7,2,5,3,0
23,66902,SAN DIEGO ISD,2,english,4,81,24,57,33,13,81,18,63,45,17
23,66903,FREER ISD,2,english,4,49,11,38,19,6,49,17,32,18,9
23,67902,CISCO ISD,14,english,4,62,11,51,36,13,62,19,43,21,9
23,67903,EASTLAND ISD,14,english,4,66,12,54,33,14,66,18,48,32,13
23,67904,GORMAN ISD,14,english,4,19,2,17,13,2,19,6,13,9,3
23,67907,RANGER ISD,14,english,4,14,5,9,2,2,14,6,8,4,1
23,67908,RISING STAR ISD,14,english,4,14,4,10,5,0,14,9,5,3,1
23,68802,COMPASS ACADEMY,18,english,4,118,29,89,50,14,117,54,63,33,6
23,68901,ECTOR COUNTY IS,18,english,4,2254,634,1620,820,297,2289,789,1500,915,349
23,69901,ROCKSPRINGS ISD,15,english,4,16,3,13,8,4,16,5,11,5,1
23,69902,NUECES CANYON C,15,english,4,17,3,14,7,3,17,12,5,3,1
23,70801,WAXAHACHIE FAIT,10,english,4,143,87,56,18,1,157,101,56,21,2
23,70901,AVALON ISD,10,english,4,24,8,16,9,4,24,14,10,3,1
23,70903,ENNIS ISD,10,english,4,387,71,316,186,77,389,77,312,233,115
23,70905,FERRIS ISD,10,english,4,150,36,114,41,15,179,62,117,50,12
23,70907,ITALY ISD,10,english,4,48,11,37,20,1,48,18,30,14,2
23,70908,MIDLOTHIAN ISD,10,english,4,810,101,709,456,228,817,137,680,524,275
23,70909,MILFORD ISD,10,english,4,11,4,7,2,0,10,5,5,2,0
23,70910,PALMER ISD,10,english,4,94,19,75,54,24,94,18,76,51,25
23,70911,RED OAK ISD,10,english,4,444,104,340,197,62,453,130,323,223,85
23,70912,WAXAHACHIE ISD,10,english,4,766,162,604,330,117,783,262,521,321,126
23,70915,MAYPEARL ISD,10,english,4,82,12,70,45,17,82,19,63,47,20
23,71801,BURNHAM WOOD CH,19,english,4,72,4,68,47,26,72,9,63,31,12
23,71806,HARMONY PUBLIC,19,english,4,390,63,327,218,109,396,116,280,176,63
23,71807,LA FE PREPARATO,19,english,4,6,1,5,3,1,6,1,5,4,1
23,71809,VISTA DEL FUTUR,19,english,4,27,4,23,15,4,27,10,17,7,3
23,71901,CLINT ISD,19,english,4,619,189,430,217,67,633,231,402,244,85
23,71902,EL PASO ISD,19,english,4,2766,540,2226,1371,605,2816,849,1967,1245,515
23,71903,FABENS ISD,19,english,4,87,19,68,36,7,90,18,72,49,21
23,71904,SAN ELIZARIO IS,19,english,4,131,41,90,37,8,184,67,117,65,22
23,71905,YSLETA ISD,19,english,4,2040,370,1670,983,383,2102,337,1765,1257,547
23,71906,ANTHONY ISD,19,english,4,48,24,24,9,1,49,23,26,11,3
23,71907,CANUTILLO ISD,19,english,4,396,49,347,222,98,400,90,310,226,111
23,71908,TORNILLO ISD,19,english,4,22,6,16,9,5,44,8,36,23,9
23,71909,SOCORRO ISD,19,english,4,3034,568,2466,1521,632,3039,782,2257,1495,593
23,72901,THREE WAY ISD,11,english,4,16,10,6,3,0,16,12,4,1,0
23,72902,DUBLIN ISD,11,english,4,72,7,65,41,23,72,5,67,48,21
23,72903,STEPHENVILLE IS,11,english,4,261,27,234,168,88,266,27,239,201,134
23,72904,BLUFF DALE ISD,11,english,4,18,5,13,6,2,18,9,9,5,3
23,72908,HUCKABAY ISD,11,english,4,27,1,26,18,5,27,1,26,20,9
23,72909,LINGLEVILLE ISD,11,english,4,16,4,12,6,2,16,6,10,6,2
23,72910,MORGAN MILL ISD,11,english,4,10,4,6,5,1,10,4,6,3,1
23,73901,CHILTON ISD,12,english,4,39,11,28,12,1,39,21,18,6,0
23,73903,MARLIN ISD,12,english,4,68,35,33,11,3,68,41,27,11,3
23,73904,WESTPHALIA ISD,12,english,4,16,2,14,12,4,16,4,12,8,2
23,73905,ROSEBUD-LOTT IS,12,english,4,48,10,38,21,10,48,15,33,25,13
23,74903,BONHAM ISD,10,english,4,131,23,108,60,28,130,50,80,47,18
23,74904,DODD CITY ISD,10,english,4,20,3,17,10,2,20,7,13,9,4
23,74905,ECTOR ISD,10,english,4,12,4,8,2,2,12,8,4,4,1
23,74907,HONEY GROVE ISD,8,english,4,33,4,29,20,9,33,7,26,15,4
23,74909,LEONARD ISD,10,english,4,53,9,44,32,10,51,14,37,23,11
23,74911,SAVOY ISD,10,english,4,21,2,19,14,3,21,3,18,10,3
23,74912,TRENTON ISD,10,english,4,56,18,38,15,4,56,31,25,8,0
23,74917,SAM RAYBURN ISD,10,english,4,35,7,28,20,8,34,7,27,20,4
23,75901,FLATONIA ISD,13,english,4,27,0,27,22,13,27,1,26,19,10
23,75902,LA GRANGE ISD,13,english,4,133,30,103,62,31,133,44,89,55,21
23,75903,SCHULENBURG ISD,13,english,4,38,16,22,10,7,38,20,18,13,6
23,75906,FAYETTEVILLE IS,13,english,4,18,1,17,11,4,19,3,16,10,1
23,75908,ROUND TOP-CARMI,13,english,4,18,1,17,12,4,18,4,14,11,3
23,76903,ROBY CISD,14,english,4,24,8,16,9,4,24,10,14,10,6
23,76904,ROTAN ISD,14,english,4,20,5,15,9,2,20,9,11,7,2
23,77901,FLOYDADA COLLEG,17,english,4,44,7,37,23,9,44,11,33,28,11
23,77902,LOCKNEY ISD,17,english,4,28,9,19,10,0,27,8,19,11,2
23,78901,CROWELL ISD,9,english,4,11,2,9,6,3,11,5,6,4,3
23,79901,LAMAR CISD,4,english,4,3119,437,2682,1855,920,3142,631,2511,1791,858
23,79906,NEEDVILLE ISD,4,english,4,275,21,254,169,74,276,28,248,184,90
23,79907,FORT BEND ISD,4,english,4,5533,996,4537,3001,1483,5544,1473,4071,2897,1507
23,79910,STAFFORD MSD,4,english,4,229,43,186,113,57,231,82,149,108,57
23,80901,MOUNT VERNON IS,8,english,4,93,26,67,45,22,94,31,63,38,18
23,81902,FAIRFIELD ISD,12,english,4,127,31,96,60,24,127,35,92,61,29
23,81904,TEAGUE ISD,12,english,4,90,14,76,51,21,90,14,76,51,21
23,81905,WORTHAM ISD,12,english,4,44,11,33,17,6,44,22,22,11,2
23,81906,DEW ISD,12,english,4,13,1,12,7,2,13,5,8,7,2
23,82902,DILLEY ISD,20,english,4,62,28,34,11,2,62,48,14,3,2
23,82903,PEARSALL ISD,20,english,4,146,56,90,49,14,146,71,75,54,14
23,83901,SEAGRAVES ISD,17,english,4,30,14,16,5,1,31,19,12,6,3
23,83902,LOOP ISD,17,english,4,14,2,12,8,2,14,1,13,8,3
23,83903,SEMINOLE ISD,17,english,4,212,48,164,83,30,213,36,177,124,65
23,84802,ODYSSEY ACADEMY,4,english,4,117,32,85,43,6,116,54,62,17,3
23,84804,AMBASSADORS PRE,4,english,4,22,3,19,5,1,21,7,14,6,1
23,84901,DICKINSON ISD,4,english,4,834,212,622,347,127,832,255,577,371,168
23,84902,GALVESTON ISD,4,english,4,391,58,333,207,84,412,120,292,181,66
23,84903,HIGH ISLAND ISD,5,english,4,7,2,5,2,1,7,5,2,2,2
23,84906,TEXAS CITY ISD,4,english,4,539,148,391,182,73,539,209,330,193,83
23,84908,HITCHCOCK ISD,4,english,4,110,46,64,23,6,110,67,43,22,9
23,84909,SANTA FE ISD,4,english,4,300,54,246,151,69,299,55,244,187,94
23,84910,CLEAR CREEK ISD,4,english,4,2738,381,2357,1621,822,2742,551,2191,1599,843
23,84911,FRIENDSWOOD ISD,4,english,4,456,23,433,347,200,454,43,411,342,221
23,85902,POST ISD,17,english,4,42,19,23,6,0,42,22,20,9,2
23,85903,SOUTHLAND ISD,17,english,4,13,4,9,5,2,13,7,6,4,2
23,86024,DOSS CONSOLIDAT,13,english,4,0,,,,,0,,,,
23,86901,FREDERICKSBURG,13,english,4,181,45,136,86,34,180,43,137,95,46
23,86902,HARPER ISD,15,english,4,39,3,36,22,8,39,7,32,26,9
23,87901,GLASSCOCK COUNT,18,english,4,14,1,13,11,8,15,1,14,10,4
23,88902,GOLIAD ISD,3,english,4,96,20,76,50,21,96,23,73,58,32
23,89901,GONZALES ISD,13,english,4,189,72,117,58,23,190,80,110,67,30
23,89903,NIXON-SMILEY CI,13,english,4,65,14,51,29,13,65,15,50,22,9
23,89905,WAELDER ISD,13,english,4,12,5,7,1,0,12,11,1,1,0
23,90902,LEFORS ISD,16,english,4,18,6,12,6,3,18,7,11,8,4
23,90903,MCLEAN ISD,16,english,4,7,1,6,2,0,7,3,4,1,0
23,90904,PAMPA ISD,16,english,4,214,50,164,93,32,215,78,137,76,25
23,90905,GRANDVIEW-HOPKI,16,english,4,0,,,,,0,,,,
23,91901,BELLS ISD,10,english,4,76,10,66,43,18,76,11,65,57,33
23,91902,COLLINSVILLE IS,10,english,4,40,6,34,18,7,40,14,26,15,7
23,91903,DENISON ISD,10,english,4,298,55,243,137,46,310,70,240,160,59
23,91905,HOWE ISD,10,english,4,79,13,66,44,18,79,25,54,35,15
23,91906,SHERMAN ISD,10,english,4,536,155,381,180,63,538,262,276,157,50
23,91907,TIOGA ISD,10,english,4,51,9,42,21,6,51,9,42,21,8
23,91908,VAN ALSTYNE ISD,10,english,4,186,14,172,124,61,185,24,161,121,54
23,91909,WHITESBORO ISD,10,english,4,114,43,71,34,12,115,47,68,39,18
23,91910,WHITEWRIGHT ISD,10,english,4,49,15,34,13,8,49,16,33,20,8
23,91913,POTTSBORO ISD,10,english,4,88,19,69,45,15,88,15,73,59,35
23,91914,S AND S CISD,10,english,4,59,14,45,23,11,59,18,41,19,5
23,91917,GUNTER ISD,10,english,4,88,10,78,48,20,88,10,78,63,30
23,91918,TOM BEAN ISD,10,english,4,53,14,39,21,8,53,8,45,32,14
23,92901,GLADEWATER ISD,7,english,4,104,34,70,30,8,103,58,45,23,6
23,92902,KILGORE ISD,7,english,4,277,72,205,103,41,277,87,190,131,67
23,92903,LONGVIEW ISD,7,english,4,522,120,402,257,110,576,132,444,302,144
23,92904,PINE TREE ISD,7,english,4,315,56,259,146,54,316,77,239,160,64
23,92906,SABINE ISD,7,english,4,115,17,98,58,25,114,30,84,48,22
23,92907,SPRING HILL ISD,7,english,4,165,15,150,105,47,165,14,151,131,74
23,92908,WHITE OAK ISD,7,english,4,124,15,109,67,20,124,18,106,75,35
23,93901,ANDERSON-SHIRO,6,english,4,69,9,60,43,13,70,8,62,47,27
23,93903,IOLA ISD,6,english,4,41,10,31,14,4,41,13,28,20,9
23,93904,NAVASOTA ISD,6,english,4,221,64,157,84,33,224,74,150,83,26
23,93905,RICHARDS ISD,6,english,4,10,3,7,5,2,10,4,6,4,4
23,94901,SEGUIN ISD,20,english,4,499,148,351,175,68,505,182,323,191,85
23,94902,SCHERTZ-CIBOLO-,20,english,4,1067,223,844,499,190,1093,360,733,436,192
23,94903,NAVARRO ISD,20,english,4,160,30,130,76,26,161,27,134,101,49
23,94904,MARION ISD,20,english,4,105,15,90,57,28,105,21,84,61,35
23,95901,ABERNATHY ISD,17,english,4,56,14,42,23,9,56,21,35,22,11
23,95902,COTTON CENTER I,17,english,4,6,3,3,1,0,6,5,1,1,0
23,95903,HALE CENTER ISD,17,english,4,39,14,25,7,2,39,10,29,17,8
23,95904,PETERSBURG ISD,17,english,4,14,5,9,2,0,14,5,9,3,0
23,95905,PLAINVIEW ISD,17,english,4,319,118,201,106,41,319,132,187,109,40
23,96904,MEMPHIS ISD,16,english,4,20,2,18,5,3,19,10,9,4,0
23,96905,TURKEY-QUITAQUE,16,english,4,10,2,8,5,0,10,4,6,4,0
23,97902,HAMILTON ISD,12,english,4,62,12,50,25,6,62,31,31,16,1
23,97903,HICO ISD,12,english,4,41,11,30,20,8,41,14,27,19,9
23,98901,GRUVER ISD,16,english,4,22,1,21,16,11,22,2,20,16,7
23,98903,PRINGLE-MORSE C,16,english,4,7,1,6,4,0,7,3,4,3,1
23,98904,SPEARMAN ISD,16,english,4,48,9,39,25,10,48,10,38,25,9
23,99902,CHILLICOTHE ISD,9,english,4,15,9,6,1,0,16,8,8,1,0
23,99903,QUANAH ISD,9,english,4,34,2,32,22,7,34,5,29,11,4
23,100903,KOUNTZE ISD,5,english,4,85,21,64,37,17,85,26,59,42,16
23,100904,SILSBEE ISD,5,english,4,214,59,155,73,19,213,79,134,83,37
23,100905,HARDIN-JEFFERSO,5,english,4,211,53,158,108,43,210,68,142,79,33
23,100907,LUMBERTON ISD,5,english,4,307,66,241,123,48,308,97,211,129,50
23,100908,WEST HARDIN COU,5,english,4,44,14,30,15,7,44,17,27,17,8
23,101802,SER-NINOS CHART,4,english,4,54,18,36,18,8,54,20,34,20,8
23,101803,ARISTOI CLASSIC,4,english,4,106,20,86,63,36,105,38,67,49,20
23,101806,RAUL YZAGUIRRE,4,english,4,86,13,73,49,24,97,7,90,61,36
23,101810,ACADEMY OF ACCE,4,english,4,82,31,51,21,8,82,48,34,19,6
23,101814,THE VARNETT PUB,4,english,4,116,47,69,30,12,116,50,66,37,12
23,101815,ALIEF MONTESSOR,4,english,4,24,1,23,18,10,24,1,23,16,8
23,101819,AMIGOS POR VIDA,4,english,4,62,7,55,36,19,62,5,57,42,20
23,101828,HOUSTON GATEWAY,4,english,4,159,12,147,101,47,162,11,151,134,87
23,101838,SOUTHWEST SCHOO,4,english,4,126,62,64,27,5,126,67,59,36,9
23,101840,TWO DIMENSIONS,4,english,4,30,12,18,9,2,30,20,10,4,0
23,101842,COMQUEST ACADEM,4,english,4,0,,,,,0,,,,
23,101845,YES PREP PUBLIC,4,english,4,175,37,138,82,37,168,43,125,90,46
23,101846,HARMONY PUBLIC,4,english,4,206,50,156,84,30,206,60,146,92,33
23,101847,BEATRICE MAYES,4,english,4,55,19,36,15,2,55,34,21,8,2
23,101849,ACCELERATED INT,4,english,4,20,8,12,5,0,20,9,11,6,0
23,101853,BAKERRIPLEY COM,4,english,4,98,54,44,10,2,97,51,46,26,9
23,101855,MEYERPARK ELEME,4,english,4,45,17,28,8,2,43,29,14,6,2
23,101856,DRAW ACADEMY,4,english,4,60,38,22,9,2,60,49,11,4,3
23,101858,HARMONY PUBLIC,4,english,4,545,142,403,271,119,545,178,367,238,114
23,101859,STEP CHARTER SC,4,english,4,75,16,59,31,18,75,34,41,28,9
23,101861,THE RHODES SCHO,4,english,4,74,29,45,18,3,74,40,34,12,3
23,101862,HARMONY PUBLIC,4,english,4,428,67,361,255,136,427,88,339,249,143
23,101868,THE PRO-VISION,4,english,4,15,10,5,0,0,15,15,0,0,0
23,101870,BETA ACADEMY,4,english,4,103,7,96,64,26,103,21,82,50,19
23,101875,BLOOM ACADEMY C,4,english,4,54,26,28,8,3,54,42,12,4,1
23,101876,REVE PREPARATOR,4,english,4,22,10,12,1,0,23,14,9,1,0
23,101902,ALDINE ISD,4,english,4,3787,1372,2415,1072,282,3850,1742,2108,1234,461
23,101903,ALIEF ISD,4,english,4,2515,857,1658,824,307,2887,1139,1748,1048,403
23,101905,CHANNELVIEW ISD,4,english,4,588,180,408,205,75,623,188,435,280,107
23,101906,CROSBY ISD,4,english,4,467,115,352,200,80,470,154,316,204,86
23,101907,CYPRESS-FAIRBAN,4,english,4,8197,1753,6444,3952,1938,8186,2438,5748,3851,1796
23,101908,DEER PARK ISD,4,english,4,785,164,621,396,164,785,162,623,425,218
23,101910,GALENA PARK ISD,4,english,4,1215,306,909,493,197,1279,306,973,620,229
23,101911,GOOSE CREEK CIS,4,english,4,1706,521,1185,641,244,1706,622,1084,675,265
23,101912,HOUSTON ISD,4,english,4,12362,3553,8809,4987,2158,12458,4397,8061,5363,2576
23,101913,HUMBLE ISD,4,english,4,3353,755,2598,1490,569,3370,1051,2319,1519,666
23,101914,KATY ISD,4,english,4,6519,790,5729,4127,2273,6586,1326,5260,3999,2261
23,101915,KLEIN ISD,4,english,4,3649,660,2989,1972,942,3677,788,2889,2166,1100
23,101916,LA PORTE ISD,4,english,4,488,90,398,217,87,490,116,374,244,95
23,101917,PASADENA ISD,4,english,4,2954,762,2192,1131,409,2887,909,1978,1176,402
23,101919,SPRING ISD,4,english,4,2230,738,1492,713,198,2274,940,1334,731,242
23,101920,SPRING BRANCH I,4,english,4,2163,410,1753,1218,725,2259,507,1752,1319,731
23,101921,TOMBALL ISD,4,english,4,1653,112,1541,1206,756,1704,177,1527,1247,757
23,101924,SHELDON ISD,4,english,4,757,260,497,253,90,761,325,436,262,112
23,101925,HUFFMAN ISD,4,english,4,277,87,190,101,33,277,110,167,102,41
23,102901,KARNACK ISD,7,english,4,6,1,5,3,1,6,0,6,3,1
23,102902,MARSHALL ISD,7,english,4,351,111,240,136,44,358,141,217,141,59
23,102903,WASKOM ISD,7,english,4,56,10,46,29,9,56,9,47,32,16
23,102904,HALLSVILLE ISD,7,english,4,811,262,549,281,116,812,408,404,239,100
23,102905,HARLETON ISD,7,english,4,56,3,53,37,15,56,12,44,25,5
23,102906,ELYSIAN FIELDS,7,english,4,57,7,50,30,13,57,22,35,18,5
23,103901,CHANNING ISD,16,english,4,14,5,9,3,1,14,7,7,3,0
23,103902,HARTLEY ISD,16,english,4,19,2,17,9,3,19,6,13,7,1
23,104901,HASKELL CISD,14,english,4,41,7,34,18,5,41,17,24,11,3
23,104903,RULE ISD,14,english,4,8,1,7,1,0,8,6,2,1,0
23,104907,PAINT CREEK ISD,14,english,4,8,1,7,3,0,8,2,6,4,2
23,105802,TEXAS PREPARATO,13,english,4,7,4,3,0,0,7,4,3,2,0
23,105803,KI CHARTER ACAD,13,english,4,7,4,3,0,0,0,,,,
23,105804,DORAL ACADEMY O,13,english,4,35,14,21,10,6,35,20,15,11,4
23,105902,SAN MARCOS CISD,13,english,4,535,150,385,210,80,568,259,309,172,72
23,105904,DRIPPING SPRING,13,english,4,607,37,570,435,251,609,74,535,418,227
23,105905,WIMBERLEY ISD,13,english,4,182,19,163,116,60,182,43,139,79,28
23,105906,HAYS CISD,13,english,4,1537,307,1230,802,365,1558,435,1123,731,337
23,106901,CANADIAN ISD,16,english,4,42,4,38,19,9,42,10,32,14,4
23,107901,ATHENS ISD,10,english,4,196,52,144,89,36,194,60,134,80,39
23,107902,BROWNSBORO ISD,7,english,4,183,52,131,71,26,183,59,124,83,34
23,107904,CROSS ROADS ISD,7,english,4,36,8,28,13,3,36,8,28,16,4
23,107905,EUSTACE ISD,7,english,4,104,16,88,49,18,104,20,84,54,18
23,107906,MALAKOFF ISD,7,english,4,100,9,91,48,17,100,22,78,51,29
23,107907,TRINIDAD ISD,7,english,4,7,5,2,0,0,7,5,2,2,0
23,107908,MURCHISON ISD,7,english,4,22,9,13,4,1,22,12,10,3,2
23,107910,LAPOYNOR ISD,7,english,4,26,1,25,19,4,26,17,9,3,3
23,108802,HORIZON MONTESS,1,english,4,109,21,88,43,13,109,55,54,27,12
23,108807,IDEA PUBLIC SCH,1,english,4,5877,1344,4533,2729,1257,5885,2041,3844,2216,805
23,108808,VANGUARD ACADEM,1,english,4,454,89,365,227,101,458,95,363,269,131
23,108809,EXCELLENCE IN L,1,english,4,25,8,17,10,4,25,10,15,10,5
23,108902,DONNA ISD,1,english,4,699,244,455,196,61,843,323,520,269,74
23,108903,EDCOUCH-ELSA IS,1,english,4,251,104,147,61,17,254,134,120,64,19
23,108904,EDINBURG CISD,1,english,4,2175,484,1691,991,468,2185,536,1649,1153,498
23,108905,HIDALGO ISD,1,english,4,122,18,104,76,35,160,15,145,131,73
23,108906,MCALLEN ISD,1,english,4,1214,255,959,643,335,1259,298,961,692,348
23,108907,MERCEDES ISD,1,english,4,290,109,181,96,31,304,112,192,125,45
23,108908,MISSION CISD,1,english,4,715,180,535,286,105,880,285,595,377,157
23,108909,PHARR-SAN JUAN-,1,english,4,1550,357,1193,694,302,1833,499,1334,903,412
23,108910,PROGRESO ISD,1,english,4,71,14,57,25,5,98,21,77,51,11
23,108911,SHARYLAND ISD,1,english,4,545,88,457,297,153,552,111,441,302,135
23,108912,LA JOYA ISD,1,english,4,913,173,740,443,187,1577,465,1112,739,289
23,108913,WESLACO ISD,1,english,4,1062,218,844,506,233,1065,287,778,548,248
23,108914,LA VILLA ISD,1,english,4,33,19,14,3,0,33,20,13,6,3
23,108915,MONTE ALTO ISD,1,english,4,54,20,34,17,5,54,18,36,23,6
23,108916,VALLEY VIEW ISD,1,english,4,204,24,180,122,50,210,23,187,140,86
23,109901,ABBOTT ISD,12,english,4,19,1,18,11,6,19,5,14,12,4
23,109902,BYNUM ISD,12,english,4,19,7,12,7,4,19,6,13,8,5
23,109903,COVINGTON ISD,12,english,4,29,8,21,7,1,29,20,9,2,0
23,109904,HILLSBORO ISD,12,english,4,135,40,95,41,12,135,72,63,25,13
23,109905,HUBBARD ISD,12,english,4,33,10,23,13,4,33,14,19,11,5
23,109907,ITASCA ISD,12,english,4,34,7,27,13,4,36,21,15,7,5
23,109908,MALONE ISD,12,english,4,17,4,13,4,2,17,8,9,4,2
23,109910,MOUNT CALM ISD,12,english,4,15,6,9,1,0,15,11,4,1,0
23,109911,WHITNEY ISD,12,english,4,108,34,74,36,10,108,63,45,21,5
23,109912,AQUILLA ISD,12,english,4,17,1,16,12,5,18,2,16,12,2
23,109913,BLUM ISD,12,english,4,17,0,17,13,4,17,2,15,11,4
23,109914,PENELOPE ISD,12,english,4,12,1,11,8,0,12,4,8,5,1
23,110901,ANTON ISD,17,english,4,8,1,7,2,0,8,2,6,4,1
23,110902,LEVELLAND ISD,17,english,4,180,67,113,52,18,179,83,96,57,20
23,110905,ROPES ISD,17,english,4,35,7,28,18,8,35,13,22,13,5
23,110906,SMYER ISD,17,english,4,29,3,26,14,5,28,7,21,14,4
23,110907,SUNDOWN ISD,17,english,4,35,2,33,27,12,35,2,33,30,13
23,110908,WHITHARRAL ISD,17,english,4,15,4,11,10,4,15,3,12,8,4
23,111901,GRANBURY ISD,11,english,4,615,118,497,336,156,628,134,494,377,191
23,111902,LIPAN ISD,11,english,4,31,7,24,15,4,31,13,18,11,5
23,111903,TOLAR ISD,11,english,4,63,14,49,26,9,60,14,46,26,13
23,112901,SULPHUR SPRINGS,8,english,4,281,53,228,122,49,305,78,227,159,74
23,112905,CUMBY COLLEGIAT,8,english,4,33,9,24,10,1,33,10,23,12,8
23,112906,NORTH HOPKINS I,8,english,4,35,6,29,18,8,34,4,30,22,10
23,112907,MILLER GROVE IS,8,english,4,19,4,15,9,3,19,9,10,7,0
23,112908,COMO-PICKTON CI,8,english,4,40,10,30,13,4,40,14,26,18,4
23,112909,SALTILLO ISD,8,english,4,17,2,15,9,4,17,1,16,13,7
23,112910,SULPHUR BLUFF I,8,english,4,9,1,8,5,2,9,4,5,2,1
23,113901,CROCKETT ISD,6,english,4,68,36,32,8,2,69,48,21,6,1
23,113902,GRAPELAND ISD,6,english,4,36,7,29,16,5,36,11,25,10,6
23,113903,LOVELADY ISD,6,english,4,41,12,29,14,4,42,8,34,21,6
23,113905,LATEXO ISD,6,english,4,41,4,37,16,4,41,18,23,10,3
23,113906,KENNARD ISD,6,english,4,13,1,12,4,1,13,3,10,9,4
23,114901,BIG SPRING ISD,18,english,4,210,54,156,68,22,209,35,174,125,49
23,114902,COAHOMA ISD,18,english,4,83,5,78,42,11,83,19,64,39,18
23,114904,FORSAN ISD,18,english,4,50,5,45,30,13,50,16,34,16,8
23,115901,FT HANCOCK ISD,19,english,4,23,5,18,5,2,28,13,15,3,0
23,115902,SIERRA BLANCA I,19,english,4,7,3,4,3,1,7,5,2,1,0
23,115903,DELL CITY ISD,19,english,4,6,3,3,1,1,6,4,2,1,0
23,116901,CADDO MILLS ISD,10,english,4,201,23,178,117,39,202,28,174,127,47
23,116902,CELESTE ISD,10,english,4,32,6,26,12,4,32,10,22,15,7
23,116903,COMMERCE ISD,10,english,4,103,39,64,34,6,104,51,53,23,6
23,116905,GREENVILLE ISD,10,english,4,325,122,203,90,26,352,192,160,87,28
23,116906,LONE OAK ISD,10,english,4,64,9,55,33,13,64,27,37,19,6
23,116908,QUINLAN ISD,10,english,4,201,71,130,52,17,204,69,135,69,33
23,116909,WOLFE CITY ISD,10,english,4,46,8,38,19,8,46,6,40,29,15
23,116910,CAMPBELL ISD,10,english,4,27,8,19,10,1,27,10,17,10,1
23,116915,BLAND ISD,10,english,4,50,9,41,24,15,50,11,39,35,16
23,116916,BOLES ISD,10,english,4,34,4,30,21,5,34,11,23,16,6
23,117901,BORGER ISD,16,english,4,161,47,114,59,17,161,57,104,62,29
23,117903,SANFORD-FRITCH,16,english,4,59,10,49,26,7,59,26,33,12,1
23,117904,PLEMONS-STINNET,16,english,4,37,5,32,21,5,37,13,24,16,6
23,117907,SPRING CREEK IS,16,english,4,7,2,5,3,1,7,2,5,3,1
23,118902,IRION COUNTY IS,15,english,4,22,2,20,15,5,22,4,18,14,6
23,119901,BRYSON ISD,9,english,4,17,0,17,11,2,17,4,13,6,3
23,119902,JACKSBORO ISD,9,english,4,76,19,57,21,10,76,33,43,24,6
23,119903,PERRIN-WHITT CI,9,english,4,23,4,19,10,3,23,5,18,9,1
23,120901,EDNA ISD,3,english,4,104,21,83,48,20,105,26,79,48,25
23,120902,GANADO ISD,3,english,4,61,9,52,36,19,61,11,50,37,20
23,120905,INDUSTRIAL ISD,3,english,4,78,1,77,61,30,78,5,73,57,34
23,121902,BROOKELAND ISD,5,english,4,29,4,25,11,3,29,7,22,9,3
23,121903,BUNA ISD,5,english,4,108,20,88,57,17,109,22,87,59,20
23,121904,JASPER ISD,5,english,4,155,86,69,22,7,155,114,41,11,4
23,121905,KIRBYVILLE CISD,5,english,4,101,30,71,35,16,101,25,76,50,25
23,121906,EVADALE ISD,5,english,4,31,5,26,15,2,31,6,25,16,4
23,122901,FT DAVIS ISD,18,english,4,6,0,6,4,1,6,2,4,1,0
23,122902,VALENTINE ISD,18,english,4,0,,,,,0,,,,
23,123803,TEKOA ACADEMY O,5,english,4,13,3,10,6,2,13,3,10,6,0
23,123805,EHRHART SCHOOL,5,english,4,54,9,45,24,8,54,12,42,26,8
23,123807,BOB HOPE SCHOOL,5,english,4,126,34,92,57,21,128,33,95,64,29
23,123905,NEDERLAND ISD,5,english,4,397,36,361,244,110,400,52,348,266,131
23,123907,PORT ARTHUR ISD,5,english,4,588,204,384,153,37,590,250,340,200,63
23,123908,PORT NECHES-GRO,5,english,4,386,51,335,195,70,385,113,272,162,58
23,123910,BEAUMONT ISD,5,english,4,1148,469,679,316,116,1149,639,510,253,90
23,123913,SABINE PASS ISD,5,english,4,16,2,14,7,4,17,9,8,1,0
23,123914,HAMSHIRE-FANNET,5,english,4,141,16,125,73,33,141,21,120,92,39
23,124901,JIM HOGG COUNTY,1,english,4,71,15,56,28,11,71,17,54,39,9
23,125901,ALICE ISD,2,english,4,325,82,243,131,39,327,94,233,167,73
23,125902,BEN BOLT-PALITO,2,english,4,29,1,28,19,9,29,4,25,19,8
23,125903,ORANGE GROVE IS,2,english,4,121,21,100,79,47,121,24,97,68,32
23,125905,PREMONT ISD,2,english,4,42,17,25,11,1,42,21,21,11,2
23,125906,LA GLORIA ISD,2,english,4,11,1,10,7,1,11,1,10,1,0
23,126901,ALVARADO ISD,11,english,4,253,80,173,80,27,258,124,134,65,27
23,126902,BURLESON ISD,11,english,4,933,136,797,535,246,934,234,700,488,250
23,126903,CLEBURNE ISD,11,english,4,466,116,350,159,51,482,140,342,202,62
23,126904,GRANDVIEW ISD,11,english,4,86,8,78,64,31,86,15,71,42,15
23,126905,JOSHUA ISD,11,english,4,412,70,342,211,96,420,78,342,261,121
23,126906,KEENE ISD,11,english,4,52,8,44,24,10,51,16,35,25,9
23,126907,RIO VISTA ISD,11,english,4,78,18,60,30,13,77,30,47,39,15
23,126908,VENUS ISD,11,english,4,150,61,89,38,9,150,79,71,35,7
23,126911,GODLEY ISD,11,english,4,204,40,164,90,25,202,58,144,89,32
23,127901,ANSON ISD,14,english,4,59,17,42,26,7,59,31,28,18,4
23,127903,HAMLIN COLLEGIA,14,english,4,31,9,22,13,3,31,8,23,16,5
23,127904,HAWLEY ISD,14,english,4,65,16,49,33,7,65,21,44,25,6
23,127905,LUEDERS-AVOCA I,14,english,4,5,2,3,3,0,5,4,1,0,0
23,127906,STAMFORD ISD,14,english,4,47,4,43,25,6,47,19,28,16,4
23,128901,KARNES CITY ISD,20,english,4,142,54,88,48,17,142,82,60,27,10
23,128902,KENEDY ISD,3,english,4,38,7,31,11,4,38,16,22,8,2
23,128903,RUNGE ISD,3,english,4,7,2,5,1,0,7,4,3,1,1
23,128904,FALLS CITY ISD,20,english,4,30,2,28,24,10,30,1,29,24,13
23,129901,CRANDALL ISD,10,english,4,442,118,324,174,79,438,154,284,174,65
23,129902,FORNEY ISD,10,english,4,1183,248,935,574,294,1210,386,824,535,282
23,129903,KAUFMAN ISD,10,english,4,311,71,240,152,62,308,77,231,159,77
23,129904,KEMP ISD,10,english,4,132,39,93,47,14,132,36,96,64,22
23,129905,MABANK ISD,10,english,4,269,54,215,114,41,268,51,217,163,80
23,129906,TERRELL ISD,10,english,4,385,140,245,103,28,386,170,216,111,35
23,129910,SCURRY-ROSSER I,10,english,4,74,15,59,23,7,74,30,44,29,11
23,130801,MEADOWLAND CHAR,20,english,4,0,,,,,0,,,,
23,130901,BOERNE ISD,20,english,4,694,68,626,480,249,697,122,575,418,214
23,130902,COMFORT ISD,13,english,4,64,21,43,16,4,64,30,34,22,6
23,131001,KENEDY COUNTY W,2,english,4,10,3,7,4,2,10,6,4,2,1
23,132902,JAYTON-GIRARD I,17,english,4,15,0,15,10,2,15,3,12,9,2
23,133901,CENTER POINT IS,20,english,4,30,6,24,12,3,30,15,15,8,2
23,133902,HUNT ISD,20,english,4,21,2,19,13,4,21,3,18,12,3
23,133903,KERRVILLE ISD,20,english,4,329,54,275,168,83,329,90,239,149,76
23,133904,INGRAM ISD,20,english,4,73,11,62,38,12,73,9,64,48,20
23,133905,DIVIDE ISD,20,english,4,5,1,4,2,0,5,3,2,2,0
23,134901,JUNCTION ISD,15,english,4,36,6,30,16,6,36,8,28,21,11
23,135001,GUTHRIE CSD,17,english,4,6,0,6,3,2,6,1,5,4,1
23,136901,BRACKETT ISD,20,english,4,32,6,26,11,3,32,5,27,19,6
23,137901,KINGSVILLE ISD,2,english,4,191,70,121,59,25,191,102,89,51,23
23,137902,RICARDO ISD,2,english,4,64,6,58,39,18,63,8,55,42,16
23,137903,RIVIERA ISD,2,english,4,22,8,14,8,2,22,11,11,7,1
23,137904,SANTA GERTRUDIS,2,english,4,39,2,37,29,18,39,8,31,21,10
23,138902,KNOX CITY-O'BRI,9,english,4,11,4,7,5,3,11,0,11,8,3
23,138903,MUNDAY CISD,9,english,4,27,5,22,12,6,27,7,20,16,9
23,138904,BENJAMIN ISD,9,english,4,6,0,6,4,4,6,0,6,5,2
23,139905,CHISUM ISD,8,english,4,81,6,75,53,20,81,22,59,40,4
23,139909,PARIS ISD,8,english,4,268,74,194,100,34,273,89,184,101,34
23,139911,NORTH LAMAR ISD,8,english,4,151,41,110,57,24,151,57,94,55,24
23,139912,PRAIRILAND ISD,8,english,4,83,20,63,37,11,83,15,68,42,14
23,140901,AMHERST ISD,17,english,4,8,2,6,1,0,8,7,1,0,0
23,140904,LITTLEFIELD ISD,17,english,4,84,15,69,40,11,83,45,38,24,5
23,140905,OLTON ISD,17,english,4,49,11,38,16,6,49,10,39,19,6
23,140907,SPRINGLAKE-EART,17,english,4,20,4,16,12,3,20,5,15,11,4
23,140908,SUDAN ISD,17,english,4,36,4,32,22,9,36,6,30,19,9
23,141901,LAMPASAS ISD,12,english,4,244,37,207,118,34,245,71,174,98,33
23,141902,LOMETA ISD,12,english,4,23,15,8,3,1,23,16,7,4,0
23,142901,COTULLA ISD,20,english,4,87,25,62,25,8,87,28,59,36,8
23,143901,HALLETTSVILLE I,3,english,4,77,11,66,34,12,77,12,65,49,29
23,143902,MOULTON ISD,3,english,4,20,5,15,10,4,20,8,12,10,6
23,143903,SHINER ISD,3,english,4,54,2,52,44,20,54,4,50,42,20
23,143904,VYSEHRAD ISD,3,english,4,5,0,5,3,1,5,1,4,4,1
23,143905,SWEET HOME ISD,3,english,4,14,5,9,8,3,14,4,10,7,2
23,143906,EZZELL ISD,3,english,4,11,0,11,8,5,11,0,11,10,6
23,144901,GIDDINGS ISD,13,english,4,125,39,86,47,17,125,43,82,42,14
23,144902,LEXINGTON ISD,13,english,4,87,17,70,38,13,88,15,73,47,18
23,144903,DIME BOX ISD,13,english,4,12,3,9,4,3,12,9,3,1,1
23,145901,BUFFALO ISD,6,english,4,60,12,48,30,14,60,21,39,20,6
23,145902,CENTERVILLE ISD,6,english,4,52,6,46,28,14,51,17,34,22,9
23,145906,NORMANGEE ISD,6,english,4,47,13,34,19,9,47,16,31,19,5
23,145907,OAKWOOD ISD,6,english,4,16,5,11,3,0,16,6,10,8,2
23,145911,LEON ISD,6,english,4,45,10,35,22,8,45,13,32,21,8
23,146901,CLEVELAND ISD,4,english,4,735,330,405,139,36,817,418,399,197,59
23,146902,DAYTON ISD,4,english,4,385,96,289,165,66,400,131,269,175,68
23,146903,DEVERS ISD,4,english,4,20,1,19,19,13,20,1,19,19,9
23,146904,HARDIN ISD,5,english,4,99,24,75,46,18,99,42,57,36,16
23,146905,HULL-DAISETTA I,5,english,4,35,17,18,7,5,35,18,17,12,5
23,146906,LIBERTY ISD,5,english,4,183,54,129,74,25,183,83,100,54,14
23,146907,TARKINGTON ISD,4,english,4,142,33,109,59,19,142,41,101,67,29
23,147901,COOLIDGE ISD,12,english,4,19,2,17,10,4,19,5,14,9,2
23,147902,GROESBECK ISD,12,english,4,109,22,87,42,13,108,38,70,39,18
23,147903,MEXIA ISD,12,english,4,117,41,76,37,10,117,57,60,33,9
23,148901,BOOKER ISD,16,english,4,18,1,17,9,4,18,2,16,11,7
23,148902,FOLLETT ISD,16,english,4,10,3,7,2,0,10,5,5,2,1
23,148905,DARROUZETT ISD,16,english,4,10,5,5,1,0,10,8,2,1,0
23,149901,GEORGE WEST ISD,2,english,4,80,9,71,48,21,80,7,73,47,21
23,149902,THREE RIVERS IS,2,english,4,38,10,28,12,4,37,9,28,18,5
23,150901,LLANO ISD,13,english,4,132,34,98,45,15,132,40,92,61,26
23,152504,TEXAS TECH UNIV,17,english,4,17,3,14,12,4,15,3,12,7,4
23,152802,RISE ACADEMY,17,english,4,24,2,22,15,8,24,4,20,13,4
23,152806,BETTY M CONDRA,17,english,4,28,11,17,4,1,28,22,6,3,0
23,152901,LUBBOCK ISD,17,english,4,1620,349,1271,709,332,1637,479,1158,726,349
23,152902,NEW DEAL ISD,17,english,4,45,14,31,12,5,45,24,21,12,3
23,152903,SLATON ISD,17,english,4,70,19,51,32,14,70,33,37,18,5
23,152906,LUBBOCK-COOPER,17,english,4,551,73,478,324,186,567,92,475,373,205
23,152907,FRENSHIP ISD,17,english,4,824,146,678,437,208,841,201,640,433,190
23,152908,ROOSEVELT ISD,17,english,4,74,28,46,18,3,75,24,51,33,10
23,152909,SHALLOWATER ISD,17,english,4,126,10,116,79,36,126,13,113,85,38
23,152910,IDALOU ISD,17,english,4,76,6,70,54,33,76,12,64,49,25
23,153903,O'DONNELL ISD,17,english,4,22,5,17,10,1,22,12,10,1,0
23,153904,TAHOKA ISD,17,english,4,34,8,26,20,11,34,3,31,28,20
23,153905,NEW HOME ISD,17,english,4,45,1,44,37,10,45,3,42,26,13
23,153907,WILSON ISD,17,english,4,9,2,7,5,1,9,3,6,3,0
23,154901,MADISONVILLE CI,6,english,4,172,46,126,74,32,172,55,117,81,30
23,154903,NORTH ZULCH ISD,6,english,4,33,6,27,18,5,33,7,26,17,7
23,155901,JEFFERSON ISD,8,english,4,74,16,58,30,12,74,22,52,27,8
23,156902,STANTON ISD,18,english,4,88,19,69,33,14,88,19,69,35,16
23,156905,GRADY ISD,18,english,4,21,0,21,16,11,21,3,18,16,11
23,157901,MASON ISD,15,english,4,44,5,39,26,12,44,9,35,19,6
23,158901,BAY CITY ISD,3,english,4,239,91,148,78,27,239,89,150,92,43
23,158902,TIDEHAVEN ISD,3,english,4,64,5,59,44,23,64,3,61,53,36
23,158904,MATAGORDA ISD,3,english,4,11,2,9,7,1,11,3,8,5,3
23,158905,PALACIOS ISD,3,english,4,92,27,65,40,21,92,17,75,55,22
23,158906,VAN VLECK ISD,3,english,4,72,12,60,39,18,72,18,54,34,10
23,159901,EAGLE PASS ISD,20,english,4,914,242,672,331,120,922,290,632,393,150
23,160901,BRADY ISD,15,english,4,63,15,48,28,7,63,19,44,31,10
23,160904,ROCHELLE ISD,15,english,4,12,1,11,6,1,12,8,4,3,1
23,160905,LOHN ISD,15,english,4,16,4,12,7,3,16,7,9,7,5
23,161801,WACO CHARTER SC,12,english,4,27,15,12,4,0,27,20,7,2,0
23,161802,RAPOPORT ACADEM,12,english,4,65,34,31,7,2,64,29,35,14,6
23,161807,HARMONY PUBLIC,12,english,4,707,186,521,299,124,707,268,439,247,104
23,161901,CRAWFORD ISD,12,english,4,50,4,46,35,19,50,14,36,26,6
23,161903,MIDWAY ISD,12,english,4,611,83,528,380,213,610,106,504,381,198
23,161906,LA VEGA ISD,12,english,4,189,57,132,65,20,190,86,104,51,15
23,161907,LORENA ISD,12,english,4,154,16,138,99,61,153,10,143,107,52
23,161908,MART ISD,12,english,4,50,8,42,20,6,48,20,28,17,8
23,161909,MCGREGOR ISD,12,english,4,107,24,83,47,17,107,43,64,27,4
23,161910,MOODY ISD,12,english,4,55,10,45,31,18,55,22,33,27,9
23,161912,RIESEL ISD,12,english,4,48,6,42,25,18,48,12,36,28,15
23,161914,WACO ISD,12,english,4,966,407,559,242,73,968,583,385,168,50
23,161916,WEST ISD,12,english,4,81,15,66,39,14,81,14,67,48,21
23,161918,AXTELL ISD,12,english,4,61,4,57,42,17,61,9,52,34,9
23,161919,BRUCEVILLE-EDDY,12,english,4,41,17,24,7,1,40,13,27,15,5
23,161920,CHINA SPRING IS,12,english,4,242,34,208,136,68,241,40,201,156,76
23,161921,CONNALLY ISD,12,english,4,173,91,82,26,6,173,112,61,29,8
23,161922,ROBINSON ISD,12,english,4,168,23,145,94,46,167,29,138,95,49
23,161923,BOSQUEVILLE ISD,12,english,4,61,10,51,27,14,61,25,36,24,5
23,161924,HALLSBURG ISD,12,english,4,16,4,12,7,2,16,13,3,1,0
23,161925,GHOLSON ISD,12,english,4,14,4,10,4,2,14,6,8,4,1
23,162904,MCMULLEN COUNTY,2,english,4,17,1,16,12,7,17,2,15,12,10
23,163901,DEVINE ISD,20,english,4,136,25,111,61,21,137,42,95,54,17
23,163902,D'HANIS ISD,20,english,4,15,0,15,15,9,15,0,15,10,4
23,163903,NATALIA ISD,20,english,4,62,18,44,23,8,62,23,39,30,7
23,163904,HONDO ISD,20,english,4,132,47,85,41,17,131,57,74,38,14
23,163908,MEDINA VALLEY I,20,english,4,561,82,479,321,139,568,137,431,291,135
23,164901,MENARD ISD,15,english,4,17,3,14,8,4,16,6,10,2,0
23,165802,MIDLAND ACADEMY,18,english,4,48,5,43,31,9,48,10,38,21,7
23,165901,MIDLAND ISD,18,english,4,2066,535,1531,795,270,2052,593,1459,1004,435
23,165902,GREENWOOD ISD,18,english,4,225,47,178,115,33,224,50,174,118,53
23,166901,CAMERON ISD,6,english,4,100,30,70,29,13,95,42,53,22,9
23,166902,GAUSE ISD,6,english,4,14,2,12,4,1,13,4,9,4,1
23,166903,MILANO ISD,6,english,4,26,1,25,18,6,26,1,25,18,11
23,166904,ROCKDALE ISD,6,english,4,88,30,58,24,5,88,50,38,21,7
23,166905,THORNDALE ISD,13,english,4,48,5,43,19,5,48,15,33,20,7
23,166907,BUCKHOLTS ISD,12,english,4,11,8,3,0,0,12,9,3,0,0
23,167901,GOLDTHWAITE ISD,12,english,4,36,6,30,23,9,36,9,27,12,6
23,167902,MULLIN ISD,12,english,4,5,0,5,4,0,5,2,3,1,0
23,167904,PRIDDY ISD,12,english,4,0,,,,,0,,,,
23,168901,COLORADO ISD,14,english,4,48,11,37,18,2,48,21,27,12,2
23,168902,LORAINE ISD,14,english,4,11,2,9,5,2,11,1,10,8,2
23,168903,WESTBROOK ISD,14,english,4,19,6,13,5,3,19,4,15,7,3
23,169901,BOWIE ISD,9,english,4,128,37,91,32,7,128,53,75,36,10
23,169902,NOCONA ISD,9,english,4,51,9,42,33,10,51,7,44,36,15
23,169906,GOLD BURG ISD,9,english,4,7,0,7,2,1,7,4,3,1,0
23,169908,MONTAGUE ISD,9,english,4,19,1,18,9,3,19,1,18,12,5
23,169909,PRAIRIE VALLEY,9,english,4,9,1,8,3,1,9,2,7,2,1
23,169910,FORESTBURG ISD,9,english,4,11,5,6,0,0,11,10,1,0,0
23,169911,SAINT JO ISD,9,english,4,17,1,16,13,3,17,4,13,9,4
23,170801,TEXAS SERENITY,4,english,4,22,19,3,0,0,22,21,1,1,0
23,170802,THRIVE CENTER F,6,english,4,5,3,2,1,1,5,4,1,0,0
23,170902,CONROE ISD,6,english,4,4788,647,4141,2904,1478,4833,825,4008,3141,1768
23,170903,MONTGOMERY ISD,6,english,4,683,69,614,454,237,682,114,568,432,231
23,170904,WILLIS ISD,6,english,4,620,153,467,244,84,626,206,420,255,89
23,170906,MAGNOLIA ISD,6,english,4,975,154,821,573,280,981,194,787,571,300
23,170907,SPLENDORA ISD,6,english,4,371,110,261,122,30,372,132,240,121,44
23,170908,NEW CANEY ISD,6,english,4,1231,343,888,497,201,1235,434,801,512,219
23,171901,DUMAS ISD,16,english,4,288,64,224,136,48,288,64,224,161,72
23,171902,SUNRAY COLLEGIA,16,english,4,39,4,35,25,6,39,9,30,18,8
23,172902,DAINGERFIELD-LO,8,english,4,75,18,57,36,13,75,28,47,30,12
23,172905,PEWITT CISD,8,english,4,50,7,43,30,10,50,8,42,21,6
23,173901,MOTLEY COUNTY I,17,english,4,11,1,10,4,1,11,3,8,4,2
23,174801,STEPHEN F AUSTI,7,english,4,41,1,40,35,28,40,4,36,30,19
23,174901,CHIRENO ISD,7,english,4,23,4,19,14,4,23,6,17,10,3
23,174902,CUSHING ISD,7,english,4,39,8,31,15,4,39,11,28,20,7
23,174903,GARRISON ISD,7,english,4,54,9,45,24,5,53,8,45,29,8
23,174904,NACOGDOCHES ISD,7,english,4,386,148,238,102,40,390,224,166,75,17
23,174906,WODEN ISD,7,english,4,66,18,48,20,6,66,28,38,26,8
23,174908,CENTRAL HEIGHTS,7,english,4,92,9,83,51,20,92,29,63,39,18
23,174909,MARTINSVILLE IS,7,english,4,16,2,14,7,2,16,6,10,4,2
23,174911,DOUGLASS ISD,7,english,4,26,3,23,20,12,26,2,24,18,9
23,175902,BLOOMING GROVE,12,english,4,55,13,42,25,6,55,13,42,27,9
23,175903,CORSICANA ISD,12,english,4,444,136,308,166,55,460,137,323,212,90
23,175904,DAWSON ISD,12,english,4,28,4,24,13,7,28,8,20,5,3
23,175905,FROST ISD,12,english,4,25,12,13,7,3,25,6,19,10,3
23,175907,KERENS ISD,12,english,4,32,6,26,13,6,32,12,20,11,2
23,175910,MILDRED ISD,12,english,4,57,5,52,34,16,57,9,48,35,10
23,175911,RICE ISD,12,english,4,60,13,47,24,9,61,22,39,24,9
23,176901,BURKEVILLE ISD,5,english,4,16,6,10,1,0,15,6,9,6,1
23,176902,NEWTON ISD,5,english,4,60,13,47,29,12,61,14,47,30,13
23,176903,DEWEYVILLE ISD,5,english,4,37,15,22,8,2,37,16,21,9,2
23,177901,ROSCOE COLLEGIA,14,english,4,476,201,275,126,38,481,329,152,60,15
23,177902,SWEETWATER ISD,14,english,4,120,44,76,37,22,120,56,64,45,18
23,177903,BLACKWELL CISD,14,english,4,11,0,11,7,1,11,3,8,3,0
23,177905,HIGHLAND ISD,14,english,4,13,1,12,8,5,13,1,12,10,7
23,178801,DR M L GARZA-GO,2,english,4,19,6,13,6,1,19,11,8,3,1
23,178807,CORPUS CHRISTI,2,english,4,18,0,18,12,1,18,10,8,1,0
23,178808,SEASHORE CHARTE,2,english,4,50,1,49,35,14,50,13,37,29,8
23,178901,AGUA DULCE ISD,2,english,4,24,3,21,17,7,24,7,17,7,1
23,178902,BISHOP CISD,2,english,4,91,10,81,57,33,91,5,86,73,48
23,178903,CALALLEN ISD,2,english,4,275,46,229,131,50,275,60,215,148,69
23,178904,CORPUS CHRISTI,2,english,4,2296,549,1747,1001,452,2277,572,1705,1122,479
23,178905,DRISCOLL ISD,2,english,4,40,2,38,32,8,40,11,29,12,4
23,178906,LONDON ISD,2,english,4,109,10,99,70,38,108,11,97,78,40
23,178908,PORT ARANSAS IS,2,english,4,36,6,30,26,8,36,9,27,14,8
23,178909,ROBSTOWN ISD,2,english,4,169,49,120,46,13,169,77,92,54,13
23,178912,TULOSO-MIDWAY I,2,english,4,276,51,225,126,48,276,82,194,113,45
23,178913,BANQUETE ISD,2,english,4,58,13,45,22,10,58,9,49,29,14
23,178914,FLOUR BLUFF ISD,2,english,4,385,55,330,211,97,386,89,297,202,85
23,178915,WEST OSO ISD,2,english,4,132,38,94,43,9,132,58,74,36,10
23,179901,PERRYTON ISD,16,english,4,129,28,101,51,18,129,47,82,43,18
23,180901,BOYS RANCH ISD,16,english,4,5,0,5,3,2,5,2,3,3,0
23,180902,VEGA ISD,16,english,4,30,1,29,26,14,30,4,26,21,12
23,180903,ADRIAN ISD,16,english,4,7,3,4,1,0,7,2,5,1,0
23,180904,WILDORADO ISD,16,english,4,18,4,14,10,3,18,5,13,8,2
23,181901,BRIDGE CITY ISD,5,english,4,219,36,183,123,59,216,60,156,95,43
23,181905,ORANGEFIELD ISD,5,english,4,140,22,118,73,26,140,38,102,55,18
23,181906,WEST ORANGE-COV,5,english,4,176,72,104,34,9,172,111,61,21,3
23,181907,VIDOR ISD,5,english,4,320,90,230,117,45,320,83,237,149,76
23,181908,LITTLE CYPRESS-,5,english,4,250,72,178,72,36,252,118,134,72,21
23,182901,GORDON ISD,11,english,4,16,5,11,6,1,16,12,4,2,0
23,182902,GRAFORD ISD,11,english,4,20,5,15,9,3,20,5,15,6,2
23,182903,MINERAL WELLS I,11,english,4,234,48,186,106,36,241,65,176,123,62
23,182904,SANTO ISD,11,english,4,40,5,35,21,12,39,5,34,25,9
23,182905,STRAWN ISD,11,english,4,8,1,7,6,3,8,2,6,3,2
23,182906,PALO PINTO ISD,11,english,4,9,0,9,8,4,9,0,9,9,6
23,183901,BECKVILLE ISD,7,english,4,50,11,39,16,6,50,9,41,32,14
23,183902,CARTHAGE ISD,7,english,4,181,45,136,66,19,180,59,121,72,31
23,183904,GARY ISD,7,english,4,37,7,30,19,7,36,12,24,16,7
23,184901,POOLVILLE ISD,11,english,4,51,5,46,23,6,51,17,34,17,5
23,184902,SPRINGTOWN ISD,11,english,4,296,55,241,149,65,296,78,218,147,78
23,184903,WEATHERFORD ISD,11,english,4,580,121,459,259,109,581,167,414,259,112
23,184904,MILLSAP ISD,11,english,4,77,19,58,36,16,77,25,52,34,15
23,184907,ALEDO ISD,11,english,4,585,50,535,416,254,583,78,505,410,237
23,184908,PEASTER ISD,11,english,4,141,40,101,56,22,142,58,84,49,24
23,184909,BROCK ISD,11,english,4,173,14,159,123,58,175,19,156,121,67
23,184911,GARNER ISD,11,english,4,25,6,19,11,2,25,8,17,12,4
23,185901,BOVINA ISD,16,english,4,34,11,23,15,6,34,12,22,13,5
23,185902,FARWELL ISD,16,english,4,40,4,36,22,7,40,4,36,32,11
23,185903,FRIONA ISD,16,english,4,82,31,51,22,4,82,56,26,5,0
23,185904,LAZBUDDIE ISD,16,english,4,6,1,5,2,1,6,5,1,1,0
23,186901,BUENA VISTA ISD,18,english,4,21,7,14,7,2,21,8,13,6,3
23,186902,FORT STOCKTON I,18,english,4,138,54,84,36,15,137,63,74,37,16
23,186903,IRAAN-SHEFFIELD,18,english,4,23,6,17,12,7,23,8,15,12,4
23,187901,BIG SANDY ISD,6,english,4,33,5,28,15,5,33,4,29,21,8
23,187903,GOODRICH ISD,6,english,4,19,7,12,6,2,19,8,11,8,2
23,187904,CORRIGAN-CAMDEN,6,english,4,56,12,44,24,4,57,22,35,18,6
23,187906,LEGGETT ISD,6,english,4,15,7,8,4,0,16,10,6,1,0
23,187907,LIVINGSTON ISD,6,english,4,331,90,241,122,44,333,95,238,162,67
23,187910,ONALASKA ISD,6,english,4,96,15,81,45,18,96,37,59,35,8
23,188901,AMARILLO ISD,16,english,4,2077,397,1680,1013,420,2164,540,1624,1122,509
23,188902,RIVER ROAD ISD,16,english,4,83,26,57,32,12,84,33,51,31,9
23,188903,HIGHLAND PARK I,16,english,4,57,11,46,29,12,57,9,48,38,15
23,188904,BUSHLAND ISD,16,english,4,113,11,102,69,30,113,18,95,66,35
23,189901,MARFA ISD,18,english,4,19,6,13,3,0,19,8,11,7,0
23,189902,PRESIDIO ISD,18,english,4,50,19,31,13,2,52,18,34,20,10
23,190903,RAINS ISD,7,english,4,118,31,87,44,9,118,65,53,27,5
23,191901,CANYON ISD,16,english,4,838,97,741,487,206,838,111,727,533,287
23,192901,REAGAN COUNTY I,18,english,4,62,18,44,23,10,62,15,47,28,12
23,193801,BIG SPRINGS CHA,20,english,4,11,6,5,1,0,12,11,1,0,0
23,193902,LEAKEY ISD,20,english,4,18,7,11,4,1,17,13,4,2,0
23,194902,AVERY ISD,8,english,4,25,3,22,16,7,25,1,24,17,9
23,194903,RIVERCREST ISD,8,english,4,46,10,36,18,6,46,10,36,21,7
23,194904,CLARKSVILLE ISD,8,english,4,39,20,19,4,1,39,28,11,2,1
23,194905,DETROIT ISD,8,english,4,38,6,32,15,5,38,22,16,10,3
23,195901,PECOS-BARSTOW-T,18,english,4,193,75,118,41,11,193,108,85,47,11
23,195902,BALMORHEA ISD,18,english,4,5,1,4,2,1,5,2,3,0,0
23,196901,AUSTWELL-TIVOLI,3,english,4,14,4,10,9,4,14,2,12,8,6
23,196902,WOODSBORO ISD,3,english,4,27,8,19,11,4,27,10,17,10,5
23,196903,REFUGIO ISD,3,english,4,47,8,39,20,6,47,25,22,10,3
23,197902,MIAMI ISD,16,english,4,14,2,12,6,2,14,4,10,4,0
23,198901,BREMOND ISD,6,english,4,35,5,30,18,6,35,6,29,10,6
23,198902,CALVERT ISD,6,english,4,8,6,2,1,0,8,8,0,0,0
23,198903,FRANKLIN ISD,6,english,4,94,1,93,74,38,95,3,92,80,44
23,198905,HEARNE ISD,6,english,4,46,24,22,6,0,46,34,12,1,0
23,198906,MUMFORD ISD,6,english,4,42,1,41,26,11,42,2,40,25,7
23,199901,ROCKWALL ISD,10,english,4,1288,194,1094,765,376,1297,282,1015,768,394
23,199902,ROYSE CITY ISD,10,english,4,644,123,521,323,143,644,111,533,381,176
23,200901,BALLINGER ISD,15,english,4,44,14,30,18,5,44,19,25,13,3
23,200902,MILES ISD,15,english,4,31,4,27,21,11,30,6,24,18,10
23,200904,WINTERS ISD,15,english,4,39,9,30,15,5,39,12,27,22,8
23,200906,OLFEN ISD,15,english,4,5,0,5,3,1,5,2,3,1,0
23,201902,HENDERSON ISD,7,english,4,230,83,147,66,27,230,116,114,72,24
23,201903,LANEVILLE ISD,7,english,4,7,2,5,2,0,7,4,3,1,0
23,201904,LEVERETTS CHAPE,7,english,4,12,0,12,9,3,12,3,9,6,1
23,201907,MOUNT ENTERPRIS,7,english,4,38,6,32,23,7,38,5,33,28,18
23,201908,OVERTON ISD,7,english,4,33,4,29,13,3,33,3,30,24,7
23,201910,TATUM ISD,7,english,4,98,23,75,44,16,99,26,73,44,15
23,201913,CARLISLE ISD,7,english,4,41,11,30,16,5,41,6,35,19,4
23,201914,WEST RUSK COUNT,7,english,4,62,11,51,23,6,63,22,41,20,5
23,202903,HEMPHILL ISD,7,english,4,49,10,39,18,5,49,17,32,17,2
23,202905,WEST SABINE ISD,7,english,4,39,11,28,14,5,39,15,24,13,8
23,203901,SAN AUGUSTINE I,7,english,4,40,11,29,10,3,40,18,22,14,4
23,203902,BROADDUS ISD,7,english,4,19,7,12,8,4,19,5,14,6,1
23,204901,COLDSPRING-OAKH,6,english,4,99,38,61,24,7,99,54,45,22,8
23,204904,SHEPHERD ISD,6,english,4,136,54,82,37,13,136,50,86,46,18
23,205901,ARANSAS PASS IS,2,english,4,119,31,88,31,7,118,74,44,20,7
23,205902,GREGORY-PORTLAN,2,english,4,380,68,312,190,90,380,90,290,198,95
23,205903,INGLESIDE ISD,2,english,4,128,15,113,66,33,128,34,94,54,19
23,205904,MATHIS ISD,2,english,4,101,22,79,49,18,101,41,60,32,13
23,205905,ODEM-EDROY ISD,2,english,4,63,17,46,16,6,63,24,39,25,7
23,205906,SINTON ISD,2,english,4,154,40,114,54,25,153,55,98,65,31
23,205907,TAFT ISD,2,english,4,51,20,31,11,1,51,13,38,28,9
23,206901,SAN SABA ISD,15,english,4,51,8,43,24,7,51,10,41,32,17
23,206902,RICHLAND SPRING,15,english,4,5,1,4,2,0,5,2,3,2,0
23,206903,CHEROKEE ISD,15,english,4,6,0,6,6,3,6,0,6,3,2
23,207901,SCHLEICHER ISD,15,english,4,34,5,29,14,6,34,9,25,15,7
23,208901,HERMLEIGH ISD,14,english,4,8,4,4,2,1,8,3,5,2,1
23,208902,SNYDER ISD,14,english,4,144,45,99,49,17,166,58,108,66,30
23,208903,IRA ISD,14,english,4,20,2,18,9,5,20,6,14,4,2
23,209901,ALBANY ISD,14,english,4,37,8,29,23,13,37,9,28,20,10
23,209902,MORAN ISD,14,english,4,9,1,8,4,3,9,3,6,3,0
23,210901,CENTER ISD,7,english,4,193,66,127,67,23,194,81,113,62,20
23,210902,JOAQUIN ISD,7,english,4,48,12,36,21,6,48,13,35,27,13
23,210903,SHELBYVILLE ISD,7,english,4,56,5,51,30,13,56,14,42,23,9
23,210904,TENAHA ISD,7,english,4,28,6,22,10,2,28,7,21,10,6
23,210905,TIMPSON ISD,7,english,4,44,14,30,18,4,44,13,31,17,10
23,210906,EXCELSIOR ISD,7,english,4,5,2,3,2,1,5,3,2,0,0
23,211901,TEXHOMA ISD,16,english,4,17,1,16,15,3,18,3,15,12,7
23,211902,STRATFORD ISD,16,english,4,31,8,23,15,7,31,12,19,14,4
23,212801,CUMBERLAND ACAD,7,english,4,143,42,101,53,20,143,64,79,50,18
23,212804,UT TYLER UNIVER,7,english,4,82,13,69,45,21,82,21,61,40,19
23,212901,ARP ISD,7,english,4,73,16,57,32,11,73,19,54,26,9
23,212902,BULLARD ISD,7,english,4,212,16,196,146,89,213,31,182,154,85
23,212903,LINDALE ISD,7,english,4,322,49,273,177,80,321,51,270,204,118
23,212904,TROUP ISD,7,english,4,70,10,60,49,20,70,16,54,43,24
23,212905,TYLER ISD,7,english,4,1280,335,945,544,250,1318,417,901,631,264
23,212906,WHITEHOUSE ISD,7,english,4,343,32,311,225,124,344,36,308,251,143
23,212909,CHAPEL HILL ISD,7,english,4,206,57,149,89,38,243,70,173,131,69
23,212910,WINONA ISD,7,english,4,62,19,43,17,6,62,24,38,23,8
23,213901,GLEN ROSE ISD,11,english,4,145,18,127,93,42,146,26,120,86,41
23,214901,RIO GRANDE CITY,1,english,4,642,224,418,186,60,643,269,374,209,73
23,214902,SAN ISIDRO ISD,1,english,4,9,0,9,3,1,9,0,9,5,0
23,214903,ROMA ISD,1,english,4,414,30,384,309,178,417,31,386,355,246
23,215901,BRECKENRIDGE IS,14,english,4,86,12,74,44,20,86,18,68,43,14
23,216901,STERLING CITY I,15,english,4,19,4,15,7,4,19,5,14,9,2
23,217901,ASPERMONT ISD,14,english,4,14,2,12,8,6,14,5,9,7,3
23,218901,SONORA ISD,15,english,4,51,3,48,32,10,51,12,39,21,5
23,219901,HAPPY ISD,16,english,4,19,3,16,10,5,19,6,13,12,5
23,219903,TULIA ISD,16,english,4,62,21,41,11,0,63,31,32,18,2
23,219905,KRESS ISD,16,english,4,13,1,12,3,1,13,4,9,3,0
23,220801,TREETOPS SCHOOL,11,english,4,24,2,22,15,8,24,2,22,15,10
23,220802,ARLINGTON CLASS,11,english,4,175,10,165,131,73,175,28,147,109,50
23,220809,FORT WORTH ACAD,11,english,4,61,7,54,45,18,60,17,43,27,14
23,220810,WESTLAKE ACADEM,11,english,4,63,2,61,54,41,63,2,61,52,37
23,220811,EAST FORT WORTH,11,english,4,21,6,15,5,2,21,13,8,5,0
23,220814,TEXAS SCHOOL OF,11,english,4,28,0,28,21,14,28,0,28,26,8
23,220815,CHAPEL HILL ACA,11,english,4,61,25,36,21,11,61,28,33,21,7
23,220817,NEWMAN INTERNAT,11,english,4,195,34,161,78,29,194,89,105,56,24
23,220819,HIGH POINT ACAD,11,english,4,133,33,100,57,18,133,49,84,45,16
23,220901,ARLINGTON ISD,11,english,4,3503,1042,2461,1317,467,3587,1398,2189,1359,554
23,220902,BIRDVILLE ISD,11,english,4,1435,286,1149,725,333,1467,449,1018,641,282
23,220904,EVERMAN ISD,11,english,4,319,95,224,111,42,330,122,208,125,48
23,220905,FORT WORTH ISD,11,english,4,4562,1586,2976,1432,512,4857,2375,2482,1479,591
23,220906,GRAPEVINE-COLLE,11,english,4,858,113,745,544,282,865,166,699,535,289
23,220907,KELLER ISD,11,english,4,2331,336,1995,1378,687,2117,513,1604,1140,550
23,220908,MANSFIELD ISD,11,english,4,2392,370,2022,1307,602,2404,574,1830,1290,629
23,220910,LAKE WORTH ISD,11,english,4,203,110,93,34,5,220,135,85,48,12
23,220912,CROWLEY ISD,11,english,4,951,309,642,346,119,1124,487,637,391,146
23,220914,KENNEDALE ISD,11,english,4,193,62,131,84,39,194,84,110,67,33
23,220915,AZLE ISD,11,english,4,529,78,451,282,116,529,107,422,297,144
23,220916,HURST-EULESS-BE,11,english,4,1615,264,1351,911,455,1621,329,1292,953,491
23,220917,CASTLEBERRY ISD,11,english,4,213,61,152,75,29,256,93,163,88,28
23,220918,EAGLE MT-SAGINA,11,english,4,1679,411,1268,697,257,1702,560,1142,747,309
23,220919,CARROLL ISD,11,english,4,600,12,588,540,392,600,26,574,522,391
23,220920,WHITE SETTLEMEN,11,english,4,440,72,368,225,101,439,126,313,214,108
23,221801,TEXAS COLLEGE P,14,english,4,1373,251,1122,687,245,1381,489,892,531,202
23,221901,ABILENE ISD,14,english,4,1036,305,731,390,151,1041,436,605,349,139
23,221904,MERKEL ISD,14,english,4,83,27,56,28,12,84,32,52,20,10
23,221905,TRENT ISD,14,english,4,10,2,8,6,2,10,5,5,3,0
23,221911,JIM NED CISD,14,english,4,125,3,122,94,44,125,21,104,69,34
23,221912,WYLIE ISD,14,english,4,388,40,348,234,95,389,80,309,204,92
23,222901,TERRELL COUNTY,18,english,4,9,1,8,3,1,9,4,5,3,1
23,223901,BROWNFIELD ISD,17,english,4,91,42,49,19,6,92,42,50,28,11
23,223902,MEADOW ISD,17,english,4,21,9,12,5,3,21,11,10,3,0
23,223904,WELLMAN-UNION C,17,english,4,23,4,19,8,2,23,6,17,7,1
23,224901,THROCKMORTON CO,9,english,4,10,3,7,2,0,10,5,5,1,0
23,224902,WOODSON ISD,9,english,4,9,4,5,2,1,9,6,3,1,0
23,225902,MOUNT PLEASANT,8,english,4,231,41,190,103,37,329,86,243,157,68
23,225906,CHAPEL HILL ISD,8,english,4,77,9,68,46,12,77,26,51,25,6
23,225907,HARTS BLUFF ISD,8,english,4,78,20,58,22,6,79,25,54,35,13
23,226801,TEXAS LEADERSHI,15,english,4,287,103,184,89,24,287,163,124,60,16
23,226901,CHRISTOVAL ISD,15,english,4,37,3,34,22,9,37,6,31,22,6
23,226903,SAN ANGELO ISD,15,english,4,1037,313,724,401,161,1036,424,612,372,128
23,226905,WATER VALLEY IS,15,english,4,16,1,15,10,2,16,0,16,7,4
23,226906,WALL ISD,15,english,4,117,20,97,67,30,117,27,90,68,37
23,226907,GRAPE CREEK ISD,15,english,4,79,21,58,30,14,79,38,41,26,11
23,226908,VERIBEST ISD,15,english,4,14,4,10,6,1,14,3,11,7,2
23,227803,WAYSIDE SCHOOLS,13,english,4,114,46,68,24,8,126,59,67,30,9
23,227804,NYOS CHARTER SC,13,english,4,144,24,120,85,44,143,41,102,75,45
23,227805,TEXAS EMPOWERME,13,english,4,28,9,19,6,2,29,12,17,7,1
23,227806,UNIVERSITY OF T,13,english,4,10,7,3,2,0,10,8,2,0,0
23,227814,CHAPARRAL STAR,13,english,4,28,4,24,21,9,28,4,24,17,10
23,227816,HARMONY PUBLIC,13,english,4,316,77,239,153,84,315,108,207,131,58
23,227817,CEDARS INTERNAT,13,english,4,33,13,20,12,1,32,18,14,7,2
23,227819,UNIVERSITY OF T,13,english,4,45,6,39,24,15,45,14,31,20,13
23,227820,KIPP TEXAS PUBL,4,english,4,2201,729,1472,694,250,2203,1061,1142,635,260
23,227821,AUSTIN DISCOVER,13,english,4,45,5,40,26,12,45,22,23,10,1
23,227824,VALERE PUBLIC S,13,english,4,60,15,45,20,3,60,30,30,14,4
23,227825,AUSTIN ACHIEVE,13,english,4,157,70,87,37,10,155,51,104,53,20
23,227826,MONTESSORI FOR,13,english,4,51,15,36,22,8,52,25,27,10,2
23,227829,VALOR PUBLIC SC,13,english,4,204,30,174,124,68,201,63,138,104,37
23,227901,AUSTIN ISD,13,english,4,4381,811,3570,2557,1522,4806,1404,3402,2445,1288
23,227904,PFLUGERVILLE IS,13,english,4,1537,338,1199,792,374,1684,548,1136,754,378
23,227905,TEXAS SCH FOR T,13,english,4,0,,,,,0,,,,
23,227906,TEXAS SCH FOR T,13,english,4,26,19,7,1,0,26,24,2,0,0
23,227907,MANOR ISD,13,english,4,568,184,384,186,65,581,245,336,186,77
23,227909,EANES ISD,13,english,4,552,15,537,462,286,554,36,518,442,291
23,227910,DEL VALLE ISD,13,english,4,455,163,292,148,56,652,283,369,230,87
23,227912,LAGO VISTA ISD,13,english,4,105,16,89,54,24,104,42,62,35,12
23,227913,LAKE TRAVIS ISD,13,english,4,849,71,778,584,322,866,137,729,570,343
23,228901,GROVETON ISD,6,english,4,50,11,39,22,4,50,15,35,20,6
23,228903,TRINITY ISD,6,english,4,65,25,40,23,9,66,28,38,21,11
23,228904,CENTERVILLE ISD,6,english,4,6,3,3,0,0,6,2,4,2,0
23,228905,APPLE SPRINGS I,6,english,4,22,2,20,12,2,22,10,12,2,0
23,229901,COLMESNEIL ISD,5,english,4,37,8,29,13,5,37,16,21,12,2
23,229903,WOODVILLE ISD,5,english,4,124,39,85,43,9,125,46,79,41,20
23,229904,WARREN ISD,5,english,4,110,23,87,48,20,110,37,73,49,18
23,229905,SPURGER ISD,5,english,4,25,6,19,7,3,25,5,20,13,6
23,229906,CHESTER ISD,5,english,4,8,2,6,2,2,8,2,6,4,3
23,230901,BIG SANDY ISD,7,english,4,44,12,32,18,8,44,12,32,20,6
23,230902,GILMER ISD,7,english,4,192,40,152,83,36,190,55,135,87,42
23,230903,ORE CITY ISD,7,english,4,63,19,44,15,7,63,25,38,18,3
23,230904,UNION HILL ISD,7,english,4,18,3,15,6,3,18,4,14,9,4
23,230905,HARMONY ISD,7,english,4,73,8,65,43,22,74,9,65,48,15
23,230906,NEW DIANA ISD,7,english,4,91,8,83,60,29,91,13,78,58,29
23,230908,UNION GROVE ISD,7,english,4,52,9,43,24,8,52,14,38,23,3
23,231901,MCCAMEY ISD,18,english,4,34,15,19,10,2,34,22,12,6,2
23,231902,RANKIN ISD,18,english,4,22,5,17,11,2,22,11,11,6,2
23,232901,KNIPPA ISD,20,english,4,39,4,35,21,7,39,6,33,24,8
23,232902,SABINAL ISD,20,english,4,25,5,20,13,5,25,3,22,14,7
23,232903,UVALDE CISD,20,english,4,236,74,162,72,20,229,113,116,59,20
23,232904,UTOPIA ISD,20,english,4,16,3,13,4,1,16,8,8,4,1
23,233901,SAN FELIPE-DEL,15,english,4,702,170,532,285,94,699,228,471,279,98
23,233903,COMSTOCK ISD,15,english,4,18,3,15,10,2,18,4,14,11,4
23,234902,CANTON ISD,10,english,4,178,34,144,80,28,178,36,142,94,42
23,234903,EDGEWOOD ISD,7,english,4,71,16,55,28,11,73,35,38,16,8
23,234904,GRAND SALINE IS,7,english,4,95,25,70,40,14,95,24,71,50,29
23,234905,MARTINS MILL IS,7,english,4,39,7,32,19,6,39,17,22,12,4
23,234906,VAN ISD,7,english,4,164,30,134,74,37,164,53,111,74,36
23,234907,WILLS POINT ISD,10,english,4,192,39,153,67,24,192,57,135,84,42
23,234909,FRUITVALE ISD,7,english,4,28,7,21,10,5,28,12,16,8,3
23,235901,BLOOMINGTON ISD,3,english,4,64,21,43,20,7,63,18,45,30,11
23,235902,VICTORIA ISD,3,english,4,877,255,622,326,137,879,352,527,336,139
23,235904,NURSERY ISD,3,english,4,18,2,16,12,2,18,3,15,13,3
23,236802,SAM HOUSTON STA,6,english,4,76,7,69,44,20,76,15,61,35,16
23,236901,NEW WAVERLY ISD,6,english,4,80,14,66,43,19,80,24,56,32,8
23,236902,HUNTSVILLE ISD,6,english,4,1024,322,702,367,134,1028,485,543,320,141
23,237902,HEMPSTEAD ISD,4,english,4,105,51,54,25,10,105,60,45,26,11
23,237904,WALLER ISD,4,english,4,616,192,424,241,101,623,196,427,279,118
23,237905,ROYAL ISD,4,english,4,177,76,101,50,28,179,46,133,86,32
23,238902,MONAHANS-WICKET,18,english,4,148,35,113,54,17,148,51,97,53,11
23,238904,GRANDFALLS-ROYA,18,english,4,11,6,5,1,0,11,7,4,1,0
23,239901,BRENHAM ISD,6,english,4,349,96,253,132,55,346,112,234,136,61
23,239903,BURTON ISD,6,english,4,36,8,28,17,5,37,9,28,22,10
23,240901,LAREDO ISD,1,english,4,1352,309,1043,630,286,1352,318,1034,749,357
23,240903,UNITED ISD,1,english,4,2846,556,2290,1482,774,2848,730,2118,1482,676
23,240904,WEBB CISD,1,english,4,12,5,7,6,1,12,2,10,10,4
23,241901,BOLING ISD,3,english,4,77,24,53,25,9,77,25,52,31,10
23,241902,EAST BERNARD IS,3,english,4,75,10,65,42,17,75,14,61,42,19
23,241903,EL CAMPO ISD,3,english,4,244,80,164,94,41,245,58,187,112,57
23,241904,WHARTON ISD,3,english,4,107,41,66,32,12,107,60,47,31,11
23,241906,LOUISE ISD,3,english,4,36,6,30,12,7,36,11,25,14,9
23,242902,SHAMROCK ISD,16,english,4,22,7,15,6,1,22,12,10,5,1
23,242903,WHEELER ISD,16,english,4,24,4,20,17,8,25,4,21,20,8
23,242905,KELTON ISD,16,english,4,12,2,10,5,1,12,6,6,3,1
23,242906,FORT ELLIOTT CI,16,english,4,9,1,8,2,1,9,2,7,3,1
23,243901,BURKBURNETT ISD,9,english,4,241,74,167,100,40,243,87,156,99,47
23,243902,ELECTRA ISD,9,english,4,40,19,21,6,2,40,22,18,12,3
23,243903,IOWA PARK CISD,9,english,4,137,16,121,83,40,137,26,111,91,44
23,243905,WICHITA FALLS I,9,english,4,941,290,651,334,128,941,394,547,319,122
23,243906,CITY VIEW ISD,9,english,4,70,15,55,24,5,70,18,52,28,10
23,244901,HARROLD ISD,9,english,4,12,0,12,7,5,12,3,9,6,1
23,244903,VERNON ISD,9,english,4,133,53,80,26,6,131,57,74,35,8
23,244905,NORTHSIDE ISD,9,english,4,20,7,13,6,1,20,7,13,9,1
23,245901,LASARA ISD,1,english,4,14,4,10,5,2,14,5,9,5,0
23,245902,LYFORD CISD,1,english,4,84,34,50,25,6,85,28,57,32,9
23,245903,RAYMONDVILLE IS,1,english,4,129,11,118,60,32,130,23,107,75,36
23,245904,SAN PERLITA ISD,1,english,4,14,6,8,6,1,14,3,11,11,3
23,246801,MERIDIAN WORLD,13,english,4,152,4,148,119,76,152,17,135,101,60
23,246802,GOODWATER MONTE,13,english,4,27,10,17,9,4,26,18,8,4,1
23,246902,FLORENCE ISD,13,english,4,83,25,58,34,14,84,28,56,42,14
23,246904,GEORGETOWN ISD,13,english,4,890,228,662,389,151,901,334,567,353,148
23,246905,GRANGER ISD,13,english,4,41,14,27,11,1,41,24,17,6,1
23,246906,HUTTO ISD,13,english,4,688,127,561,339,114,708,226,482,298,117
23,246907,JARRELL ISD,13,english,4,241,80,161,64,23,240,115,125,67,18
23,246908,LIBERTY HILL IS,13,english,4,627,76,551,388,188,627,106,521,396,205
23,246909,ROUND ROCK ISD,13,english,4,3299,436,2863,2157,1306,2827,671,2156,1608,852
23,246911,TAYLOR ISD,13,english,4,210,72,138,73,31,213,106,107,56,20
23,246912,THRALL ISD,13,english,4,56,4,52,32,12,56,15,41,23,10
23,246913,LEANDER ISD,13,english,4,2972,377,2595,1885,974,3006,708,2298,1576,780
23,246914,COUPLAND ISD,13,english,4,33,6,27,12,2,33,11,22,12,4
23,247901,FLORESVILLE ISD,20,english,4,259,61,198,108,45,267,83,184,120,51
23,247903,LA VERNIA ISD,20,english,4,243,35,208,131,54,245,51,194,131,49
23,247904,POTH ISD,20,english,4,66,8,58,39,13,66,12,54,37,12
23,247906,STOCKDALE ISD,20,english,4,58,11,47,33,9,58,18,40,29,11
23,248901,KERMIT ISD,18,english,4,98,39,59,25,6,97,23,74,40,10
23,248902,WINK-LOVING ISD,18,english,4,23,4,19,10,5,23,5,18,12,5
23,249901,ALVORD ISD,11,english,4,47,4,43,25,8,47,8,39,28,10
23,249902,BOYD ISD,11,english,4,91,29,62,31,12,89,33,56,34,16
23,249903,BRIDGEPORT ISD,11,english,4,125,29,96,50,19,147,55,92,49,18
23,249904,CHICO ISD,11,english,4,39,8,31,20,7,39,10,29,15,8
23,249905,DECATUR ISD,11,english,4,269,58,211,116,52,277,106,171,110,41
23,249906,PARADISE ISD,11,english,4,107,17,90,42,16,107,20,87,59,16
23,249908,SLIDELL ISD,11,english,4,41,21,20,11,4,42,27,15,8,3
23,250902,HAWKINS ISD,7,english,4,45,11,34,21,6,45,7,38,35,7
23,250903,MINEOLA ISD,7,english,4,117,20,97,38,14,117,32,85,49,16
23,250904,QUITMAN ISD,7,english,4,89,13,76,49,19,88,19,69,42,18
23,250905,YANTIS ISD,7,english,4,20,4,16,7,2,20,7,13,7,1
23,250906,ALBA-GOLDEN ISD,7,english,4,72,17,55,26,10,72,23,49,28,12
23,250907,WINNSBORO ISD,7,english,4,117,39,78,42,14,115,52,63,37,17
23,251901,DENVER CITY ISD,17,english,4,110,29,81,37,14,110,50,60,28,9
23,251902,PLAINS ISD,17,english,4,31,11,20,11,3,31,6,25,14,3
23,252901,GRAHAM ISD,9,english,4,144,23,121,68,33,144,46,98,63,37
23,252902,NEWCASTLE ISD,9,english,4,14,4,10,7,5,14,6,8,3,2
23,252903,OLNEY ISD,9,english,4,45,11,34,23,13,45,25,20,10,4
23,253901,ZAPATA COUNTY I,1,english,4,217,66,151,78,30,216,58,158,117,51
23,254901,CRYSTAL CITY IS,20,english,4,131,61,70,23,8,131,55,76,32,8
23,254902,LA PRYOR ISD,20,english,4,45,14,31,11,2,45,22,23,12,5
23,1907,PALESTINE ISD,7,spanish,4,0,,,,,0,,,,
23,2901,ANDREWS ISD,18,spanish,4,22,10,12,7,0,9,9,0,0,0
23,3903,LUFKIN ISD,7,spanish,4,0,,,,,0,,,,
23,4901,ARANSAS COUNTY,2,spanish,4,0,,,,,0,,,,
23,7906,POTEET ISD,20,spanish,4,8,4,4,2,1,5,2,3,1,0
23,8902,SEALY ISD,6,spanish,4,9,6,3,2,1,29,10,19,11,5
23,10902,BANDERA ISD,20,spanish,4,0,,,,,0,,,,
23,11901,BASTROP ISD,13,spanish,4,16,12,4,1,1,17,14,3,1,0
23,11902,ELGIN ISD,13,spanish,4,74,41,33,19,7,9,8,1,0,0
23,13901,BEEVILLE ISD,2,spanish,4,0,,,,,0,,,,
23,14902,BARTLETT ISD,13,spanish,4,0,,,,,0,,,,
23,14903,BELTON ISD,12,spanish,4,31,22,9,6,4,5,4,1,1,0
23,14906,KILLEEN ISD,12,spanish,4,15,11,4,1,1,15,12,3,0,0
23,14909,TEMPLE ISD,12,spanish,4,13,10,3,2,1,7,4,3,1,1
23,15802,GEORGE GERVIN A,20,spanish,4,12,8,4,3,0,12,7,5,0,0
23,15822,JUBILEE ACADEMI,20,spanish,4,20,11,9,5,3,20,9,11,3,1
23,15825,LIGHTHOUSE PUBL,20,spanish,4,0,,,,,0,,,,
23,15827,SCHOOL OF SCIEN,20,spanish,4,0,,,,,0,,,,
23,15828,HARMONY PUBLIC,20,spanish,4,14,9,5,2,2,0,,,,
23,15830,BROOKS ACADEMIE,20,spanish,4,7,4,3,3,0,6,5,1,0,0
23,15835,GREAT HEARTS TE,20,spanish,4,0,,,,,0,,,,
23,15838,COMPASS ROSE PU,20,spanish,4,5,4,1,0,0,0,,,,
23,15901,ALAMO HEIGHTS I,20,spanish,4,13,4,9,4,3,11,5,6,3,0
23,15904,HARLANDALE ISD,20,spanish,4,105,50,55,30,14,106,37,69,39,15
23,15905,EDGEWOOD ISD,20,spanish,4,109,72,37,20,5,10,7,3,1,0
23,15907,SAN ANTONIO ISD,20,spanish,4,489,276,213,133,53,460,238,222,106,30
23,15908,SOUTH SAN ANTON,20,spanish,4,92,63,29,16,3,74,36,38,17,1
23,15909,SOMERSET ISD,20,spanish,4,37,14,23,11,4,12,1,11,6,2
23,15910,NORTH EAST ISD,20,spanish,4,505,200,305,210,109,517,192,325,202,74
23,15911,EAST CENTRAL IS,20,spanish,4,64,36,28,12,3,33,23,10,4,1
23,15912,SOUTHWEST ISD,20,spanish,4,41,14,27,17,8,35,14,21,15,3
23,15914,FT SAM HOUSTON,20,spanish,4,0,,,,,0,,,,
23,15915,NORTHSIDE ISD,20,spanish,4,258,124,134,84,31,268,124,144,74,18
23,15916,JUDSON ISD,20,spanish,4,42,19,23,13,1,41,23,18,9,1
23,15917,SOUTHSIDE ISD,20,spanish,4,91,31,60,37,19,9,2,7,3,0
23,18901,CLIFTON ISD,12,spanish,4,0,,,,,0,,,,
23,19907,TEXARKANA ISD,8,spanish,4,27,18,9,6,0,0,,,,
23,19912,PLEASANT GROVE,8,spanish,4,0,,,,,0,,,,
23,20901,ALVIN ISD,4,spanish,4,27,10,17,10,2,16,7,9,3,1
23,20902,ANGLETON ISD,4,spanish,4,0,,,,,0,,,,
23,20905,BRAZOSPORT ISD,4,spanish,4,8,2,6,3,2,7,4,3,3,3
23,20907,COLUMBIA-BRAZOR,4,spanish,4,0,,,,,0,,,,
23,20908,PEARLAND ISD,4,spanish,4,8,3,5,4,2,5,3,2,1,0
23,21901,COLLEGE STATION,6,spanish,4,23,12,11,7,2,21,12,9,4,1
23,21902,BRYAN ISD,6,spanish,4,23,2,21,16,7,23,8,15,9,4
23,22004,TERLINGUA CSD,18,spanish,4,0,,,,,0,,,,
23,22901,ALPINE ISD,18,spanish,4,0,,,,,0,,,,
23,26901,CALDWELL ISD,6,spanish,4,6,5,1,0,0,6,6,0,0,0
23,27903,BURNET CISD,13,spanish,4,0,,,,,0,,,,
23,27904,MARBLE FALLS IS,13,spanish,4,43,23,20,10,5,7,6,1,1,0
23,28902,LOCKHART ISD,13,spanish,4,38,22,16,5,2,31,19,12,4,1
23,31901,BROWNSVILLE ISD,1,spanish,4,101,43,58,34,18,93,49,44,20,3
23,31903,HARLINGEN CISD,1,spanish,4,12,10,2,0,0,9,8,1,0,0
23,31905,LA FERIA ISD,1,spanish,4,5,3,2,1,0,5,3,2,0,0
23,31906,LOS FRESNOS CIS,1,spanish,4,6,2,4,2,2,6,1,5,2,1
23,31909,POINT ISABEL IS,1,spanish,4,10,7,3,1,1,0,,,,
23,31912,SAN BENITO CISD,1,spanish,4,15,11,4,2,0,15,8,7,2,0
23,31914,SANTA ROSA ISD,1,spanish,4,0,,,,,0,,,,
23,35901,DIMMITT ISD,16,spanish,4,0,,,,,0,,,,
23,36902,BARBERS HILL IS,4,spanish,4,0,,,,,0,,,,
23,37904,JACKSONVILLE IS,7,spanish,4,84,28,56,33,17,0,,,,
23,40901,MORTON ISD,17,spanish,4,0,,,,,0,,,,
23,43901,ALLEN ISD,10,spanish,4,17,8,9,7,4,18,9,9,5,3
23,43902,ANNA ISD,10,spanish,4,0,,,,,0,,,,
23,43903,CELINA ISD,10,spanish,4,7,4,3,1,0,0,,,,
23,43904,FARMERSVILLE IS,10,spanish,4,0,,,,,0,,,,
23,43905,FRISCO ISD,10,spanish,4,39,19,20,10,5,24,12,12,5,1
23,43907,MCKINNEY ISD,10,spanish,4,47,29,18,12,4,45,26,19,7,0
23,43910,PLANO ISD,10,spanish,4,291,154,137,75,26,285,158,127,60,17
23,43911,PRINCETON ISD,10,spanish,4,10,8,2,1,1,10,9,1,1,0
23,43912,PROSPER ISD,10,spanish,4,5,2,3,1,0,5,3,2,1,0
23,43914,WYLIE ISD,10,spanish,4,24,5,19,11,4,0,,,,
23,43918,COMMUNITY ISD,10,spanish,4,35,10,25,20,11,0,,,,
23,46901,NEW BRAUNFELS I,20,spanish,4,18,10,8,4,1,15,14,1,0,0
23,46902,COMAL ISD,20,spanish,4,14,8,6,3,1,9,5,4,2,1
23,47901,COMANCHE ISD,14,spanish,4,0,,,,,0,,,,
23,49901,GAINESVILLE ISD,11,spanish,4,18,6,12,8,2,0,,,,
23,49903,VALLEY VIEW ISD,11,spanish,4,9,7,2,1,0,0,,,,
23,50901,EVANT ISD,12,spanish,4,0,,,,,0,,,,
23,50910,COPPERAS COVE I,12,spanish,4,0,,,,,0,,,,
23,52901,CRANE ISD,15,spanish,4,0,,,,,0,,,,
23,57802,PEGASUS SCHOOL,10,spanish,4,0,,,,,0,,,,
23,57807,LIFE SCHOOL,10,spanish,4,0,,,,,0,,,,
23,57808,UNIVERSAL ACADE,10,spanish,4,0,,,,,0,,,,
23,57810,ACADEMY OF DALL,10,spanish,4,0,,,,,0,,,,
23,57835,GOLDEN RULE CHA,10,spanish,4,8,5,3,2,0,5,3,2,0,0
23,57841,CITYSCAPE SCHOO,10,spanish,4,33,12,21,6,0,0,,,,
23,57846,LEGACY PREPARAT,10,spanish,4,0,,,,,0,,,,
23,57848,INTERNATIONAL L,10,spanish,4,63,41,22,12,3,56,45,11,5,1
23,57903,CARROLLTON-FARM,10,spanish,4,322,111,211,130,61,74,55,19,4,0
23,57904,CEDAR HILL ISD,10,spanish,4,0,,,,,0,,,,
23,57905,DALLAS ISD,10,spanish,4,3119,1301,1818,1217,596,335,194,141,50,11
23,57906,DESOTO ISD,10,spanish,4,32,26,6,3,0,19,18,1,0,0
23,57907,DUNCANVILLE ISD,10,spanish,4,110,51,59,41,19,16,10,6,2,0
23,57909,GARLAND ISD,10,spanish,4,627,291,336,217,100,87,47,40,12,1
23,57910,GRAND PRAIRIE I,10,spanish,4,372,165,207,140,54,36,24,12,4,0
23,57912,IRVING ISD,10,spanish,4,194,125,69,32,12,183,127,56,16,5
23,57913,LANCASTER ISD,10,spanish,4,8,3,5,2,0,0,,,,
23,57914,MESQUITE ISD,10,spanish,4,223,120,103,50,18,178,90,88,41,12
23,57916,RICHARDSON ISD,10,spanish,4,173,122,51,24,11,118,82,36,10,3
23,57922,COPPELL ISD,10,spanish,4,9,6,3,2,0,5,4,1,0,0
23,61804,LEADERSHIP PREP,10,spanish,4,0,,,,,0,,,,
23,61805,TRIVIUM ACADEMY,11,spanish,4,0,,,,,0,,,,
23,61901,DENTON ISD,11,spanish,4,121,62,59,30,12,51,32,19,5,0
23,61902,LEWISVILLE ISD,11,spanish,4,153,88,65,38,12,152,94,58,21,1
23,61911,NORTHWEST ISD,11,spanish,4,5,4,1,0,0,0,,,,
23,61912,LAKE DALLAS ISD,11,spanish,4,0,,,,,0,,,,
23,61914,LITTLE ELM ISD,11,spanish,4,36,20,16,9,3,9,9,0,0,0
23,62901,CUERO ISD,3,spanish,4,0,,,,,0,,,,
23,64903,CARRIZO SPRINGS,20,spanish,4,0,,,,,0,,,,
23,67903,EASTLAND ISD,14,spanish,4,0,,,,,0,,,,
23,68901,ECTOR COUNTY IS,18,spanish,4,268,162,106,50,22,240,136,104,39,8
23,70801,WAXAHACHIE FAIT,10,spanish,4,42,31,11,8,0,27,24,3,0,0
23,70903,ENNIS ISD,10,spanish,4,9,4,5,1,0,8,3,5,0,0
23,70905,FERRIS ISD,10,spanish,4,30,20,10,7,2,0,,,,
23,70908,MIDLOTHIAN ISD,10,spanish,4,12,4,8,5,2,0,,,,
23,70911,RED OAK ISD,10,spanish,4,10,4,6,5,2,0,,,,
23,70912,WAXAHACHIE ISD,10,spanish,4,18,12,6,3,0,0,,,,
23,71801,BURNHAM WOOD CH,19,spanish,4,12,6,6,5,2,12,5,7,3,1
23,71806,HARMONY PUBLIC,19,spanish,4,15,5,10,9,6,13,6,7,3,0
23,71807,LA FE PREPARATO,19,spanish,4,14,8,6,3,1,14,7,7,5,0
23,71809,VISTA DEL FUTUR,19,spanish,4,0,,,,,0,,,,
23,71901,CLINT ISD,19,spanish,4,91,50,41,21,10,73,41,32,10,1
23,71902,EL PASO ISD,19,spanish,4,496,204,292,178,68,447,241,206,90,22
23,71903,FABENS ISD,19,spanish,4,44,18,26,19,12,41,18,23,9,3
23,71904,SAN ELIZARIO IS,19,spanish,4,61,44,17,5,0,7,5,2,0,0
23,71905,YSLETA ISD,19,spanish,4,323,118,205,129,64,257,58,199,145,63
23,71906,ANTHONY ISD,19,spanish,4,0,,,,,0,,,,
23,71907,CANUTILLO ISD,19,spanish,4,66,28,38,25,14,63,20,43,17,1
23,71908,TORNILLO ISD,19,spanish,4,22,4,18,10,7,0,,,,
23,71909,SOCORRO ISD,19,spanish,4,78,36,42,20,7,71,40,31,13,4
23,72902,DUBLIN ISD,11,spanish,4,0,,,,,0,,,,
23,72903,STEPHENVILLE IS,11,spanish,4,7,1,6,6,0,0,,,,
23,74907,HONEY GROVE ISD,8,spanish,4,0,,,,,0,,,,
23,75903,SCHULENBURG ISD,13,spanish,4,0,,,,,0,,,,
23,75906,FAYETTEVILLE IS,13,spanish,4,0,,,,,0,,,,
23,79901,LAMAR CISD,4,spanish,4,51,25,26,15,7,24,12,12,2,0
23,79906,NEEDVILLE ISD,4,spanish,4,0,,,,,0,,,,
23,79907,FORT BEND ISD,4,spanish,4,31,14,17,10,2,26,18,8,5,1
23,79910,STAFFORD MSD,4,spanish,4,0,,,,,0,,,,
23,80901,MOUNT VERNON IS,8,spanish,4,0,,,,,0,,,,
23,82903,PEARSALL ISD,20,spanish,4,0,,,,,0,,,,
23,83901,SEAGRAVES ISD,17,spanish,4,0,,,,,0,,,,
23,83903,SEMINOLE ISD,17,spanish,4,9,8,1,0,0,9,6,3,1,0
23,84802,ODYSSEY ACADEMY,4,spanish,4,0,,,,,0,,,,
23,84901,DICKINSON ISD,4,spanish,4,50,30,20,10,3,50,21,29,14,0
23,84902,GALVESTON ISD,4,spanish,4,58,27,31,25,11,39,17,22,10,2
23,84906,TEXAS CITY ISD,4,spanish,4,7,6,1,1,0,0,,,,
23,84909,SANTA FE ISD,4,spanish,4,0,,,,,0,,,,
23,84910,CLEAR CREEK ISD,4,spanish,4,145,53,92,59,23,138,51,87,55,22
23,84911,FRIENDSWOOD ISD,4,spanish,4,0,,,,,0,,,,
23,86901,FREDERICKSBURG,13,spanish,4,5,3,2,0,0,0,,,,
23,89901,GONZALES ISD,13,spanish,4,0,,,,,0,,,,
23,89903,NIXON-SMILEY CI,13,spanish,4,0,,,,,0,,,,
23,89905,WAELDER ISD,13,spanish,4,0,,,,,0,,,,
23,90904,PAMPA ISD,16,spanish,4,0,,,,,0,,,,
23,91903,DENISON ISD,10,spanish,4,17,10,7,3,1,0,,,,
23,91905,HOWE ISD,10,spanish,4,0,,,,,0,,,,
23,91906,SHERMAN ISD,10,spanish,4,17,14,3,1,1,14,12,2,0,0
23,92902,KILGORE ISD,7,spanish,4,0,,,,,0,,,,
23,92903,LONGVIEW ISD,7,spanish,4,61,34,27,18,10,5,4,1,0,0
23,92904,PINE TREE ISD,7,spanish,4,0,,,,,0,,,,
23,93904,NAVASOTA ISD,6,spanish,4,5,5,0,0,0,0,,,,
23,94901,SEGUIN ISD,20,spanish,4,19,10,9,5,2,14,8,6,5,0
23,94902,SCHERTZ-CIBOLO-,20,spanish,4,34,13,21,14,5,9,4,5,2,0
23,94903,NAVARRO ISD,20,spanish,4,0,,,,,0,,,,
23,94904,MARION ISD,20,spanish,4,0,,,,,0,,,,
23,97902,HAMILTON ISD,12,spanish,4,0,,,,,0,,,,
23,99902,CHILLICOTHE ISD,9,spanish,4,0,,,,,0,,,,
23,101802,SER-NINOS CHART,4,spanish,4,53,18,35,23,12,53,24,29,17,6
23,101806,RAUL YZAGUIRRE,4,spanish,4,11,0,11,11,8,0,,,,
23,101814,THE VARNETT PUB,4,spanish,4,10,8,2,2,1,10,7,3,1,0
23,101828,HOUSTON GATEWAY,4,spanish,4,0,,,,,0,,,,
23,101838,SOUTHWEST SCHOO,4,spanish,4,6,4,2,1,1,6,4,2,0,0
23,101845,YES PREP PUBLIC,4,spanish,4,66,15,51,35,17,69,6,63,51,23
23,101853,BAKERRIPLEY COM,4,spanish,4,0,,,,,0,,,,
23,101856,DRAW ACADEMY,4,spanish,4,5,3,2,1,0,5,4,1,0,0
23,101861,THE RHODES SCHO,4,spanish,4,0,,,,,0,,,,
23,101862,HARMONY PUBLIC,4,spanish,4,0,,,,,0,,,,
23,101902,ALDINE ISD,4,spanish,4,396,264,132,61,21,329,218,111,45,8
23,101903,ALIEF ISD,4,spanish,4,382,158,224,139,60,7,5,2,0,0
23,101905,CHANNELVIEW ISD,4,spanish,4,72,34,38,28,8,32,16,16,10,4
23,101906,CROSBY ISD,4,spanish,4,15,7,8,5,3,15,4,11,3,0
23,101907,CYPRESS-FAIRBAN,4,spanish,4,31,25,6,4,1,30,28,2,1,0
23,101908,DEER PARK ISD,4,spanish,4,26,6,20,17,13,26,6,20,14,10
23,101910,GALENA PARK ISD,4,spanish,4,190,84,106,61,26,130,51,79,43,11
23,101911,GOOSE CREEK CIS,4,spanish,4,32,12,20,15,12,33,12,21,11,6
23,101912,HOUSTON ISD,4,spanish,4,1727,967,760,413,125,1635,754,881,455,141
23,101913,HUMBLE ISD,4,spanish,4,84,48,36,17,1,69,38,31,6,0
23,101914,KATY ISD,4,spanish,4,277,97,180,115,42,215,103,112,41,9
23,101915,KLEIN ISD,4,spanish,4,78,32,46,24,9,59,35,24,8,3
23,101916,LA PORTE ISD,4,spanish,4,0,,,,,0,,,,
23,101917,PASADENA ISD,4,spanish,4,164,69,95,66,31,231,83,148,80,31
23,101919,SPRING ISD,4,spanish,4,190,108,82,39,10,141,100,41,19,7
23,101920,SPRING BRANCH I,4,spanish,4,135,72,63,41,16,45,28,17,6,1
23,101921,TOMBALL ISD,4,spanish,4,66,18,48,32,14,14,5,9,5,3
23,101924,SHELDON ISD,4,spanish,4,31,18,13,6,0,27,18,9,2,0
23,101925,HUFFMAN ISD,4,spanish,4,9,6,3,0,0,10,7,3,0,0
23,102902,MARSHALL ISD,7,spanish,4,13,6,7,4,1,6,3,3,1,0
23,105902,SAN MARCOS CISD,13,spanish,4,46,27,19,4,1,15,7,8,2,0
23,105904,DRIPPING SPRING,13,spanish,4,0,,,,,0,,,,
23,105905,WIMBERLEY ISD,13,spanish,4,0,,,,,0,,,,
23,105906,HAYS CISD,13,spanish,4,52,32,20,12,4,26,20,6,3,1
23,107901,ATHENS ISD,10,spanish,4,0,,,,,0,,,,
23,108802,HORIZON MONTESS,1,spanish,4,0,,,,,0,,,,
23,108807,IDEA PUBLIC SCH,1,spanish,4,43,28,15,9,5,42,27,15,5,1
23,108808,VANGUARD ACADEM,1,spanish,4,14,7,7,5,4,10,2,8,4,2
23,108902,DONNA ISD,1,spanish,4,217,144,73,31,12,69,49,20,3,0
23,108903,EDCOUCH-ELSA IS,1,spanish,4,6,6,0,0,0,0,,,,
23,108904,EDINBURG CISD,1,spanish,4,60,39,21,10,4,51,30,21,6,2
23,108905,HIDALGO ISD,1,spanish,4,59,21,38,29,13,22,8,14,13,8
23,108906,MCALLEN ISD,1,spanish,4,99,40,59,44,23,51,28,23,14,2
23,108907,MERCEDES ISD,1,spanish,4,17,10,7,4,1,5,3,2,0,0
23,108908,MISSION CISD,1,spanish,4,186,98,88,61,36,18,8,10,7,2
23,108909,PHARR-SAN JUAN-,1,spanish,4,329,138,191,122,52,45,25,20,11,2
23,108910,PROGRESO ISD,1,spanish,4,27,10,17,10,6,0,,,,
23,108911,SHARYLAND ISD,1,spanish,4,77,21,56,41,28,70,16,54,37,8
23,108912,LA JOYA ISD,1,spanish,4,683,246,437,310,171,21,11,10,4,0
23,108913,WESLACO ISD,1,spanish,4,10,4,6,6,2,7,3,4,1,1
23,108914,LA VILLA ISD,1,spanish,4,0,,,,,0,,,,
23,108916,VALLEY VIEW ISD,1,spanish,4,32,8,24,18,8,27,5,22,11,2
23,109904,HILLSBORO ISD,12,spanish,4,0,,,,,0,,,,
23,109907,ITASCA ISD,12,spanish,4,0,,,,,0,,,,
23,111901,GRANBURY ISD,11,spanish,4,16,6,10,8,2,5,4,1,0,0
23,112901,SULPHUR SPRINGS,8,spanish,4,28,13,15,7,3,0,,,,
23,114901,BIG SPRING ISD,18,spanish,4,0,,,,,0,,,,
23,114904,FORSAN ISD,18,spanish,4,0,,,,,0,,,,
23,115901,FT HANCOCK ISD,19,spanish,4,7,4,3,1,0,0,,,,
23,116905,GREENVILLE ISD,10,spanish,4,28,13,15,7,1,0,,,,
23,116906,LONE OAK ISD,10,spanish,4,0,,,,,0,,,,
23,116908,QUINLAN ISD,10,spanish,4,0,,,,,0,,,,
23,116915,BLAND ISD,10,spanish,4,0,,,,,0,,,,
23,120902,GANADO ISD,3,spanish,4,0,,,,,0,,,,
23,123807,BOB HOPE SCHOOL,5,spanish,4,15,5,10,6,3,13,3,10,5,0
23,123905,NEDERLAND ISD,5,spanish,4,5,2,3,1,0,0,,,,
23,123907,PORT ARTHUR ISD,5,spanish,4,23,15,8,4,0,21,14,7,1,1
23,123908,PORT NECHES-GRO,5,spanish,4,0,,,,,0,,,,
23,123910,BEAUMONT ISD,5,spanish,4,6,2,4,2,1,6,4,2,1,0
23,125901,ALICE ISD,2,spanish,4,0,,,,,0,,,,
23,125903,ORANGE GROVE IS,2,spanish,4,0,,,,,0,,,,
23,125905,PREMONT ISD,2,spanish,4,0,,,,,0,,,,
23,126901,ALVARADO ISD,11,spanish,4,16,15,1,1,1,12,9,3,0,0
23,126902,BURLESON ISD,11,spanish,4,0,,,,,0,,,,
23,126903,CLEBURNE ISD,11,spanish,4,27,8,19,13,3,12,2,10,7,2
23,126905,JOSHUA ISD,11,spanish,4,10,4,6,3,1,0,,,,
23,126906,KEENE ISD,11,spanish,4,0,,,,,0,,,,
23,126907,RIO VISTA ISD,11,spanish,4,0,,,,,0,,,,
23,126908,VENUS ISD,11,spanish,4,0,,,,,0,,,,
23,129901,CRANDALL ISD,10,spanish,4,6,4,2,2,0,0,,,,
23,129902,FORNEY ISD,10,spanish,4,36,16,20,13,7,7,6,1,0,0
23,129903,KAUFMAN ISD,10,spanish,4,0,,,,,0,,,,
23,129904,KEMP ISD,10,spanish,4,5,5,0,0,0,5,4,1,0,0
23,129906,TERRELL ISD,10,spanish,4,0,,,,,0,,,,
23,130901,BOERNE ISD,20,spanish,4,23,14,9,4,1,19,11,8,6,2
23,130902,COMFORT ISD,13,spanish,4,0,,,,,0,,,,
23,133903,KERRVILLE ISD,20,spanish,4,0,,,,,0,,,,
23,137901,KINGSVILLE ISD,2,spanish,4,0,,,,,0,,,,
23,137902,RICARDO ISD,2,spanish,4,0,,,,,0,,,,
23,139909,PARIS ISD,8,spanish,4,7,4,3,1,1,0,,,,
23,142901,COTULLA ISD,20,spanish,4,0,,,,,0,,,,
23,144901,GIDDINGS ISD,13,spanish,4,0,,,,,0,,,,
23,144902,LEXINGTON ISD,13,spanish,4,0,,,,,0,,,,
23,145911,LEON ISD,6,spanish,4,0,,,,,0,,,,
23,146901,CLEVELAND ISD,4,spanish,4,105,80,25,14,5,22,15,7,3,0
23,146902,DAYTON ISD,4,spanish,4,20,11,9,5,0,5,2,3,1,0
23,146904,HARDIN ISD,5,spanish,4,0,,,,,0,,,,
23,146906,LIBERTY ISD,5,spanish,4,0,,,,,0,,,,
23,147902,GROESBECK ISD,12,spanish,4,0,,,,,0,,,,
23,152901,LUBBOCK ISD,17,spanish,4,51,12,39,26,12,30,4,26,14,5
23,152906,LUBBOCK-COOPER,17,spanish,4,16,5,11,5,3,0,,,,
23,152907,FRENSHIP ISD,17,spanish,4,21,6,15,9,0,0,,,,
23,152908,ROOSEVELT ISD,17,spanish,4,0,,,,,0,,,,
23,154901,MADISONVILLE CI,6,spanish,4,5,4,1,0,0,5,5,0,0,0
23,157901,MASON ISD,15,spanish,4,0,,,,,0,,,,
23,159901,EAGLE PASS ISD,20,spanish,4,81,41,40,19,3,72,41,31,16,5
23,161801,WACO CHARTER SC,12,spanish,4,0,,,,,0,,,,
23,161807,HARMONY PUBLIC,12,spanish,4,6,5,1,0,0,5,5,0,0,0
23,161903,MIDWAY ISD,12,spanish,4,0,,,,,0,,,,
23,161906,LA VEGA ISD,12,spanish,4,6,3,3,1,0,5,4,1,0,0
23,161914,WACO ISD,12,spanish,4,8,8,0,0,0,10,8,2,0,0
23,163908,MEDINA VALLEY I,20,spanish,4,0,,,,,0,,,,
23,165901,MIDLAND ISD,18,spanish,4,120,72,48,29,6,129,69,60,27,8
23,165902,GREENWOOD ISD,18,spanish,4,0,,,,,0,,,,
23,166901,CAMERON ISD,6,spanish,4,0,,,,,0,,,,
23,168901,COLORADO ISD,14,spanish,4,0,,,,,0,,,,
23,170902,CONROE ISD,6,spanish,4,323,146,177,111,50,270,112,158,86,27
23,170903,MONTGOMERY ISD,6,spanish,4,0,,,,,0,,,,
23,170904,WILLIS ISD,6,spanish,4,16,12,4,3,0,6,5,1,0,0
23,170906,MAGNOLIA ISD,6,spanish,4,13,4,9,7,2,6,1,5,2,0
23,170907,SPLENDORA ISD,6,spanish,4,0,,,,,0,,,,
23,170908,NEW CANEY ISD,6,spanish,4,57,33,24,11,5,54,32,22,9,0
23,171901,DUMAS ISD,16,spanish,4,5,1,4,0,0,5,4,1,0,0
23,171902,SUNRAY COLLEGIA,16,spanish,4,0,,,,,0,,,,
23,174904,NACOGDOCHES ISD,7,spanish,4,0,,,,,0,,,,
23,175903,CORSICANA ISD,12,spanish,4,21,4,17,12,6,0,,,,
23,175911,RICE ISD,12,spanish,4,0,,,,,0,,,,
23,177901,ROSCOE COLLEGIA,14,spanish,4,0,,,,,0,,,,
23,178902,BISHOP CISD,2,spanish,4,0,,,,,0,,,,
23,178903,CALALLEN ISD,2,spanish,4,0,,,,,0,,,,
23,178904,CORPUS CHRISTI,2,spanish,4,20,13,7,6,2,22,10,12,1,0
23,178909,ROBSTOWN ISD,2,spanish,4,0,,,,,0,,,,
23,178914,FLOUR BLUFF ISD,2,spanish,4,0,,,,,0,,,,
23,181907,VIDOR ISD,5,spanish,4,0,,,,,0,,,,
23,182903,MINERAL WELLS I,11,spanish,4,12,5,7,3,1,5,3,2,1,0
23,184903,WEATHERFORD ISD,11,spanish,4,0,,,,,0,,,,
23,184907,ALEDO ISD,11,spanish,4,0,,,,,0,,,,
23,185902,FARWELL ISD,16,spanish,4,0,,,,,0,,,,
23,187907,LIVINGSTON ISD,6,spanish,4,0,,,,,0,,,,
23,188901,AMARILLO ISD,16,spanish,4,104,33,71,51,22,19,13,6,3,2
23,189902,PRESIDIO ISD,18,spanish,4,7,5,2,2,1,5,4,1,0,0
23,191901,CANYON ISD,16,spanish,4,0,,,,,0,,,,
23,195901,PECOS-BARSTOW-T,18,spanish,4,10,3,7,4,1,10,5,5,0,0
23,196902,WOODSBORO ISD,3,spanish,4,0,,,,,0,,,,
23,198903,FRANKLIN ISD,6,spanish,4,0,,,,,0,,,,
23,199901,ROCKWALL ISD,10,spanish,4,8,4,4,2,2,0,,,,
23,199902,ROYSE CITY ISD,10,spanish,4,0,,,,,0,,,,
23,205901,ARANSAS PASS IS,2,spanish,4,0,,,,,0,,,,
23,205902,GREGORY-PORTLAN,2,spanish,4,7,2,5,3,1,7,1,6,4,1
23,205903,INGLESIDE ISD,2,spanish,4,0,,,,,0,,,,
23,205906,SINTON ISD,2,spanish,4,0,,,,,0,,,,
23,208902,SNYDER ISD,14,spanish,4,24,13,11,8,3,0,,,,
23,211901,TEXHOMA ISD,16,spanish,4,0,,,,,0,,,,
23,211902,STRATFORD ISD,16,spanish,4,0,,,,,0,,,,
23,212905,TYLER ISD,7,spanish,4,42,14,28,22,12,7,4,3,1,0
23,212909,CHAPEL HILL ISD,7,spanish,4,40,19,21,13,5,0,,,,
23,214901,RIO GRANDE CITY,1,spanish,4,9,6,3,2,1,7,3,4,2,0
23,214903,ROMA ISD,1,spanish,4,14,4,10,8,4,11,4,7,7,4
23,220815,CHAPEL HILL ACA,11,spanish,4,0,,,,,0,,,,
23,220901,ARLINGTON ISD,11,spanish,4,246,167,79,42,9,171,120,51,18,3
23,220902,BIRDVILLE ISD,11,spanish,4,121,76,45,27,4,77,59,18,5,0
23,220904,EVERMAN ISD,11,spanish,4,15,8,7,4,2,5,4,1,0,0
23,220905,FORT WORTH ISD,11,spanish,4,404,278,126,55,26,103,81,22,8,1
23,220906,GRAPEVINE-COLLE,11,spanish,4,6,5,1,1,1,5,5,0,0,0
23,220907,KELLER ISD,11,spanish,4,65,23,42,23,15,9,6,3,0,0
23,220908,MANSFIELD ISD,11,spanish,4,47,21,26,20,3,37,18,19,10,2
23,220910,LAKE WORTH ISD,11,spanish,4,17,8,9,4,0,0,,,,
23,220912,CROWLEY ISD,11,spanish,4,109,37,72,49,25,7,3,4,3,0
23,220914,KENNEDALE ISD,11,spanish,4,0,,,,,0,,,,
23,220916,HURST-EULESS-BE,11,spanish,4,30,15,15,7,2,22,11,11,7,4
23,220917,CASTLEBERRY ISD,11,spanish,4,42,15,27,18,7,0,,,,
23,220918,EAGLE MT-SAGINA,11,spanish,4,30,13,17,11,4,6,2,4,2,0
23,220920,WHITE SETTLEMEN,11,spanish,4,44,18,26,21,12,44,17,27,22,10
23,221801,TEXAS COLLEGE P,14,spanish,4,5,4,1,0,0,0,,,,
23,221901,ABILENE ISD,14,spanish,4,14,11,3,2,2,6,5,1,1,0
23,221912,WYLIE ISD,14,spanish,4,0,,,,,0,,,,
23,223901,BROWNFIELD ISD,17,spanish,4,0,,,,,0,,,,
23,225902,MOUNT PLEASANT,8,spanish,4,103,26,77,57,32,0,,,,
23,225907,HARTS BLUFF ISD,8,spanish,4,0,,,,,0,,,,
23,226903,SAN ANGELO ISD,15,spanish,4,0,,,,,0,,,,
23,227803,WAYSIDE SCHOOLS,13,spanish,4,15,3,12,8,3,0,,,,
23,227816,HARMONY PUBLIC,13,spanish,4,8,7,1,1,0,8,8,0,0,0
23,227820,KIPP TEXAS PUBL,4,spanish,4,14,13,1,0,0,11,11,0,0,0
23,227824,VALERE PUBLIC S,13,spanish,4,0,,,,,0,,,,
23,227901,AUSTIN ISD,13,spanish,4,803,483,320,178,64,379,259,120,37,8
23,227904,PFLUGERVILLE IS,13,spanish,4,217,91,126,82,30,59,42,17,13,4
23,227907,MANOR ISD,13,spanish,4,78,60,18,5,1,66,47,19,2,0
23,227910,DEL VALLE ISD,13,spanish,4,256,143,113,66,27,59,39,20,5,1
23,227912,LAGO VISTA ISD,13,spanish,4,0,,,,,0,,,,
23,227913,LAKE TRAVIS ISD,13,spanish,4,22,12,10,5,2,5,4,1,0,0
23,230905,HARMONY ISD,7,spanish,4,0,,,,,0,,,,
23,231901,MCCAMEY ISD,18,spanish,4,0,,,,,0,,,,
23,232903,UVALDE CISD,20,spanish,4,16,8,8,7,5,24,12,12,7,3
23,234906,VAN ISD,7,spanish,4,0,,,,,0,,,,
23,235901,BLOOMINGTON ISD,3,spanish,4,0,,,,,0,,,,
23,235902,VICTORIA ISD,3,spanish,4,23,12,11,4,2,22,12,10,6,3
23,236902,HUNTSVILLE ISD,6,spanish,4,0,,,,,5,5,0,0,0
23,237904,WALLER ISD,4,spanish,4,9,4,5,2,1,9,5,4,1,0
23,237905,ROYAL ISD,4,spanish,4,9,7,2,0,0,8,6,2,0,0
23,238902,MONAHANS-WICKET,18,spanish,4,0,,,,,0,,,,
23,239901,BRENHAM ISD,6,spanish,4,0,,,,,0,,,,
23,240901,LAREDO ISD,1,spanish,4,56,29,27,14,5,54,21,33,15,2
23,240903,UNITED ISD,1,spanish,4,45,14,31,18,9,42,21,21,11,3
23,241902,EAST BERNARD IS,3,spanish,4,0,,,,,0,,,,
23,241903,EL CAMPO ISD,3,spanish,4,0,,,,,0,,,,
23,243905,WICHITA FALLS I,9,spanish,4,16,8,8,5,3,12,6,6,3,0
23,245903,RAYMONDVILLE IS,1,spanish,4,0,,,,,0,,,,
23,246902,FLORENCE ISD,13,spanish,4,0,,,,,0,,,,
23,246904,GEORGETOWN ISD,13,spanish,4,32,19,13,5,2,18,15,3,1,0
23,246906,HUTTO ISD,13,spanish,4,29,12,17,9,4,9,5,4,1,0
23,246907,JARRELL ISD,13,spanish,4,12,10,2,1,0,11,10,1,1,1
23,246908,LIBERTY HILL IS,13,spanish,4,0,,,,,0,,,,
23,246909,ROUND ROCK ISD,13,spanish,4,119,73,46,23,5,81,62,19,4,0
23,246911,TAYLOR ISD,13,spanish,4,9,5,4,4,4,0,,,,
23,246913,LEANDER ISD,13,spanish,4,61,30,31,16,7,23,18,5,2,0
23,247901,FLORESVILLE ISD,20,spanish,4,11,7,4,1,0,0,,,,
23,247903,LA VERNIA ISD,20,spanish,4,0,,,,,0,,,,
23,248901,KERMIT ISD,18,spanish,4,5,3,2,1,0,5,5,0,0,0
23,249903,BRIDGEPORT ISD,11,spanish,4,22,17,5,3,1,0,,,,
23,249905,DECATUR ISD,11,spanish,4,10,9,1,0,0,0,,,,
23,250903,MINEOLA ISD,7,spanish,4,0,,,,,0,,,,
23,251901,DENVER CITY ISD,17,spanish,4,0,,,,,5,2,3,1,0
23,1902,CAYUGA ISD,7,english,5,35,4,31,23,11,35,2,33,21,9
23,1903,ELKHART ISD,7,english,5,105,18,87,58,28,107,11,96,52,20
23,1904,FRANKSTON ISD,7,english,5,45,6,39,36,22,45,0,45,36,20
23,1906,NECHES ISD,7,english,5,23,1,22,15,3,23,4,19,11,3
23,1907,PALESTINE ISD,7,english,5,208,61,147,68,20,204,40,164,79,21
23,1908,WESTWOOD ISD,7,english,5,84,32,52,26,8,84,29,55,22,8
23,1909,SLOCUM ISD,7,english,5,30,6,24,18,11,30,5,25,16,8
23,2901,ANDREWS ISD,18,english,5,291,52,239,144,64,295,71,224,125,35
23,3801,PINEYWOODS COMM,7,english,5,83,17,66,46,29,83,28,55,24,10
23,3902,HUDSON ISD,7,english,5,209,49,160,101,37,208,26,182,113,35
23,3903,LUFKIN ISD,7,english,5,518,126,392,271,124,518,141,377,202,66
23,3904,HUNTINGTON ISD,7,english,5,107,18,89,48,16,107,23,84,37,8
23,3905,DIBOLL ISD,7,english,5,109,16,93,66,31,109,13,96,56,20
23,3906,ZAVALLA ISD,7,english,5,18,3,15,12,2,18,2,16,10,2
23,3907,CENTRAL ISD,7,english,5,103,22,81,50,21,103,20,83,38,8
23,4901,ARANSAS COUNTY,2,english,5,222,77,145,103,45,222,89,133,66,22
23,5901,ARCHER CITY ISD,9,english,5,31,2,29,25,7,31,2,29,27,10
23,5902,HOLLIDAY ISD,9,english,5,83,12,71,55,30,83,1,82,69,43
23,5904,WINDTHORST ISD,9,english,5,39,4,35,29,20,39,1,38,28,13
23,6902,CLAUDE ISD,16,english,5,23,0,23,19,11,23,2,21,16,7
23,7901,CHARLOTTE ISD,20,english,5,26,5,21,8,2,26,6,20,6,3
23,7902,JOURDANTON ISD,20,english,5,119,27,92,48,10,120,28,92,51,16
23,7904,LYTLE ISD,20,english,5,136,47,89,52,14,137,57,80,31,10
23,7905,PLEASANTON ISD,20,english,5,224,65,159,103,45,224,73,151,87,33
23,7906,POTEET ISD,20,english,5,117,32,85,43,16,118,34,84,41,9
23,8901,BELLVILLE ISD,6,english,5,167,38,129,85,39,167,23,144,79,29
23,8902,SEALY ISD,6,english,5,223,47,176,121,62,222,32,190,126,46
23,8903,BRAZOS ISD,6,english,5,47,8,39,28,10,47,9,38,20,7
23,9901,MULESHOE ISD,17,english,5,94,27,67,39,18,94,33,61,29,7
23,10901,MEDINA ISD,20,english,5,13,2,11,8,6,13,1,12,8,2
23,10902,BANDERA ISD,20,english,5,165,39,126,70,26,166,42,124,77,27
23,11901,BASTROP ISD,13,english,5,783,310,473,242,76,780,308,472,224,78
23,11902,ELGIN ISD,13,english,5,320,132,188,83,24,331,183,148,40,5
23,11904,SMITHVILLE ISD,13,english,5,140,34,106,68,38,139,37,102,63,22
23,11905,MCDADE ISD,13,english,5,25,8,17,6,2,25,5,20,11,2
23,12901,SEYMOUR ISD,9,english,5,47,9,38,33,19,47,6,41,26,6
23,13801,ST MARY'S ACADE,2,english,5,43,8,35,22,9,43,8,35,19,4
23,13901,BEEVILLE ISD,2,english,5,171,35,136,88,35,172,41,131,73,24
23,13902,PAWNEE ISD,2,english,5,10,4,6,3,2,10,3,7,3,1
23,13903,PETTUS ISD,2,english,5,26,7,19,8,6,26,10,16,9,3
23,13905,SKIDMORE-TYNAN,2,english,5,67,9,58,41,21,67,7,60,29,7
23,14803,PRIORITY CHARTE,12,english,5,50,18,32,14,5,50,23,27,15,2
23,14804,ORENDA CHARTER,12,english,5,147,7,140,102,43,152,21,131,92,32
23,14901,ACADEMY ISD,12,english,5,129,15,114,80,42,129,16,113,71,22
23,14902,BARTLETT ISD,13,english,5,25,13,12,7,1,25,10,15,4,0
23,14903,BELTON ISD,12,english,5,964,166,798,575,307,963,178,785,500,232
23,14905,HOLLAND ISD,12,english,5,54,10,44,37,20,54,5,49,34,15
23,14906,KILLEEN ISD,12,english,5,3114,627,2487,1597,677,3100,745,2355,1314,448
23,14907,ROGERS ISD,12,english,5,73,23,50,29,3,74,11,63,27,14
23,14908,SALADO ISD,12,english,5,158,22,136,94,36,157,19,138,88,37
23,14909,TEMPLE ISD,12,english,5,588,159,429,265,101,591,152,439,231,78
23,14910,TROY ISD,12,english,5,144,41,103,60,24,144,16,128,83,28
23,15802,GEORGE GERVIN A,20,english,5,22,12,10,2,0,22,11,11,2,0
23,15806,LEGACY TRADITIO,20,english,5,109,19,90,53,14,106,36,70,38,12
23,15807,SOUTHWEST PREPA,20,english,5,52,16,36,19,6,52,16,36,12,5
23,15808,INSPIRE ACADEMI,20,english,5,38,9,29,25,14,38,5,33,17,5
23,15809,BEXAR COUNTY AC,20,english,5,21,11,10,4,0,21,8,13,2,1
23,15815,HERITAGE ACADEM,20,english,5,46,10,36,22,9,46,9,37,22,8
23,15822,JUBILEE ACADEMI,20,english,5,517,196,321,175,62,516,211,305,149,56
23,15825,LIGHTHOUSE PUBL,20,english,5,19,12,7,5,2,19,12,7,1,0
23,15827,SCHOOL OF SCIEN,20,english,5,331,56,275,196,118,334,51,283,190,85
23,15828,HARMONY PUBLIC,20,english,5,295,62,233,157,64,304,88,216,125,42
23,15830,BROOKS ACADEMIE,20,english,5,223,49,174,97,36,222,87,135,52,15
23,15831,SCHOOL OF SCIEN,20,english,5,534,68,466,353,175,532,109,423,248,105
23,15834,BASIS TEXAS,20,english,5,484,16,468,403,284,480,41,439,350,189
23,15835,GREAT HEARTS TE,20,english,5,994,104,890,674,382,994,154,840,582,281
23,15836,ELEANOR KOLITZ,20,english,5,52,4,48,44,32,52,8,44,31,8
23,15838,COMPASS ROSE PU,20,english,5,285,112,173,82,25,285,132,153,54,7
23,15840,SAN ANTONIO PRE,20,english,5,16,10,6,3,0,15,8,7,1,0
23,15842,ROYAL PUBLIC SC,20,english,5,7,3,4,4,3,7,2,5,2,0
23,15844,ESSENCE PREPARA,20,english,5,13,4,9,3,0,13,8,5,1,0
23,15901,ALAMO HEIGHTS I,20,english,5,327,24,303,250,126,332,23,309,243,141
23,15904,HARLANDALE ISD,20,english,5,734,199,535,305,105,740,190,550,269,65
23,15905,EDGEWOOD ISD,20,english,5,561,250,311,150,33,575,250,325,135,31
23,15906,RANDOLPH FIELD,20,english,5,117,6,111,87,54,117,5,112,90,49
23,15907,SAN ANTONIO ISD,20,english,5,2577,857,1720,1037,420,2598,938,1660,817,255
23,15908,SOUTH SAN ANTON,20,english,5,478,192,286,165,58,491,187,304,133,37
23,15909,SOMERSET ISD,20,english,5,254,43,211,162,77,273,50,223,138,45
23,15910,NORTH EAST ISD,20,english,5,3711,562,3149,2312,1246,3709,656,3053,2073,948
23,15911,EAST CENTRAL IS,20,english,5,667,177,490,295,105,694,221,473,243,77
23,15912,SOUTHWEST ISD,20,english,5,924,184,740,480,216,925,232,693,383,126
23,15913,LACKLAND ISD,20,english,5,92,14,78,46,13,91,17,74,42,17
23,15914,FT SAM HOUSTON,20,english,5,125,8,117,97,62,121,12,109,81,39
23,15915,NORTHSIDE ISD,20,english,5,6910,1361,5549,3816,1728,6920,1318,5602,3490,1467
23,15916,JUDSON ISD,20,english,5,1708,380,1328,807,340,1711,531,1180,595,200
23,15917,SOUTHSIDE ISD,20,english,5,308,81,227,150,61,381,50,331,208,75
23,16901,JOHNSON CITY IS,13,english,5,47,9,38,28,9,47,5,42,26,8
23,16902,BLANCO ISD,13,english,5,74,8,66,48,24,74,11,63,26,8
23,17901,BORDEN COUNTY I,17,english,5,8,0,8,5,4,8,0,8,7,3
23,18901,CLIFTON ISD,12,english,5,70,9,61,39,15,70,14,56,29,5
23,18902,MERIDIAN ISD,12,english,5,26,6,20,11,6,26,8,18,10,5
23,18903,MORGAN ISD,12,english,5,13,4,9,2,1,13,3,10,3,0
23,18904,VALLEY MILLS IS,12,english,5,41,11,30,19,5,41,2,39,26,9
23,18905,WALNUT SPRINGS,12,english,5,12,6,6,0,0,12,9,3,1,0
23,18906,IREDELL ISD,12,english,5,10,0,10,7,2,10,0,10,6,4
23,18907,KOPPERL ISD,12,english,5,18,7,11,7,4,18,7,11,5,1
23,18908,CRANFILLS GAP I,12,english,5,7,1,6,3,2,7,2,5,3,1
23,19901,DEKALB ISD,8,english,5,51,8,43,26,19,52,7,45,25,10
23,19902,HOOKS ISD,8,english,5,67,11,56,36,16,67,12,55,27,6
23,19903,MAUD ISD,8,english,5,33,5,28,22,10,33,8,25,21,9
23,19905,NEW BOSTON ISD,8,english,5,74,20,54,30,13,74,20,54,25,5
23,19906,REDWATER ISD,8,english,5,75,15,60,45,24,74,10,64,37,13
23,19907,TEXARKANA ISD,8,english,5,501,120,381,249,119,509,133,376,204,77
23,19908,LIBERTY-EYLAU I,8,english,5,143,50,93,53,16,142,44,98,53,4
23,19909,SIMMS ISD,8,english,5,38,8,30,16,6,38,6,32,15,8
23,19910,MALTA ISD,8,english,5,28,2,26,19,10,28,0,28,15,6
23,19911,RED LICK ISD,8,english,5,69,8,61,48,24,69,15,54,23,2
23,19912,PLEASANT GROVE,8,english,5,161,10,151,126,69,161,6,155,125,64
23,19913,HUBBARD ISD,8,english,5,6,3,3,2,2,6,1,5,3,0
23,19914,LEARY ISD,8,english,5,6,1,5,4,0,6,2,4,2,0
23,20901,ALVIN ISD,4,english,5,2073,321,1752,1289,698,1406,335,1071,484,103
23,20902,ANGLETON ISD,4,english,5,501,62,439,311,140,501,30,471,333,140
23,20904,DANBURY ISD,4,english,5,46,1,45,34,11,45,1,44,24,7
23,20905,BRAZOSPORT ISD,4,english,5,802,195,607,380,195,805,207,598,300,93
23,20906,SWEENY ISD,4,english,5,150,34,116,65,14,150,40,110,43,19
23,20907,COLUMBIA-BRAZOR,4,english,5,228,34,194,136,71,228,26,202,116,47
23,20908,PEARLAND ISD,4,english,5,1551,198,1353,1067,680,1477,189,1288,893,441
23,20910,DAMON ISD,4,english,5,8,4,4,4,0,8,1,7,1,0
23,21803,BRAZOS SCHOOL F,6,english,5,28,6,22,10,5,28,6,22,16,3
23,21805,ARROW ACADEMY,6,english,5,93,26,67,44,9,93,35,58,24,2
23,21901,COLLEGE STATION,6,english,5,957,152,805,608,345,907,151,756,540,257
23,21902,BRYAN ISD,6,english,5,1020,290,730,446,190,1023,263,760,428,188
23,22004,TERLINGUA CSD,18,english,5,10,7,3,2,0,10,8,2,1,0
23,22901,ALPINE ISD,18,english,5,63,14,49,30,5,62,32,30,10,4
23,22902,MARATHON ISD,18,english,5,0,,,,,0,,,,
23,23902,SILVERTON ISD,16,english,5,19,6,13,7,3,19,4,15,8,4
23,24901,BROOKS COUNTY I,1,english,5,100,43,57,25,10,98,40,58,23,6
23,25901,BANGS ISD,15,english,5,70,6,64,44,19,72,11,61,31,9
23,25902,BROWNWOOD ISD,15,english,5,230,48,182,135,72,230,30,200,123,37
23,25904,BLANKET ISD,15,english,5,9,3,6,4,0,9,6,3,1,0
23,25905,MAY ISD,15,english,5,20,6,14,6,4,20,4,16,7,1
23,25906,ZEPHYR ISD,15,english,5,20,4,16,9,3,20,3,17,11,2
23,25908,BROOKESMITH ISD,15,english,5,15,8,7,4,1,15,6,9,4,1
23,25909,EARLY ISD,15,english,5,87,8,79,63,29,87,8,79,51,22
23,26901,CALDWELL ISD,6,english,5,124,11,113,76,29,124,12,112,69,28
23,26902,SOMERVILLE ISD,6,english,5,37,16,21,12,2,37,9,28,13,3
23,26903,SNOOK ISD,6,english,5,39,10,29,18,8,39,9,30,23,9
23,27903,BURNET CISD,13,english,5,221,52,169,87,36,221,58,163,80,23
23,27904,MARBLE FALLS IS,13,english,5,275,47,228,131,69,283,67,216,115,53
23,28902,LOCKHART ISD,13,english,5,442,97,345,226,85,446,86,360,226,77
23,28903,LULING ISD,13,english,5,96,33,63,48,20,96,26,70,45,18
23,28906,PRAIRIE LEA ISD,13,english,5,16,10,6,2,0,16,10,6,0,0
23,29901,CALHOUN COUNTY,3,english,5,253,30,223,162,88,252,35,217,138,51
23,30901,CROSS PLAINS IS,14,english,5,26,1,25,22,11,26,0,26,17,7
23,30902,CLYDE CISD,14,english,5,99,20,79,52,24,99,15,84,42,12
23,30903,BAIRD ISD,14,english,5,17,4,13,8,4,17,2,15,6,2
23,30906,EULA ISD,14,english,5,35,5,30,18,13,35,3,32,21,9
23,31901,BROWNSVILLE ISD,1,english,5,2434,415,2019,1414,694,2437,265,2172,1501,525
23,31903,HARLINGEN CISD,1,english,5,1171,225,946,659,306,1172,247,925,549,188
23,31905,LA FERIA ISD,1,english,5,193,64,129,61,12,192,83,109,40,12
23,31906,LOS FRESNOS CIS,1,english,5,765,108,657,523,305,766,68,698,511,249
23,31909,POINT ISABEL IS,1,english,5,147,18,129,71,25,147,17,130,71,15
23,31911,RIO HONDO ISD,1,english,5,113,33,80,47,20,113,35,78,41,10
23,31912,SAN BENITO CISD,1,english,5,631,184,447,281,121,636,147,489,276,109
23,31913,SANTA MARIA ISD,1,english,5,38,11,27,13,5,37,10,27,15,3
23,31914,SANTA ROSA ISD,1,english,5,72,27,45,25,8,72,20,52,38,11
23,32902,PITTSBURG ISD,8,english,5,137,10,127,107,48,137,2,135,115,35
23,33901,GROOM ISD,16,english,5,11,3,8,4,1,11,2,9,3,2
23,33902,PANHANDLE ISD,16,english,5,47,6,41,33,21,47,6,41,28,15
23,33904,WHITE DEER ISD,16,english,5,14,2,12,9,4,14,0,14,10,4
23,34901,ATLANTA ISD,8,english,5,152,15,137,110,67,152,14,138,89,43
23,34902,AVINGER ISD,8,english,5,10,3,7,5,3,10,4,6,5,1
23,34903,HUGHES SPRINGS,8,english,5,75,9,66,51,29,75,10,65,49,13
23,34905,LINDEN-KILDARE,8,english,5,48,17,31,25,8,48,10,38,18,3
23,34906,MCLEOD ISD,8,english,5,32,2,30,21,11,32,0,32,27,11
23,34907,QUEEN CITY ISD,8,english,5,53,16,37,27,14,54,16,38,22,7
23,34909,BLOOMBURG ISD,8,english,5,20,5,15,12,4,20,3,17,8,4
23,35901,DIMMITT ISD,16,english,5,73,18,55,37,17,73,34,39,17,5
23,35902,HART ISD,16,english,5,12,2,10,8,2,12,3,9,4,1
23,35903,NAZARETH ISD,16,english,5,19,1,18,15,13,19,2,17,15,7
23,36901,ANAHUAC ISD,4,english,5,111,31,80,50,25,110,22,88,55,11
23,36902,BARBERS HILL IS,4,english,5,504,28,476,383,234,504,23,481,384,183
23,36903,EAST CHAMBERS I,5,english,5,115,15,100,78,45,117,16,101,67,30
23,37901,ALTO ISD,7,english,5,37,12,25,14,6,38,7,31,16,5
23,37904,JACKSONVILLE IS,7,english,5,290,95,195,110,39,310,108,202,76,16
23,37907,RUSK ISD,7,english,5,167,38,129,87,37,167,34,133,70,21
23,37908,NEW SUMMERFIELD,7,english,5,45,9,36,25,12,45,7,38,20,8
23,37909,WELLS ISD,7,english,5,20,1,19,13,6,20,1,19,15,9
23,38901,CHILDRESS ISD,16,english,5,73,10,63,45,20,73,11,62,44,11
23,39902,HENRIETTA ISD,9,english,5,74,14,60,46,26,75,18,57,28,9
23,39903,PETROLIA CISD,9,english,5,30,14,16,8,2,30,14,16,6,1
23,39904,BELLEVUE ISD,9,english,5,12,3,9,5,1,12,1,11,5,0
23,39905,MIDWAY ISD,9,english,5,11,2,9,5,3,11,1,10,4,1
23,40901,MORTON ISD,17,english,5,23,10,13,4,2,22,8,14,6,2
23,40902,WHITEFACE CISD,17,english,5,24,4,20,9,5,24,5,19,13,3
23,41901,BRONTE ISD,15,english,5,21,4,17,7,4,22,9,13,6,0
23,41902,ROBERT LEE ISD,15,english,5,20,4,16,7,2,20,11,9,5,1
23,42901,COLEMAN ISD,15,english,5,65,16,49,23,11,64,14,50,20,6
23,42903,SANTA ANNA ISD,15,english,5,20,3,17,11,4,20,7,13,6,0
23,42905,PANTHER CREEK C,15,english,5,9,4,5,3,1,9,2,7,2,0
23,43801,IMAGINE INTERNA,10,english,5,123,7,116,105,70,124,6,118,104,62
23,43802,LONE STAR LANGU,10,english,5,21,1,20,18,11,21,2,19,17,9
23,43901,ALLEN ISD,10,english,5,1641,126,1515,1252,819,1641,126,1515,1224,736
23,43902,ANNA ISD,10,english,5,377,72,305,208,91,379,77,302,186,61
23,43903,CELINA ISD,10,english,5,300,15,285,216,133,303,28,275,200,93
23,43904,FARMERSVILLE IS,10,english,5,146,20,126,93,43,145,26,119,62,20
23,43905,FRISCO ISD,10,english,5,4964,380,4584,3956,2762,4975,367,4608,3777,2385
23,43907,MCKINNEY ISD,10,english,5,1542,164,1378,1063,590,1555,230,1325,943,475
23,43908,MELISSA ISD,10,english,5,461,35,426,359,250,461,41,420,316,190
23,43910,PLANO ISD,10,english,5,3296,397,2899,2310,1395,3301,398,2903,2215,1322
23,43911,PRINCETON ISD,10,english,5,626,121,505,360,185,625,113,512,326,118
23,43912,PROSPER ISD,10,english,5,1997,139,1858,1511,875,1995,150,1845,1449,765
23,43914,WYLIE ISD,10,english,5,1448,155,1293,1039,667,1447,128,1319,1021,566
23,43917,BLUE RIDGE ISD,10,english,5,78,24,54,31,13,78,19,59,35,7
23,43918,COMMUNITY ISD,10,english,5,280,55,225,145,54,321,78,243,126,30
23,43919,LOVEJOY ISD,10,english,5,315,11,304,267,171,263,8,255,227,148
23,44902,WELLINGTON ISD,16,english,5,44,11,33,23,5,44,6,38,23,5
23,45902,COLUMBUS ISD,4,english,5,81,16,65,44,23,81,23,58,24,8
23,45903,RICE CISD,3,english,5,88,12,76,53,28,89,8,81,64,27
23,45905,WEIMAR ISD,3,english,5,52,11,41,31,11,52,4,48,29,7
23,46802,TRINITY CHARTER,20,english,5,10,6,4,2,1,10,8,2,1,0
23,46901,NEW BRAUNFELS I,20,english,5,694,92,602,448,220,698,93,605,397,166
23,46902,COMAL ISD,20,english,5,2144,208,1936,1528,904,2155,231,1924,1422,766
23,47901,COMANCHE ISD,14,english,5,95,17,78,49,20,95,15,80,58,26
23,47902,DE LEON ISD,14,english,5,43,1,42,37,19,43,1,42,37,13
23,47903,GUSTINE ISD,14,english,5,9,1,8,4,1,9,1,8,6,2
23,47905,SIDNEY ISD,14,english,5,10,1,9,3,2,10,3,7,2,1
23,48901,EDEN CISD,15,english,5,15,3,12,5,1,15,4,11,5,2
23,48903,PAINT ROCK ISD,15,english,5,16,1,15,10,2,16,4,12,4,1
23,49901,GAINESVILLE ISD,11,english,5,201,90,111,49,11,200,93,107,47,10
23,49902,MUENSTER ISD,11,english,5,39,1,38,30,16,39,1,38,28,13
23,49903,VALLEY VIEW ISD,11,english,5,59,24,35,21,5,59,21,38,14,4
23,49905,CALLISBURG ISD,11,english,5,91,29,62,34,8,90,18,72,35,15
23,49906,ERA ISD,11,english,5,38,0,38,28,11,38,1,37,31,15
23,49907,LINDSAY ISD,11,english,5,50,3,47,34,16,50,9,41,17,6
23,49908,WALNUT BEND ISD,11,english,5,0,,,,,0,,,,
23,49909,SIVELLS BEND IS,11,english,5,0,,,,,0,,,,
23,50901,EVANT ISD,12,english,5,12,3,9,8,3,12,5,7,3,1
23,50902,GATESVILLE ISD,12,english,5,187,42,145,94,42,187,46,141,72,23
23,50904,OGLESBY ISD,12,english,5,17,2,15,11,4,17,8,9,5,1
23,50909,JONESBORO ISD,12,english,5,22,14,8,6,2,22,14,8,2,0
23,50910,COPPERAS COVE I,12,english,5,549,89,460,319,162,548,81,467,301,110
23,51901,PADUCAH ISD,17,english,5,7,3,4,3,1,8,1,7,3,1
23,52901,CRANE ISD,15,english,5,73,25,48,30,8,73,22,51,29,11
23,53001,CROCKETT COUNTY,15,english,5,42,5,37,20,7,43,4,39,16,4
23,54901,CROSBYTON CISD,17,english,5,17,6,11,4,0,17,11,6,0,0
23,54902,LORENZO ISD,17,english,5,12,3,9,4,0,12,6,6,3,0
23,54903,RALLS ISD,17,english,5,30,12,18,8,1,30,13,17,7,2
23,55901,CULBERSON COUNT,18,english,5,19,1,18,12,2,19,8,11,4,1
23,56901,DALHART ISD,16,english,5,113,38,75,43,15,113,33,80,38,18
23,56902,TEXLINE ISD,16,english,5,20,1,19,15,7,20,1,19,15,3
23,57802,PEGASUS SCHOOL,10,english,5,34,11,23,9,3,35,19,16,6,1
23,57803,UPLIFT EDUCATIO,10,english,5,1750,454,1296,796,342,1750,532,1218,621,212
23,57806,ADVANTAGE ACADE,10,english,5,58,26,32,12,1,58,36,22,9,1
23,57807,LIFE SCHOOL,10,english,5,426,138,288,128,37,424,143,281,122,28
23,57808,UNIVERSAL ACADE,10,english,5,161,11,150,123,80,160,17,143,107,68
23,57810,ACADEMY OF DALL,10,english,5,21,14,7,3,2,20,10,10,2,0
23,57813,TRINITY BASIN P,10,english,5,414,120,294,165,74,414,160,254,119,29
23,57816,A W BROWN LEADE,10,english,5,62,13,49,32,17,62,26,36,13,3
23,57819,JEAN MASSIEU AC,10,english,5,12,4,8,4,2,12,4,8,2,0
23,57827,NOVA ACADEMY SO,10,english,5,46,13,33,22,13,46,14,32,11,3
23,57829,A+ ACADEMY,10,english,5,105,45,60,24,11,105,44,61,28,7
23,57830,INSPIRED VISION,10,english,5,75,33,42,17,2,75,37,38,17,2
23,57831,GATEWAY CHARTER,10,english,5,24,12,12,4,0,24,13,11,5,1
23,57833,EDUCATION CENTE,10,english,5,28,8,20,10,5,28,5,23,15,2
23,57835,GOLDEN RULE CHA,10,english,5,107,24,83,44,19,108,32,76,36,16
23,57836,ST ANTHONY SCHO,10,english,5,42,10,32,21,9,41,11,30,20,6
23,57839,LA ACADEMIA DE,10,english,5,88,18,70,28,8,88,15,73,40,10
23,57841,CITYSCAPE SCHOO,10,english,5,83,35,48,28,3,98,32,66,38,6
23,57844,MANARA ACADEMY,10,english,5,54,20,34,16,5,54,24,30,18,4
23,57845,UME PREPARATORY,10,english,5,132,11,121,96,50,132,22,110,71,31
23,57846,LEGACY PREPARAT,10,english,5,106,52,54,25,11,106,45,61,27,5
23,57847,VILLAGE TECH SC,10,english,5,101,14,87,68,30,101,23,78,36,12
23,57848,INTERNATIONAL L,10,english,5,1900,560,1340,757,235,1895,738,1157,562,196
23,57850,PIONEER TECHNOL,10,english,5,181,33,148,105,37,181,41,140,74,16
23,57851,BRIDGEWAY PREPA,10,english,5,6,2,4,0,0,6,2,4,1,0
23,57903,CARROLLTON-FARM,10,english,5,1496,229,1267,913,519,1593,287,1306,875,394
23,57904,CEDAR HILL ISD,10,english,5,421,90,331,213,104,425,123,302,162,45
23,57905,DALLAS ISD,10,english,5,6555,1461,5094,3438,1714,9286,1856,7430,4679,1768
23,57906,DESOTO ISD,10,english,5,380,106,274,174,65,387,92,295,171,49
23,57907,DUNCANVILLE ISD,10,english,5,666,209,457,225,79,680,231,449,220,79
23,57909,GARLAND ISD,10,english,5,3132,571,2561,1815,940,3587,710,2877,1817,798
23,57910,GRAND PRAIRIE I,10,english,5,1531,306,1225,823,390,1776,442,1334,780,297
23,57911,HIGHLAND PARK I,10,english,5,465,12,453,397,275,375,14,361,298,154
23,57912,IRVING ISD,10,english,5,2007,604,1403,780,273,2022,611,1411,709,211
23,57913,LANCASTER ISD,10,english,5,425,95,330,184,76,431,90,341,179,49
23,57914,MESQUITE ISD,10,english,5,2464,629,1835,1139,469,2513,534,1979,1127,375
23,57916,RICHARDSON ISD,10,english,5,2595,573,2022,1476,839,2612,456,2156,1483,687
23,57919,SUNNYVALE ISD,10,english,5,161,11,150,129,76,162,14,148,115,57
23,57922,COPPELL ISD,10,english,5,990,55,935,828,620,987,50,937,791,546
23,58902,DAWSON ISD,17,english,5,10,1,9,4,0,10,5,5,0,0
23,58905,KLONDIKE ISD,17,english,5,19,1,18,15,6,19,3,16,7,3
23,58906,LAMESA ISD,17,english,5,121,39,82,36,12,121,46,75,22,4
23,58909,SANDS CISD,17,english,5,26,4,22,15,7,26,2,24,14,4
23,59901,HEREFORD ISD,16,english,5,225,54,171,91,34,225,38,187,121,32
23,59902,WALCOTT ISD,16,english,5,19,0,19,12,7,19,1,18,16,1
23,60902,COOPER ISD,8,english,5,62,23,39,28,14,62,15,47,23,6
23,60914,FANNINDEL ISD,8,english,5,11,7,4,2,0,11,5,6,1,0
23,61802,NORTH TEXAS COL,11,english,5,47,14,33,18,12,47,10,37,19,7
23,61804,LEADERSHIP PREP,10,english,5,148,17,131,101,55,148,18,130,81,39
23,61805,TRIVIUM ACADEMY,11,english,5,67,2,65,56,36,67,2,65,57,32
23,61901,DENTON ISD,11,english,5,2238,437,1801,1266,680,2266,508,1758,1098,449
23,61902,LEWISVILLE ISD,11,english,5,3232,467,2765,2141,1286,3227,530,2697,1900,988
23,61903,PILOT POINT ISD,11,english,5,119,22,97,58,30,119,25,94,45,16
23,61905,KRUM ISD,11,english,5,180,22,158,115,55,179,18,161,111,46
23,61906,PONDER ISD,11,english,5,104,25,79,48,16,104,23,81,41,12
23,61907,AUBREY ISD,11,english,5,269,41,228,160,73,269,56,213,110,39
23,61908,SANGER ISD,11,english,5,186,20,166,123,63,187,18,169,104,39
23,61910,ARGYLE ISD,11,english,5,386,20,366,320,197,388,20,368,312,170
23,61911,NORTHWEST ISD,11,english,5,2318,267,2051,1550,912,2297,409,1888,1234,598
23,61912,LAKE DALLAS ISD,11,english,5,280,55,225,156,59,280,72,208,118,40
23,61914,LITTLE ELM ISD,11,english,5,597,111,486,326,140,612,166,446,269,123
23,62901,CUERO ISD,3,english,5,129,36,93,56,23,129,37,92,52,23
23,62902,NORDHEIM ISD,3,english,5,9,0,9,5,1,9,2,7,5,0
23,62903,YOAKUM ISD,3,english,5,101,18,83,52,21,101,3,98,65,19
23,62904,YORKTOWN ISD,3,english,5,45,11,34,21,12,44,7,37,20,9
23,62905,WESTHOFF ISD,3,english,5,8,0,8,8,6,8,0,8,7,4
23,62906,MEYERSVILLE ISD,3,english,5,11,3,8,7,2,11,2,9,7,1
23,63903,SPUR ISD,17,english,5,14,1,13,11,8,14,1,13,10,5
23,63906,PATTON SPRINGS,17,english,5,0,,,,,0,,,,
23,64903,CARRIZO SPRINGS,20,english,5,147,50,97,64,24,147,35,112,69,25
23,65901,CLARENDON ISD,16,english,5,29,8,21,16,8,29,6,23,10,5
23,65902,HEDLEY ISD,16,english,5,8,0,8,3,2,8,0,8,5,1
23,66005,RAMIREZ CSD,2,english,5,0,,,,,0,,,,
23,66901,BENAVIDES ISD,2,english,5,13,2,11,6,2,13,2,11,6,2
23,66902,SAN DIEGO ISD,2,english,5,117,46,71,38,17,116,33,83,45,15
23,66903,FREER ISD,2,english,5,49,13,36,22,6,49,6,43,32,9
23,67902,CISCO ISD,14,english,5,47,9,38,30,18,47,5,42,24,9
23,67903,EASTLAND ISD,14,english,5,61,11,50,38,19,62,4,58,46,17
23,67904,GORMAN ISD,14,english,5,12,2,10,5,2,12,2,10,6,1
23,67907,RANGER ISD,14,english,5,22,11,11,6,3,22,3,19,6,1
23,67908,RISING STAR ISD,14,english,5,11,4,7,4,2,11,3,8,3,2
23,68802,COMPASS ACADEMY,18,english,5,119,16,103,67,23,119,19,100,53,17
23,68901,ECTOR COUNTY IS,18,english,5,2333,613,1720,998,402,2370,548,1822,1033,352
23,69901,ROCKSPRINGS ISD,15,english,5,17,8,9,3,1,17,5,12,5,1
23,69902,NUECES CANYON C,15,english,5,22,0,22,15,4,22,11,11,3,0
23,70801,WAXAHACHIE FAIT,10,english,5,163,82,81,28,8,168,72,96,36,5
23,70901,AVALON ISD,10,english,5,32,11,21,12,3,32,9,23,7,1
23,70903,ENNIS ISD,10,english,5,433,82,351,197,84,431,80,351,197,66
23,70905,FERRIS ISD,10,english,5,158,37,121,68,22,173,28,145,88,22
23,70907,ITALY ISD,10,english,5,38,10,28,13,5,38,5,33,18,9
23,70908,MIDLOTHIAN ISD,10,english,5,807,107,700,497,262,807,104,703,478,221
23,70909,MILFORD ISD,10,english,5,18,8,10,6,2,18,9,9,3,0
23,70910,PALMER ISD,10,english,5,115,19,96,73,33,115,18,97,57,18
23,70911,RED OAK ISD,10,english,5,467,80,387,264,132,469,75,394,252,86
23,70912,WAXAHACHIE ISD,10,english,5,762,150,612,382,161,770,161,609,346,118
23,70915,MAYPEARL ISD,10,english,5,80,10,70,46,19,80,21,59,28,10
23,71801,BURNHAM WOOD CH,19,english,5,71,4,67,51,27,71,5,66,47,10
23,71806,HARMONY PUBLIC,19,english,5,379,59,320,235,120,384,66,318,197,64
23,71807,LA FE PREPARATO,19,english,5,10,0,10,9,3,10,0,10,9,5
23,71809,VISTA DEL FUTUR,19,english,5,38,3,35,31,13,38,3,35,22,7
23,71901,CLINT ISD,19,english,5,689,205,484,281,119,692,177,515,280,81
23,71902,EL PASO ISD,19,english,5,2980,470,2510,1779,893,3041,546,2495,1484,557
23,71903,FABENS ISD,19,english,5,90,16,74,59,27,97,9,88,50,16
23,71904,SAN ELIZARIO IS,19,english,5,173,49,124,71,27,192,39,153,81,17
23,71905,YSLETA ISD,19,english,5,2344,366,1978,1357,614,2379,257,2122,1414,530
23,71906,ANTHONY ISD,19,english,5,53,8,45,26,8,53,11,42,23,2
23,71907,CANUTILLO ISD,19,english,5,386,56,330,241,125,399,60,339,220,95
23,71908,TORNILLO ISD,19,english,5,46,11,35,24,9,57,7,50,33,9
23,71909,SOCORRO ISD,19,english,5,3226,449,2777,2009,1004,3230,452,2778,1774,622
23,72901,THREE WAY ISD,11,english,5,10,1,9,6,0,10,1,9,2,0
23,72902,DUBLIN ISD,11,english,5,82,5,77,58,26,83,9,74,44,11
23,72903,STEPHENVILLE IS,11,english,5,247,36,211,143,81,248,34,214,140,57
23,72904,BLUFF DALE ISD,11,english,5,17,1,16,10,3,17,2,15,7,3
23,72908,HUCKABAY ISD,11,english,5,30,4,26,15,5,30,5,25,17,6
23,72909,LINGLEVILLE ISD,11,english,5,21,4,17,10,3,21,2,19,9,2
23,72910,MORGAN MILL ISD,11,english,5,11,2,9,5,2,11,1,10,5,1
23,73901,CHILTON ISD,12,english,5,42,7,35,21,8,42,6,36,14,4
23,73903,MARLIN ISD,12,english,5,71,28,43,20,5,70,17,53,28,7
23,73904,WESTPHALIA ISD,12,english,5,13,1,12,10,5,13,0,13,12,4
23,73905,ROSEBUD-LOTT IS,12,english,5,56,13,43,26,20,56,16,40,28,16
23,74903,BONHAM ISD,10,english,5,114,23,91,57,20,114,19,95,59,18
23,74904,DODD CITY ISD,10,english,5,19,5,14,9,4,19,7,12,9,4
23,74905,ECTOR ISD,10,english,5,12,3,9,6,2,12,2,10,7,3
23,74907,HONEY GROVE ISD,8,english,5,42,4,38,29,15,42,2,40,27,14
23,74909,LEONARD ISD,10,english,5,57,10,47,26,13,58,8,50,24,5
23,74911,SAVOY ISD,10,english,5,25,2,23,18,6,25,6,19,9,4
23,74912,TRENTON ISD,10,english,5,47,11,36,17,4,47,13,34,16,3
23,74917,SAM RAYBURN ISD,10,english,5,40,3,37,28,16,40,4,36,25,13
23,75901,FLATONIA ISD,13,english,5,32,2,30,25,18,31,1,30,27,11
23,75902,LA GRANGE ISD,13,english,5,130,23,107,79,44,129,40,89,44,10
23,75903,SCHULENBURG ISD,13,english,5,47,10,37,18,4,46,18,28,7,2
23,75906,FAYETTEVILLE IS,13,english,5,14,1,13,12,5,14,2,12,8,3
23,75908,ROUND TOP-CARMI,13,english,5,18,4,14,13,9,18,6,12,11,10
23,76903,ROBY CISD,14,english,5,24,4,20,11,3,24,5,19,8,2
23,76904,ROTAN ISD,14,english,5,21,7,14,9,4,21,7,14,8,1
23,77901,FLOYDADA COLLEG,17,english,5,47,9,38,27,14,47,5,42,29,11
23,77902,LOCKNEY ISD,17,english,5,26,7,19,8,1,26,2,24,10,1
23,78901,CROWELL ISD,9,english,5,21,7,14,10,5,21,2,19,6,2
23,79901,LAMAR CISD,4,english,5,3089,335,2754,2164,1311,3103,322,2781,1936,906
23,79906,NEEDVILLE ISD,4,english,5,240,27,213,168,99,241,10,231,164,66
23,79907,FORT BEND ISD,4,english,5,5821,829,4992,3816,2177,5832,1020,4812,3306,1680
23,79910,STAFFORD MSD,4,english,5,234,62,172,95,51,238,90,148,80,39
23,80901,MOUNT VERNON IS,8,english,5,120,25,95,63,25,119,13,106,62,19
23,81902,FAIRFIELD ISD,12,english,5,125,20,105,65,32,125,18,107,69,16
23,81904,TEAGUE ISD,12,english,5,82,11,71,56,27,82,11,71,42,11
23,81905,WORTHAM ISD,12,english,5,44,11,33,19,8,44,11,33,18,3
23,81906,DEW ISD,12,english,5,14,2,12,10,2,14,2,12,6,2
23,82902,DILLEY ISD,20,english,5,63,18,45,28,11,63,38,25,12,4
23,82903,PEARSALL ISD,20,english,5,127,47,80,34,14,125,55,70,28,9
23,83901,SEAGRAVES ISD,17,english,5,34,10,24,12,2,34,7,27,12,5
23,83902,LOOP ISD,17,english,5,13,1,12,9,5,13,1,12,10,3
23,83903,SEMINOLE ISD,17,english,5,196,28,168,127,69,195,11,184,136,69
23,84802,ODYSSEY ACADEMY,4,english,5,116,42,74,30,10,115,60,55,19,5
23,84804,AMBASSADORS PRE,4,english,5,12,0,12,6,3,12,2,10,6,4
23,84901,DICKINSON ISD,4,english,5,873,216,657,399,128,871,209,662,360,101
23,84902,GALVESTON ISD,4,english,5,346,121,225,134,57,348,124,224,115,45
23,84903,HIGH ISLAND ISD,5,english,5,11,3,8,4,1,11,1,10,2,0
23,84906,TEXAS CITY ISD,4,english,5,559,159,400,239,94,561,147,414,228,65
23,84908,HITCHCOCK ISD,4,english,5,120,41,79,45,21,121,47,74,36,11
23,84909,SANTA FE ISD,4,english,5,324,52,272,182,80,323,42,281,195,73
23,84910,CLEAR CREEK ISD,4,english,5,2794,340,2454,1897,1054,2806,371,2435,1771,881
23,84911,FRIENDSWOOD ISD,4,english,5,491,24,467,386,230,492,21,471,390,236
23,85902,POST ISD,17,english,5,49,20,29,18,3,49,19,30,7,1
23,85903,SOUTHLAND ISD,17,english,5,11,3,8,6,3,11,1,10,7,2
23,86024,DOSS CONSOLIDAT,13,english,5,0,,,,,0,,,,
23,86901,FREDERICKSBURG,13,english,5,200,48,152,95,44,201,59,142,88,41
23,86902,HARPER ISD,15,english,5,43,4,39,24,13,43,5,38,20,6
23,87901,GLASSCOCK COUNT,18,english,5,27,0,27,26,16,27,0,27,22,12
23,88902,GOLIAD ISD,3,english,5,80,23,57,41,18,80,13,67,37,19
23,89901,GONZALES ISD,13,english,5,180,54,126,81,39,181,42,139,76,37
23,89903,NIXON-SMILEY CI,13,english,5,71,17,54,37,14,71,19,52,31,10
23,89905,WAELDER ISD,13,english,5,23,11,12,4,1,23,8,15,6,1
23,90902,LEFORS ISD,16,english,5,12,0,12,5,2,12,1,11,6,3
23,90903,MCLEAN ISD,16,english,5,15,4,11,3,0,15,5,10,1,0
23,90904,PAMPA ISD,16,english,5,241,61,180,99,39,244,55,189,109,28
23,90905,GRANDVIEW-HOPKI,16,english,5,6,0,6,4,2,6,1,5,3,1
23,91901,BELLS ISD,10,english,5,62,11,51,35,12,61,3,58,46,15
23,91902,COLLINSVILLE IS,10,english,5,42,10,32,20,5,42,4,38,22,3
23,91903,DENISON ISD,10,english,5,356,77,279,182,95,359,62,297,167,62
23,91905,HOWE ISD,10,english,5,86,12,74,46,23,85,12,73,50,18
23,91906,SHERMAN ISD,10,english,5,558,131,427,258,107,560,184,376,185,63
23,91907,TIOGA ISD,10,english,5,42,1,41,27,10,42,3,39,20,6
23,91908,VAN ALSTYNE ISD,10,english,5,175,19,156,125,65,175,16,159,103,42
23,91909,WHITESBORO ISD,10,english,5,120,24,96,63,22,120,19,101,54,19
23,91910,WHITEWRIGHT ISD,10,english,5,62,16,46,25,12,62,12,50,29,9
23,91913,POTTSBORO ISD,10,english,5,111,16,95,72,36,111,9,102,77,34
23,91914,S AND S CISD,10,english,5,65,20,45,24,8,65,29,36,21,7
23,91917,GUNTER ISD,10,english,5,93,11,82,65,34,93,11,82,56,24
23,91918,TOM BEAN ISD,10,english,5,48,4,44,24,6,47,4,43,31,8
23,92901,GLADEWATER ISD,7,english,5,127,46,81,40,9,128,38,90,36,14
23,92902,KILGORE ISD,7,english,5,290,81,209,119,53,297,103,194,110,41
23,92903,LONGVIEW ISD,7,english,5,548,106,442,310,156,580,104,476,326,157
23,92904,PINE TREE ISD,7,english,5,350,71,279,198,92,352,67,285,157,55
23,92906,SABINE ISD,7,english,5,126,31,95,58,22,126,15,111,58,26
23,92907,SPRING HILL ISD,7,english,5,148,21,127,105,69,148,14,134,105,51
23,92908,WHITE OAK ISD,7,english,5,118,9,109,81,42,118,16,102,64,21
23,93901,ANDERSON-SHIRO,6,english,5,76,12,64,50,22,76,5,71,50,19
23,93903,IOLA ISD,6,english,5,37,3,34,28,11,38,8,30,25,11
23,93904,NAVASOTA ISD,6,english,5,195,49,146,82,25,197,51,146,73,14
23,93905,RICHARDS ISD,6,english,5,18,9,9,2,1,18,9,9,4,1
23,94901,SEGUIN ISD,20,english,5,503,130,373,247,114,507,156,351,191,67
23,94902,SCHERTZ-CIBOLO-,20,english,5,1066,224,842,514,194,1073,215,858,477,179
23,94903,NAVARRO ISD,20,english,5,182,40,142,101,54,183,37,146,83,33
23,94904,MARION ISD,20,english,5,112,16,96,73,44,112,11,101,65,18
23,95901,ABERNATHY ISD,17,english,5,53,5,48,32,14,53,7,46,34,12
23,95902,COTTON CENTER I,17,english,5,8,0,8,6,4,8,1,7,7,4
23,95903,HALE CENTER ISD,17,english,5,40,9,31,18,5,40,14,26,7,0
23,95904,PETERSBURG ISD,17,english,5,24,3,21,15,8,24,0,24,14,3
23,95905,PLAINVIEW ISD,17,english,5,322,127,195,103,30,325,102,223,100,22
23,96904,MEMPHIS ISD,16,english,5,33,9,24,18,6,33,3,30,20,9
23,96905,TURKEY-QUITAQUE,16,english,5,11,1,10,9,5,11,0,11,6,2
23,97902,HAMILTON ISD,12,english,5,70,10,60,43,27,70,8,62,38,14
23,97903,HICO ISD,12,english,5,50,3,47,30,9,51,2,49,32,11
23,98901,GRUVER ISD,16,english,5,32,2,30,24,12,32,2,30,22,6
23,98903,PRINGLE-MORSE C,16,english,5,8,0,8,5,0,8,1,7,4,0
23,98904,SPEARMAN ISD,16,english,5,56,12,44,29,17,56,11,45,19,10
23,99902,CHILLICOTHE ISD,9,english,5,13,4,9,5,0,13,4,9,5,1
23,99903,QUANAH ISD,9,english,5,27,1,26,20,10,27,2,25,10,3
23,100903,KOUNTZE ISD,5,english,5,79,13,66,43,25,79,24,55,33,11
23,100904,SILSBEE ISD,5,english,5,197,50,147,91,44,197,50,147,85,30
23,100905,HARDIN-JEFFERSO,5,english,5,190,37,153,99,41,190,32,158,80,22
23,100907,LUMBERTON ISD,5,english,5,316,54,262,159,54,316,53,263,163,61
23,100908,WEST HARDIN COU,5,english,5,32,7,25,14,4,31,3,28,19,7
23,101802,SER-NINOS CHART,4,english,5,92,32,60,37,12,93,26,67,32,5
23,101803,ARISTOI CLASSIC,4,english,5,121,8,113,78,38,121,27,94,56,15
23,101806,RAUL YZAGUIRRE,4,english,5,102,15,87,63,29,110,15,95,65,29
23,101810,ACADEMY OF ACCE,4,english,5,72,20,52,29,9,72,26,46,24,9
23,101814,THE VARNETT PUB,4,english,5,91,35,56,30,8,91,34,57,24,7
23,101815,ALIEF MONTESSOR,4,english,5,21,0,21,20,9,21,1,20,11,5
23,101819,AMIGOS POR VIDA,4,english,5,48,4,44,37,18,48,5,43,28,16
23,101828,HOUSTON GATEWAY,4,english,5,149,11,138,113,65,150,9,141,103,47
23,101838,SOUTHWEST SCHOO,4,english,5,117,43,74,44,14,117,19,98,68,27
23,101840,TWO DIMENSIONS,4,english,5,25,8,17,10,6,25,11,14,7,0
23,101842,COMQUEST ACADEM,4,english,5,7,5,2,0,0,7,5,2,0,0
23,101846,HARMONY PUBLIC,4,english,5,190,30,160,102,44,190,32,158,106,35
23,101847,BEATRICE MAYES,4,english,5,60,6,54,25,6,60,23,37,15,4
23,101849,ACCELERATED INT,4,english,5,12,2,10,5,2,12,3,9,6,1
23,101853,BAKERRIPLEY COM,4,english,5,88,45,43,24,5,88,40,48,17,6
23,101855,MEYERPARK ELEME,4,english,5,25,4,21,13,2,25,14,11,6,1
23,101856,DRAW ACADEMY,4,english,5,59,21,38,18,3,59,24,35,15,4
23,101858,HARMONY PUBLIC,4,english,5,600,104,496,346,184,600,112,488,341,154
23,101859,STEP CHARTER SC,4,english,5,70,16,54,35,20,70,19,51,33,10
23,101861,THE RHODES SCHO,4,english,5,61,18,43,25,11,59,18,41,18,5
23,101862,HARMONY PUBLIC,4,english,5,417,40,377,304,194,417,40,377,295,168
23,101868,THE PRO-VISION,4,english,5,19,10,9,2,0,19,17,2,0,0
23,101870,BETA ACADEMY,4,english,5,126,9,117,79,28,126,14,112,55,15
23,101872,ETOILE ACADEMY,4,english,5,77,38,39,20,12,79,39,40,15,4
23,101876,REVE PREPARATOR,4,english,5,22,10,12,5,1,22,14,8,2,0
23,101902,ALDINE ISD,4,english,5,3898,1243,2655,1501,544,3947,1425,2522,1254,386
23,101903,ALIEF ISD,4,english,5,2519,777,1742,1104,493,2681,979,1702,881,350
23,101905,CHANNELVIEW ISD,4,english,5,608,139,469,286,115,643,142,501,292,111
23,101906,CROSBY ISD,4,english,5,480,89,391,253,114,475,79,396,243,90
23,101907,CYPRESS-FAIRBAN,4,english,5,8178,1339,6839,5010,2747,8165,1580,6585,4122,1727
23,101908,DEER PARK ISD,4,english,5,824,161,663,467,238,658,105,553,322,53
23,101910,GALENA PARK ISD,4,english,5,1342,303,1039,658,301,1358,246,1112,691,234
23,101911,GOOSE CREEK CIS,4,english,5,1659,434,1225,784,366,1659,467,1192,670,214
23,101912,HOUSTON ISD,4,english,5,13186,3280,9906,6415,3032,13234,3541,9693,5876,2567
23,101913,HUMBLE ISD,4,english,5,3511,673,2838,1915,872,3505,860,2645,1563,647
23,101914,KATY ISD,4,english,5,6778,692,6086,4908,3041,6810,843,5967,4379,2398
23,101915,KLEIN ISD,4,english,5,3778,525,3253,2337,1212,3790,489,3301,2262,962
23,101916,LA PORTE ISD,4,english,5,502,66,436,325,143,500,21,479,333,128
23,101917,PASADENA ISD,4,english,5,3216,829,2387,1395,546,3187,923,2264,1125,328
23,101919,SPRING ISD,4,english,5,2306,611,1695,968,356,2332,718,1614,860,270
23,101920,SPRING BRANCH I,4,english,5,2192,378,1814,1417,894,2243,353,1890,1367,736
23,101921,TOMBALL ISD,4,english,5,1645,170,1475,1203,732,1671,143,1528,1183,633
23,101924,SHELDON ISD,4,english,5,736,199,537,331,118,737,202,535,311,105
23,101925,HUFFMAN ISD,4,english,5,262,63,199,129,69,258,58,200,121,39
23,102901,KARNACK ISD,7,english,5,11,5,6,4,3,11,3,8,5,3
23,102902,MARSHALL ISD,7,english,5,329,77,252,156,74,327,93,234,146,56
23,102903,WASKOM ISD,7,english,5,54,10,44,23,7,54,14,40,13,4
23,102904,HALLSVILLE ISD,7,english,5,1048,365,683,377,158,1049,493,556,279,115
23,102905,HARLETON ISD,7,english,5,51,5,46,36,21,50,7,43,20,5
23,102906,ELYSIAN FIELDS,7,english,5,62,10,52,37,21,62,7,55,30,9
23,103901,CHANNING ISD,16,english,5,16,6,10,4,0,16,8,8,1,0
23,103902,HARTLEY ISD,16,english,5,17,4,13,12,4,17,5,12,6,1
23,104901,HASKELL CISD,14,english,5,40,4,36,28,12,40,1,39,30,9
23,104903,RULE ISD,14,english,5,8,2,6,3,1,8,2,6,2,0
23,104907,PAINT CREEK ISD,14,english,5,7,2,5,3,2,7,1,6,3,1
23,105802,TEXAS PREPARATO,13,english,5,11,4,7,4,1,10,6,4,1,1
23,105803,KI CHARTER ACAD,13,english,5,26,16,10,4,0,20,15,5,1,0
23,105804,DORAL ACADEMY O,13,english,5,40,9,31,19,7,40,13,27,11,4
23,105902,SAN MARCOS CISD,13,english,5,534,132,402,244,122,550,155,395,209,78
23,105904,DRIPPING SPRING,13,english,5,641,36,605,510,327,619,41,578,468,234
23,105905,WIMBERLEY ISD,13,english,5,182,22,160,123,50,182,31,151,83,28
23,105906,HAYS CISD,13,english,5,1507,239,1268,926,492,1505,264,1241,736,298
23,106901,CANADIAN ISD,16,english,5,55,5,50,38,15,55,3,52,32,11
23,107901,ATHENS ISD,10,english,5,213,42,171,95,39,213,50,163,78,34
23,107902,BROWNSBORO ISD,7,english,5,178,33,145,89,45,178,23,155,91,33
23,107904,CROSS ROADS ISD,7,english,5,29,4,25,17,10,29,3,26,20,10
23,107905,EUSTACE ISD,7,english,5,143,23,120,86,26,143,27,116,65,17
23,107906,MALAKOFF ISD,7,english,5,111,6,105,82,28,111,8,103,70,20
23,107907,TRINIDAD ISD,7,english,5,12,6,6,2,0,12,7,5,1,0
23,107908,MURCHISON ISD,7,english,5,20,6,14,9,5,19,5,14,6,1
23,107910,LAPOYNOR ISD,7,english,5,27,3,24,18,6,27,14,13,4,2
23,108802,HORIZON MONTESS,1,english,5,126,24,102,74,32,125,37,88,50,19
23,108807,IDEA PUBLIC SCH,1,english,5,5077,889,4188,2949,1573,5077,980,4097,2410,758
23,108808,VANGUARD ACADEM,1,english,5,459,72,387,293,151,462,66,396,256,98
23,108809,EXCELLENCE IN L,1,english,5,30,7,23,13,4,30,5,25,12,3
23,108902,DONNA ISD,1,english,5,732,210,522,274,106,841,197,644,319,71
23,108903,EDCOUCH-ELSA IS,1,english,5,292,121,171,79,27,292,146,146,61,15
23,108904,EDINBURG CISD,1,english,5,2171,401,1770,1232,627,2184,331,1853,1227,466
23,108905,HIDALGO ISD,1,english,5,159,14,145,101,54,195,17,178,145,72
23,108906,MCALLEN ISD,1,english,5,1358,201,1157,891,547,1392,194,1198,827,337
23,108907,MERCEDES ISD,1,english,5,270,71,199,137,61,280,58,222,132,26
23,108908,MISSION CISD,1,english,5,851,180,671,446,194,986,205,781,481,170
23,108909,PHARR-SAN JUAN-,1,english,5,1687,332,1355,934,472,1892,397,1495,925,326
23,108910,PROGRESO ISD,1,english,5,83,15,68,39,21,98,7,91,66,23
23,108911,SHARYLAND ISD,1,english,5,644,99,545,423,239,652,96,556,358,143
23,108912,LA JOYA ISD,1,english,5,1121,188,933,672,337,1694,349,1345,852,285
23,108913,WESLACO ISD,1,english,5,1150,225,925,650,294,1151,204,947,585,208
23,108914,LA VILLA ISD,1,english,5,30,9,21,14,5,30,6,24,12,2
23,108915,MONTE ALTO ISD,1,english,5,61,10,51,32,14,61,5,56,39,12
23,108916,VALLEY VIEW ISD,1,english,5,231,18,213,171,97,244,18,226,174,61
23,109901,ABBOTT ISD,12,english,5,14,0,14,11,7,15,2,13,10,6
23,109902,BYNUM ISD,12,english,5,12,2,10,8,5,12,4,8,7,3
23,109903,COVINGTON ISD,12,english,5,22,7,15,9,4,22,4,18,9,3
23,109904,HILLSBORO ISD,12,english,5,133,34,99,66,28,133,41,92,47,12
23,109905,HUBBARD ISD,12,english,5,19,2,17,11,7,19,3,16,11,4
23,109907,ITASCA ISD,12,english,5,50,9,41,21,5,50,15,35,10,2
23,109908,MALONE ISD,12,english,5,10,6,4,3,1,10,4,6,2,0
23,109910,MOUNT CALM ISD,12,english,5,9,4,5,2,0,9,5,4,2,0
23,109911,WHITNEY ISD,12,english,5,108,25,83,50,17,108,18,90,55,17
23,109912,AQUILLA ISD,12,english,5,17,0,17,16,8,17,0,17,17,9
23,109913,BLUM ISD,12,english,5,27,4,23,12,4,27,6,21,10,2
23,109914,PENELOPE ISD,12,english,5,11,2,9,5,0,11,3,8,6,1
23,110901,ANTON ISD,17,english,5,12,4,8,4,1,12,1,11,5,1
23,110902,LEVELLAND ISD,17,english,5,190,70,120,61,28,189,60,129,48,20
23,110905,ROPES ISD,17,english,5,47,7,40,20,11,47,8,39,21,8
23,110906,SMYER ISD,17,english,5,28,3,25,17,8,28,6,22,14,3
23,110907,SUNDOWN ISD,17,english,5,43,5,38,25,14,43,1,42,37,17
23,110908,WHITHARRAL ISD,17,english,5,16,2,14,12,7,16,0,16,12,7
23,111901,GRANBURY ISD,11,english,5,530,86,444,324,161,530,53,477,333,147
23,111902,LIPAN ISD,11,english,5,26,2,24,17,10,26,5,21,12,7
23,111903,TOLAR ISD,11,english,5,42,6,36,24,6,42,6,36,18,6
23,112901,SULPHUR SPRINGS,8,english,5,309,71,238,157,71,307,47,260,177,78
23,112905,CUMBY COLLEGIAT,8,english,5,28,8,20,9,1,28,5,23,10,5
23,112906,NORTH HOPKINS I,8,english,5,38,5,33,24,9,39,4,35,27,10
23,112907,MILLER GROVE IS,8,english,5,19,3,16,13,5,19,3,16,6,2
23,112908,COMO-PICKTON CI,8,english,5,46,5,41,25,9,46,2,44,33,9
23,112909,SALTILLO ISD,8,english,5,16,1,15,11,6,16,0,16,11,3
23,112910,SULPHUR BLUFF I,8,english,5,11,1,10,8,4,11,0,11,6,2
23,113901,CROCKETT ISD,6,english,5,72,31,41,15,5,72,48,24,6,2
23,113902,GRAPELAND ISD,6,english,5,37,12,25,12,5,37,9,28,15,3
23,113903,LOVELADY ISD,6,english,5,36,5,31,24,14,36,3,33,17,6
23,113905,LATEXO ISD,6,english,5,32,4,28,17,6,31,13,18,8,2
23,113906,KENNARD ISD,6,english,5,16,0,16,10,5,16,0,16,12,7
23,114901,BIG SPRING ISD,18,english,5,216,57,159,105,35,214,56,158,85,21
23,114902,COAHOMA ISD,18,english,5,80,15,65,39,15,80,23,57,22,4
23,114904,FORSAN ISD,18,english,5,54,6,48,30,19,54,10,44,22,6
23,115901,FT HANCOCK ISD,19,english,5,18,1,17,14,6,23,5,18,10,3
23,115902,SIERRA BLANCA I,19,english,5,8,1,7,5,1,8,2,6,4,1
23,115903,DELL CITY ISD,19,english,5,0,,,,,0,,,,
23,116901,CADDO MILLS ISD,10,english,5,201,28,173,121,49,202,19,183,123,35
23,116902,CELESTE ISD,10,english,5,35,6,29,19,6,35,8,27,13,7
23,116903,COMMERCE ISD,10,english,5,101,49,52,28,7,101,41,60,25,4
23,116905,GREENVILLE ISD,10,english,5,382,148,234,118,40,392,145,247,106,27
23,116906,LONE OAK ISD,10,english,5,70,5,65,48,28,69,4,65,49,17
23,116908,QUINLAN ISD,10,english,5,180,62,118,60,23,179,33,146,75,30
23,116909,WOLFE CITY ISD,10,english,5,46,13,33,21,10,46,12,34,16,6
23,116910,CAMPBELL ISD,10,english,5,16,7,9,3,2,16,7,9,1,0
23,116915,BLAND ISD,10,english,5,63,7,56,36,18,63,3,60,35,9
23,116916,BOLES ISD,10,english,5,35,7,28,20,6,35,6,29,14,4
23,117901,BORGER ISD,16,english,5,186,47,139,86,25,187,39,148,87,26
23,117903,SANFORD-FRITCH,16,english,5,44,7,37,28,15,44,6,38,19,5
23,117904,PLEMONS-STINNET,16,english,5,47,10,37,21,7,47,7,40,20,7
23,117907,SPRING CREEK IS,16,english,5,15,2,13,8,4,15,8,7,4,1
23,118902,IRION COUNTY IS,15,english,5,23,4,19,18,6,23,2,21,16,6
23,119901,BRYSON ISD,9,english,5,24,2,22,16,8,24,1,23,12,6
23,119902,JACKSBORO ISD,9,english,5,82,18,64,42,19,83,19,64,33,7
23,119903,PERRIN-WHITT CI,9,english,5,25,7,18,12,3,27,2,25,11,1
23,120901,EDNA ISD,3,english,5,94,15,79,50,29,95,2,93,63,26
23,120902,GANADO ISD,3,english,5,48,5,43,28,12,48,3,45,32,14
23,120905,INDUSTRIAL ISD,3,english,5,92,3,89,77,40,92,2,90,80,46
23,121902,BROOKELAND ISD,5,english,5,16,2,14,8,3,16,2,14,3,1
23,121903,BUNA ISD,5,english,5,90,12,78,55,21,92,4,88,52,20
23,121904,JASPER ISD,5,english,5,176,82,94,53,15,175,97,78,28,7
23,121905,KIRBYVILLE CISD,5,english,5,108,26,82,41,8,108,24,84,42,5
23,121906,EVADALE ISD,5,english,5,29,1,28,21,15,29,1,28,21,5
23,122901,FT DAVIS ISD,18,english,5,10,2,8,7,2,10,1,9,7,1
23,122902,VALENTINE ISD,18,english,5,0,,,,,0,,,,
23,123803,TEKOA ACADEMY O,5,english,5,21,7,14,4,2,21,5,16,6,0
23,123805,EHRHART SCHOOL,5,english,5,56,8,48,33,12,56,11,45,29,7
23,123807,BOB HOPE SCHOOL,5,english,5,98,21,77,53,27,100,16,84,52,21
23,123905,NEDERLAND ISD,5,english,5,359,64,295,200,100,358,48,310,211,92
23,123907,PORT ARTHUR ISD,5,english,5,583,156,427,248,99,584,160,424,224,62
23,123908,PORT NECHES-GRO,5,english,5,368,39,329,249,136,369,38,331,213,74
23,123910,BEAUMONT ISD,5,english,5,1084,396,688,374,147,1085,418,667,338,107
23,123913,SABINE PASS ISD,5,english,5,24,1,23,14,6,22,5,17,7,2
23,123914,HAMSHIRE-FANNET,5,english,5,152,19,133,90,39,152,23,129,81,33
23,124901,JIM HOGG COUNTY,1,english,5,85,21,64,34,18,85,5,80,47,15
23,125901,ALICE ISD,2,english,5,315,98,217,125,49,315,133,182,83,19
23,125902,BEN BOLT-PALITO,2,english,5,46,4,42,26,7,46,4,42,26,6
23,125903,ORANGE GROVE IS,2,english,5,105,21,84,54,28,105,23,82,51,22
23,125905,PREMONT ISD,2,english,5,50,18,32,16,3,50,14,36,12,2
23,125906,LA GLORIA ISD,2,english,5,15,2,13,10,6,15,6,9,5,2
23,126901,ALVARADO ISD,11,english,5,258,67,191,108,35,266,60,206,110,33
23,126902,BURLESON ISD,11,english,5,976,129,847,621,332,976,140,836,572,258
23,126903,CLEBURNE ISD,11,english,5,461,98,363,208,66,466,98,368,206,51
23,126904,GRANDVIEW ISD,11,english,5,103,5,98,78,45,103,5,98,71,31
23,126905,JOSHUA ISD,11,english,5,423,67,356,254,94,426,67,359,227,89
23,126906,KEENE ISD,11,english,5,72,14,58,36,14,72,13,59,23,5
23,126907,RIO VISTA ISD,11,english,5,60,12,48,34,8,60,17,43,19,6
23,126908,VENUS ISD,11,english,5,171,44,127,77,29,172,49,123,65,19
23,126911,GODLEY ISD,11,english,5,197,41,156,90,36,197,36,161,99,39
23,127901,ANSON ISD,14,english,5,53,16,37,26,6,54,15,39,18,5
23,127903,HAMLIN COLLEGIA,14,english,5,23,10,13,7,1,23,6,17,10,2
23,127904,HAWLEY ISD,14,english,5,59,13,46,25,10,59,25,34,17,4
23,127905,LUEDERS-AVOCA I,14,english,5,6,2,4,0,0,6,1,5,0,0
23,127906,STAMFORD ISD,14,english,5,41,7,34,15,6,41,3,38,23,6
23,128901,KARNES CITY ISD,20,english,5,194,64,130,52,14,193,99,94,37,10
23,128902,KENEDY ISD,3,english,5,46,6,40,23,12,46,3,43,12,1
23,128903,RUNGE ISD,3,english,5,9,5,4,4,1,10,4,6,2,1
23,128904,FALLS CITY ISD,20,english,5,33,1,32,31,24,33,1,32,29,13
23,129901,CRANDALL ISD,10,english,5,433,86,347,218,82,438,119,319,162,58
23,129902,FORNEY ISD,10,english,5,1144,258,886,655,338,1148,265,883,521,235
23,129903,KAUFMAN ISD,10,english,5,292,60,232,153,78,291,50,241,139,46
23,129904,KEMP ISD,10,english,5,120,27,93,52,20,119,10,109,78,26
23,129905,MABANK ISD,10,english,5,311,92,219,126,49,310,104,206,116,37
23,129906,TERRELL ISD,10,english,5,373,107,266,154,62,373,115,258,126,27
23,129910,SCURRY-ROSSER I,10,english,5,73,10,63,40,16,73,8,65,45,15
23,130801,MEADOWLAND CHAR,20,english,5,0,,,,,0,,,,
23,130901,BOERNE ISD,20,english,5,828,54,774,635,415,833,57,776,616,324
23,130902,COMFORT ISD,13,english,5,84,27,57,39,14,83,17,66,31,10
23,131001,KENEDY COUNTY W,2,english,5,13,1,12,8,3,13,2,11,9,1
23,132902,JAYTON-GIRARD I,17,english,5,11,0,11,11,5,11,0,11,7,2
23,133901,CENTER POINT IS,20,english,5,28,2,26,23,9,28,1,27,23,5
23,133902,HUNT ISD,20,english,5,25,3,22,18,8,25,0,25,14,8
23,133903,KERRVILLE ISD,20,english,5,329,41,288,205,113,332,35,297,195,68
23,133904,INGRAM ISD,20,english,5,62,9,53,39,19,61,3,58,41,12
23,134901,JUNCTION ISD,15,english,5,39,12,27,11,3,39,13,26,10,1
23,135001,GUTHRIE CSD,17,english,5,11,0,11,7,1,11,1,10,7,2
23,136901,BRACKETT ISD,20,english,5,34,7,27,15,10,34,13,21,14,8
23,137901,KINGSVILLE ISD,2,english,5,192,65,127,78,19,193,85,108,45,7
23,137902,RICARDO ISD,2,english,5,68,11,57,37,19,68,13,55,34,14
23,137903,RIVIERA ISD,2,english,5,29,3,26,22,12,29,1,28,19,8
23,137904,SANTA GERTRUDIS,2,english,5,38,2,36,31,23,38,6,32,22,10
23,138902,KNOX CITY-O'BRI,9,english,5,10,3,7,6,2,10,2,8,2,0
23,138903,MUNDAY CISD,9,english,5,26,4,22,20,16,26,1,25,19,9
23,138904,BENJAMIN ISD,9,english,5,16,1,15,10,0,16,2,14,3,1
23,139905,CHISUM ISD,8,english,5,90,8,82,59,36,90,6,84,46,18
23,139909,PARIS ISD,8,english,5,275,93,182,92,35,276,103,173,90,31
23,139911,NORTH LAMAR ISD,8,english,5,177,29,148,91,35,177,17,160,105,42
23,139912,PRAIRILAND ISD,8,english,5,90,13,77,49,23,90,12,78,59,18
23,140901,AMHERST ISD,17,english,5,12,4,8,4,1,12,8,4,2,0
23,140904,LITTLEFIELD ISD,17,english,5,102,19,83,50,21,102,8,94,50,14
23,140905,OLTON ISD,17,english,5,42,10,32,17,2,42,5,37,12,2
23,140907,SPRINGLAKE-EART,17,english,5,23,2,21,13,5,23,0,23,15,4
23,140908,SUDAN ISD,17,english,5,30,10,20,17,8,30,5,25,17,8
23,141901,LAMPASAS ISD,12,english,5,255,29,226,160,84,255,32,223,148,64
23,141902,LOMETA ISD,12,english,5,24,7,17,9,1,24,8,16,5,0
23,142901,COTULLA ISD,20,english,5,85,25,60,32,9,85,24,61,29,11
23,143901,HALLETTSVILLE I,3,english,5,69,12,57,37,15,70,10,60,38,15
23,143902,MOULTON ISD,3,english,5,14,1,13,9,7,13,0,13,13,10
23,143903,SHINER ISD,3,english,5,55,3,52,47,36,55,2,53,38,25
23,143904,VYSEHRAD ISD,3,english,5,8,1,7,5,3,8,0,8,6,4
23,143905,SWEET HOME ISD,3,english,5,19,1,18,12,10,19,2,17,10,4
23,143906,EZZELL ISD,3,english,5,6,0,6,4,3,6,0,6,5,2
23,144901,GIDDINGS ISD,13,english,5,110,29,81,49,15,110,27,83,40,15
23,144902,LEXINGTON ISD,13,english,5,79,17,62,43,19,79,19,60,35,13
23,144903,DIME BOX ISD,13,english,5,7,3,4,4,1,7,2,5,2,0
23,145901,BUFFALO ISD,6,english,5,83,2,81,61,33,83,3,80,53,19
23,145902,CENTERVILLE ISD,6,english,5,54,7,47,29,11,55,11,44,22,7
23,145906,NORMANGEE ISD,6,english,5,51,13,38,24,11,51,10,41,28,10
23,145907,OAKWOOD ISD,6,english,5,17,6,11,5,0,17,5,12,5,1
23,145911,LEON ISD,6,english,5,50,15,35,24,12,50,9,41,25,14
23,146901,CLEVELAND ISD,4,english,5,755,252,503,265,79,770,251,519,238,47
23,146902,DAYTON ISD,4,english,5,420,127,293,176,82,419,137,282,152,47
23,146903,DEVERS ISD,4,english,5,19,2,17,16,10,19,3,16,16,8
23,146904,HARDIN ISD,5,english,5,94,30,64,42,13,92,34,58,28,11
23,146905,HULL-DAISETTA I,5,english,5,32,14,18,7,2,32,7,25,8,1
23,146906,LIBERTY ISD,5,english,5,138,23,115,78,37,139,24,115,66,19
23,146907,TARKINGTON ISD,4,english,5,125,31,94,52,14,125,24,101,71,21
23,147901,COOLIDGE ISD,12,english,5,18,1,17,12,5,18,1,17,8,5
23,147902,GROESBECK ISD,12,english,5,117,30,87,38,18,116,29,87,44,19
23,147903,MEXIA ISD,12,english,5,121,40,81,39,14,121,56,65,22,5
23,148901,BOOKER ISD,16,english,5,21,0,21,20,14,21,0,21,20,7
23,148902,FOLLETT ISD,16,english,5,7,1,6,4,3,7,1,6,3,0
23,148905,DARROUZETT ISD,16,english,5,5,2,3,2,0,5,3,2,1,0
23,149901,GEORGE WEST ISD,2,english,5,83,7,76,56,34,83,8,75,50,19
23,149902,THREE RIVERS IS,2,english,5,29,3,26,13,1,29,5,24,8,2
23,150901,LLANO ISD,13,english,5,130,21,109,61,31,129,12,117,77,30
23,152504,TEXAS TECH UNIV,17,english,5,14,1,13,11,8,16,2,14,8,2
23,152802,RISE ACADEMY,17,english,5,12,1,11,10,5,12,0,12,10,2
23,152806,BETTY M CONDRA,17,english,5,24,6,18,7,0,25,11,14,2,0
23,152901,LUBBOCK ISD,17,english,5,1597,310,1287,870,443,1623,243,1380,890,345
23,152902,NEW DEAL ISD,17,english,5,58,14,44,25,8,58,23,35,14,2
23,152903,SLATON ISD,17,english,5,77,17,60,36,15,77,15,62,34,6
23,152906,LUBBOCK-COOPER,17,english,5,526,60,466,348,193,535,47,488,375,194
23,152907,FRENSHIP ISD,17,english,5,796,99,697,511,259,806,84,722,487,211
23,152908,ROOSEVELT ISD,17,english,5,93,34,59,24,9,94,27,67,34,10
23,152909,SHALLOWATER ISD,17,english,5,126,7,119,89,44,126,2,124,98,50
23,152910,IDALOU ISD,17,english,5,68,15,53,34,12,68,9,59,38,13
23,153903,O'DONNELL ISD,17,english,5,17,0,17,7,4,17,0,17,6,1
23,153904,TAHOKA ISD,17,english,5,48,12,36,24,9,48,3,45,26,12
23,153905,NEW HOME ISD,17,english,5,53,2,51,38,22,53,0,53,48,18
23,153907,WILSON ISD,17,english,5,9,3,6,5,0,9,3,6,3,1
23,154901,MADISONVILLE CI,6,english,5,160,12,148,109,54,161,12,149,98,32
23,154903,NORTH ZULCH ISD,6,english,5,15,0,15,12,5,15,0,15,9,1
23,155901,JEFFERSON ISD,8,english,5,75,32,43,30,11,75,33,42,21,4
23,156902,STANTON ISD,18,english,5,75,14,61,46,22,75,5,70,48,12
23,156905,GRADY ISD,18,english,5,22,0,22,20,11,22,1,21,16,5
23,157901,MASON ISD,15,english,5,61,5,56,41,16,62,7,55,38,15
23,158901,BAY CITY ISD,3,english,5,249,81,168,89,39,249,90,159,59,17
23,158902,TIDEHAVEN ISD,3,english,5,70,8,62,50,31,70,4,66,46,19
23,158904,MATAGORDA ISD,3,english,5,11,5,6,3,1,10,6,4,1,0
23,158905,PALACIOS ISD,3,english,5,86,9,77,50,22,86,12,74,41,12
23,158906,VAN VLECK ISD,3,english,5,92,17,75,51,20,92,31,61,31,9
23,159901,EAGLE PASS ISD,20,english,5,920,183,737,506,226,920,114,806,513,167
23,160901,BRADY ISD,15,english,5,90,26,64,40,21,90,28,62,33,9
23,160904,ROCHELLE ISD,15,english,5,6,0,6,4,2,6,0,6,6,1
23,160905,LOHN ISD,15,english,5,8,3,5,1,0,8,5,3,0,0
23,161801,WACO CHARTER SC,12,english,5,23,4,19,9,2,23,8,15,2,0
23,161802,RAPOPORT ACADEM,12,english,5,64,21,43,23,6,65,39,26,9,3
23,161807,HARMONY PUBLIC,12,english,5,732,136,596,414,189,731,152,579,354,136
23,161901,CRAWFORD ISD,12,english,5,39,2,37,31,19,39,3,36,27,9
23,161903,MIDWAY ISD,12,english,5,644,72,572,478,308,648,53,595,435,221
23,161906,LA VEGA ISD,12,english,5,192,45,147,77,18,190,55,135,56,13
23,161907,LORENA ISD,12,english,5,128,7,121,90,51,127,12,115,86,40
23,161908,MART ISD,12,english,5,50,6,44,28,11,50,8,42,22,8
23,161909,MCGREGOR ISD,12,english,5,100,19,81,59,30,100,17,83,43,8
23,161910,MOODY ISD,12,english,5,46,12,34,20,5,47,11,36,15,5
23,161912,RIESEL ISD,12,english,5,41,4,37,31,18,41,5,36,32,11
23,161914,WACO ISD,12,english,5,982,322,660,359,120,984,385,599,285,84
23,161916,WEST ISD,12,english,5,89,5,84,70,50,89,10,79,69,29
23,161918,AXTELL ISD,12,english,5,51,5,46,38,20,51,3,48,29,4
23,161919,BRUCEVILLE-EDDY,12,english,5,32,4,28,16,4,32,0,32,17,2
23,161920,CHINA SPRING IS,12,english,5,218,37,181,127,60,220,51,169,97,32
23,161921,CONNALLY ISD,12,english,5,185,78,107,48,11,184,84,100,35,11
23,161922,ROBINSON ISD,12,english,5,169,22,147,112,62,168,9,159,109,43
23,161923,BOSQUEVILLE ISD,12,english,5,58,3,55,37,20,58,5,53,25,7
23,161924,HALLSBURG ISD,12,english,5,16,7,9,6,2,16,2,14,6,2
23,161925,GHOLSON ISD,12,english,5,16,6,10,5,1,17,5,12,6,2
23,162904,MCMULLEN COUNTY,2,english,5,20,2,18,14,5,20,0,20,18,11
23,163901,DEVINE ISD,20,english,5,149,33,116,65,23,149,25,124,68,19
23,163902,D'HANIS ISD,20,english,5,13,0,13,12,11,13,0,13,12,4
23,163903,NATALIA ISD,20,english,5,77,23,54,27,6,77,37,40,18,7
23,163904,HONDO ISD,20,english,5,119,22,97,64,26,119,24,95,62,24
23,163908,MEDINA VALLEY I,20,english,5,604,68,536,396,213,605,72,533,356,148
23,164901,MENARD ISD,15,english,5,28,2,26,16,5,29,6,23,10,4
23,165802,MIDLAND ACADEMY,18,english,5,34,2,32,26,10,34,7,27,22,8
23,165901,MIDLAND ISD,18,english,5,1943,482,1461,938,393,1939,502,1437,834,331
23,165902,GREENWOOD ISD,18,english,5,259,52,207,132,57,260,42,218,138,58
23,166901,CAMERON ISD,6,english,5,107,25,82,50,22,107,24,83,41,18
23,166902,GAUSE ISD,6,english,5,17,3,14,8,4,17,6,11,4,1
23,166903,MILANO ISD,6,english,5,24,2,22,17,12,24,1,23,18,11
23,166904,ROCKDALE ISD,6,english,5,116,14,102,64,25,116,23,93,51,15
23,166905,THORNDALE ISD,13,english,5,40,6,34,28,9,40,2,38,31,16
23,166907,BUCKHOLTS ISD,12,english,5,9,7,2,1,1,9,7,2,0,0
23,167901,GOLDTHWAITE ISD,12,english,5,39,1,38,31,17,39,1,38,22,10
23,167902,MULLIN ISD,12,english,5,6,5,1,0,0,6,2,4,1,0
23,167904,PRIDDY ISD,12,english,5,7,3,4,2,0,7,4,3,3,1
23,168901,COLORADO ISD,14,english,5,60,21,39,21,11,60,11,49,23,5
23,168902,LORAINE ISD,14,english,5,5,1,4,1,0,5,0,5,3,0
23,168903,WESTBROOK ISD,14,english,5,13,4,9,5,0,13,4,9,5,3
23,169901,BOWIE ISD,9,english,5,110,19,91,57,23,109,13,96,47,11
23,169902,NOCONA ISD,9,english,5,49,4,45,33,14,49,2,47,30,11
23,169906,GOLD BURG ISD,9,english,5,7,1,6,4,1,6,1,5,2,0
23,169908,MONTAGUE ISD,9,english,5,10,1,9,8,3,10,0,10,10,5
23,169909,PRAIRIE VALLEY,9,english,5,13,2,11,11,7,13,3,10,7,3
23,169910,FORESTBURG ISD,9,english,5,17,5,12,9,2,17,8,9,3,2
23,169911,SAINT JO ISD,9,english,5,26,2,24,16,7,26,3,23,14,4
23,170801,TEXAS SERENITY,4,english,5,25,15,10,2,0,25,22,3,0,0
23,170802,THRIVE CENTER F,6,english,5,8,8,0,0,0,9,8,1,0,0
23,170902,CONROE ISD,6,english,5,4998,709,4289,3288,1928,5011,645,4366,3144,1645
23,170903,MONTGOMERY ISD,6,english,5,719,74,645,494,258,719,67,652,453,218
23,170904,WILLIS ISD,6,english,5,638,128,510,358,160,639,156,483,241,69
23,170906,MAGNOLIA ISD,6,english,5,975,179,796,599,311,969,152,817,527,243
23,170907,SPLENDORA ISD,6,english,5,361,97,264,146,52,361,111,250,108,26
23,170908,NEW CANEY ISD,6,english,5,1280,305,975,623,256,1281,349,932,521,183
23,171901,DUMAS ISD,16,english,5,292,67,225,160,65,292,55,237,125,39
23,171902,SUNRAY COLLEGIA,16,english,5,37,7,30,19,5,37,1,36,18,5
23,172902,DAINGERFIELD-LO,8,english,5,64,19,45,27,8,64,14,50,24,9
23,172905,PEWITT CISD,8,english,5,62,10,52,32,14,62,6,56,31,13
23,173901,MOTLEY COUNTY I,17,english,5,8,1,7,3,1,8,0,8,2,0
23,174801,STEPHEN F AUSTI,7,english,5,38,0,38,34,22,38,0,38,31,20
23,174901,CHIRENO ISD,7,english,5,32,11,21,13,3,32,10,22,9,1
23,174902,CUSHING ISD,7,english,5,44,3,41,28,11,44,4,40,26,11
23,174903,GARRISON ISD,7,english,5,54,4,50,43,25,54,2,52,41,10
23,174904,NACOGDOCHES ISD,7,english,5,375,98,277,168,85,376,124,252,122,44
23,174906,WODEN ISD,7,english,5,67,13,54,37,24,66,10,56,29,9
23,174908,CENTRAL HEIGHTS,7,english,5,61,9,52,36,23,61,6,55,42,27
23,174909,MARTINSVILLE IS,7,english,5,27,1,26,19,8,27,10,17,9,1
23,174911,DOUGLASS ISD,7,english,5,28,3,25,18,9,28,2,26,19,11
23,175902,BLOOMING GROVE,12,english,5,56,13,43,24,8,56,6,50,31,12
23,175903,CORSICANA ISD,12,english,5,414,119,295,165,56,411,108,303,173,58
23,175904,DAWSON ISD,12,english,5,23,2,21,15,8,23,2,21,15,3
23,175905,FROST ISD,12,english,5,33,6,27,16,5,33,8,25,13,2
23,175907,KERENS ISD,12,english,5,43,10,33,20,9,43,8,35,23,9
23,175910,MILDRED ISD,12,english,5,65,10,55,37,19,65,8,57,32,8
23,175911,RICE ISD,12,english,5,78,27,51,29,8,78,7,71,46,17
23,176901,BURKEVILLE ISD,5,english,5,21,6,15,10,2,21,7,14,5,1
23,176902,NEWTON ISD,5,english,5,82,27,55,27,10,82,49,33,12,5
23,176903,DEWEYVILLE ISD,5,english,5,42,4,38,27,12,42,4,38,24,7
23,177901,ROSCOE COLLEGIA,14,english,5,428,166,262,141,37,437,287,150,50,10
23,177902,SWEETWATER ISD,14,english,5,125,41,84,49,17,125,26,99,59,17
23,177903,BLACKWELL CISD,14,english,5,6,0,6,4,2,6,1,5,3,0
23,177905,HIGHLAND ISD,14,english,5,17,1,16,11,8,17,0,17,14,9
23,178801,DR M L GARZA-GO,2,english,5,16,4,12,10,1,16,0,16,5,2
23,178807,CORPUS CHRISTI,2,english,5,13,4,9,5,5,13,7,6,4,2
23,178808,SEASHORE CHARTE,2,english,5,45,9,36,26,13,36,6,30,14,1
23,178901,AGUA DULCE ISD,2,english,5,22,6,16,8,4,22,9,13,5,0
23,178902,BISHOP CISD,2,english,5,99,17,82,58,25,99,14,85,56,22
23,178903,CALALLEN ISD,2,english,5,266,37,229,158,75,266,32,234,154,57
23,178904,CORPUS CHRISTI,2,english,5,2227,432,1795,1234,573,2246,398,1848,1175,442
23,178905,DRISCOLL ISD,2,english,5,33,2,31,25,12,33,3,30,19,8
23,178906,LONDON ISD,2,english,5,119,8,111,97,45,118,7,111,86,35
23,178908,PORT ARANSAS IS,2,english,5,30,4,26,19,9,30,1,29,18,6
23,178909,ROBSTOWN ISD,2,english,5,157,53,104,61,19,156,76,80,34,12
23,178912,TULOSO-MIDWAY I,2,english,5,291,33,258,178,79,291,44,247,144,58
23,178913,BANQUETE ISD,2,english,5,62,7,55,31,15,62,12,50,28,7
23,178914,FLOUR BLUFF ISD,2,english,5,392,45,347,269,147,393,58,335,237,108
23,178915,WEST OSO ISD,2,english,5,128,28,100,41,18,128,33,95,44,9
23,179901,PERRYTON ISD,16,english,5,133,23,110,75,28,132,9,123,99,41
23,180901,BOYS RANCH ISD,16,english,5,8,1,7,4,3,8,1,7,4,3
23,180902,VEGA ISD,16,english,5,20,0,20,14,8,20,0,20,19,10
23,180903,ADRIAN ISD,16,english,5,7,3,4,2,1,7,0,7,3,0
23,180904,WILDORADO ISD,16,english,5,10,4,6,2,0,10,2,8,4,0
23,181901,BRIDGE CITY ISD,5,english,5,242,34,208,147,74,240,45,195,116,48
23,181905,ORANGEFIELD ISD,5,english,5,132,23,109,64,22,132,10,122,64,24
23,181906,WEST ORANGE-COV,5,english,5,162,60,102,64,23,159,88,71,28,2
23,181907,VIDOR ISD,5,english,5,286,50,236,139,49,288,66,222,117,31
23,181908,LITTLE CYPRESS-,5,english,5,244,70,174,101,47,242,78,164,75,21
23,182901,GORDON ISD,11,english,5,22,5,17,7,4,22,11,11,2,1
23,182902,GRAFORD ISD,11,english,5,18,5,13,5,2,18,3,15,3,1
23,182903,MINERAL WELLS I,11,english,5,251,68,183,103,39,252,47,205,110,41
23,182904,SANTO ISD,11,english,5,44,6,38,25,10,43,3,40,28,11
23,182905,STRAWN ISD,11,english,5,9,0,9,8,1,9,2,7,4,0
23,182906,PALO PINTO ISD,11,english,5,10,0,10,9,7,10,0,10,8,2
23,183901,BECKVILLE ISD,7,english,5,56,3,53,39,18,56,3,53,34,9
23,183902,CARTHAGE ISD,7,english,5,201,56,145,80,21,200,56,144,65,27
23,183904,GARY ISD,7,english,5,33,2,31,19,10,33,2,31,18,5
23,184901,POOLVILLE ISD,11,english,5,56,12,44,27,6,57,23,34,18,6
23,184902,SPRINGTOWN ISD,11,english,5,309,86,223,141,53,311,77,234,117,38
23,184903,WEATHERFORD ISD,11,english,5,598,119,479,333,170,601,122,479,300,119
23,184904,MILLSAP ISD,11,english,5,80,9,71,49,26,80,5,75,50,11
23,184907,ALEDO ISD,11,english,5,605,37,568,451,264,606,40,566,429,233
23,184908,PEASTER ISD,11,english,5,152,30,122,91,36,151,29,122,75,27
23,184909,BROCK ISD,11,english,5,159,9,150,125,80,158,6,152,128,57
23,184911,GARNER ISD,11,english,5,29,7,22,14,3,30,3,27,16,7
23,185901,BOVINA ISD,16,english,5,32,7,25,16,9,32,5,27,11,1
23,185902,FARWELL ISD,16,english,5,43,2,41,24,10,43,0,43,31,12
23,185903,FRIONA ISD,16,english,5,74,25,49,25,11,74,18,56,26,10
23,185904,LAZBUDDIE ISD,16,english,5,7,2,5,4,0,7,3,4,3,0
23,186901,BUENA VISTA ISD,18,english,5,20,0,20,12,2,20,2,18,12,4
23,186902,FORT STOCKTON I,18,english,5,155,37,118,66,33,154,34,120,67,26
23,186903,IRAAN-SHEFFIELD,18,english,5,29,13,16,9,1,29,9,20,7,2
23,187901,BIG SANDY ISD,6,english,5,37,2,35,25,9,37,1,36,26,9
23,187903,GOODRICH ISD,6,english,5,17,5,12,6,3,17,6,11,6,0
23,187904,CORRIGAN-CAMDEN,6,english,5,64,12,52,25,15,64,16,48,27,12
23,187906,LEGGETT ISD,6,english,5,16,6,10,6,2,16,4,12,3,1
23,187907,LIVINGSTON ISD,6,english,5,274,52,222,136,64,275,42,233,147,55
23,187910,ONALASKA ISD,6,english,5,73,7,66,45,22,73,6,67,44,14
23,188901,AMARILLO ISD,16,english,5,2024,313,1711,1173,570,2107,259,1848,1164,431
23,188902,RIVER ROAD ISD,16,english,5,99,18,81,38,13,99,30,69,30,6
23,188903,HIGHLAND PARK I,16,english,5,68,10,58,38,9,68,4,64,43,20
23,188904,BUSHLAND ISD,16,english,5,117,21,96,76,45,117,18,99,63,19
23,189901,MARFA ISD,18,english,5,20,2,18,12,5,20,5,15,6,1
23,189902,PRESIDIO ISD,18,english,5,54,27,27,15,6,54,13,41,18,8
23,190903,RAINS ISD,7,english,5,125,35,90,50,20,125,36,89,38,7
23,191901,CANYON ISD,16,english,5,836,115,721,510,218,836,78,758,506,202
23,192901,REAGAN COUNTY I,18,english,5,48,9,39,27,12,48,17,31,19,4
23,193801,BIG SPRINGS CHA,20,english,5,18,12,6,2,1,17,12,5,1,1
23,193902,LEAKEY ISD,20,english,5,28,5,23,14,5,27,9,18,5,2
23,194902,AVERY ISD,8,english,5,17,2,15,10,4,17,2,15,12,6
23,194903,RIVERCREST ISD,8,english,5,56,11,45,21,7,56,6,50,38,10
23,194904,CLARKSVILLE ISD,8,english,5,35,10,25,11,2,35,20,15,5,0
23,194905,DETROIT ISD,8,english,5,42,14,28,13,2,42,18,24,9,0
23,195901,PECOS-BARSTOW-T,18,english,5,175,52,123,72,24,174,40,134,64,17
23,195902,BALMORHEA ISD,18,english,5,11,5,6,3,0,11,5,6,1,0
23,196901,AUSTWELL-TIVOLI,3,english,5,0,,,,,0,,,,
23,196902,WOODSBORO ISD,3,english,5,34,7,27,13,4,34,11,23,7,2
23,196903,REFUGIO ISD,3,english,5,49,16,33,17,6,49,9,40,16,7
23,197902,MIAMI ISD,16,english,5,16,1,15,11,4,16,1,15,6,2
23,198901,BREMOND ISD,6,english,5,29,0,29,23,14,29,0,29,19,10
23,198902,CALVERT ISD,6,english,5,9,2,7,4,0,8,4,4,1,1
23,198903,FRANKLIN ISD,6,english,5,98,9,89,69,38,98,5,93,63,28
23,198905,HEARNE ISD,6,english,5,59,31,28,13,4,58,28,30,11,3
23,198906,MUMFORD ISD,6,english,5,42,1,41,37,23,42,1,41,33,17
23,199901,ROCKWALL ISD,10,english,5,1327,149,1178,933,559,1245,107,1138,843,423
23,199902,ROYSE CITY ISD,10,english,5,639,115,524,352,168,632,93,539,347,135
23,200901,BALLINGER ISD,15,english,5,59,11,48,32,10,59,8,51,38,11
23,200902,MILES ISD,15,english,5,39,7,32,28,20,39,7,32,24,9
23,200904,WINTERS ISD,15,english,5,34,14,20,10,4,34,7,27,13,4
23,200906,OLFEN ISD,15,english,5,6,2,4,3,2,6,2,4,2,2
23,201902,HENDERSON ISD,7,english,5,247,58,189,99,49,248,73,175,96,25
23,201903,LANEVILLE ISD,7,english,5,6,0,6,3,1,6,1,5,2,0
23,201904,LEVERETTS CHAPE,7,english,5,20,3,17,12,1,20,3,17,6,0
23,201907,MOUNT ENTERPRIS,7,english,5,42,2,40,33,18,42,1,41,34,19
23,201908,OVERTON ISD,7,english,5,38,9,29,16,4,39,6,33,15,4
23,201910,TATUM ISD,7,english,5,115,23,92,58,21,115,12,103,74,32
23,201913,CARLISLE ISD,7,english,5,48,12,36,16,7,48,5,43,26,6
23,201914,WEST RUSK COUNT,7,english,5,68,15,53,35,20,68,14,54,35,10
23,202903,HEMPHILL ISD,7,english,5,52,8,44,25,10,51,6,45,22,8
23,202905,WEST SABINE ISD,7,english,5,44,5,39,22,7,44,3,41,29,11
23,203901,SAN AUGUSTINE I,7,english,5,41,18,23,13,3,42,14,28,10,2
23,203902,BROADDUS ISD,7,english,5,25,2,23,20,8,25,1,24,17,7
23,204901,COLDSPRING-OAKH,6,english,5,101,36,65,38,15,102,32,70,42,9
23,204904,SHEPHERD ISD,6,english,5,135,56,79,41,15,136,36,100,48,10
23,205901,ARANSAS PASS IS,2,english,5,123,44,79,48,15,123,43,80,33,5
23,205902,GREGORY-PORTLAN,2,english,5,376,46,330,249,109,375,46,329,227,107
23,205903,INGLESIDE ISD,2,english,5,134,24,110,74,34,133,31,102,55,15
23,205904,MATHIS ISD,2,english,5,126,25,101,62,25,127,10,117,59,14
23,205905,ODEM-EDROY ISD,2,english,5,65,15,50,33,15,65,22,43,17,8
23,205906,SINTON ISD,2,english,5,121,16,105,80,32,120,16,104,66,22
23,205907,TAFT ISD,2,english,5,59,16,43,26,6,59,12,47,27,13
23,206901,SAN SABA ISD,15,english,5,61,8,53,34,17,61,6,55,30,12
23,206902,RICHLAND SPRING,15,english,5,9,1,8,6,3,9,0,9,7,1
23,206903,CHEROKEE ISD,15,english,5,6,1,5,4,3,6,1,5,4,2
23,207901,SCHLEICHER ISD,15,english,5,34,9,25,12,1,34,15,19,10,3
23,208901,HERMLEIGH ISD,14,english,5,15,4,11,6,2,15,0,15,9,3
23,208902,SNYDER ISD,14,english,5,178,49,129,65,23,185,46,139,76,22
23,208903,IRA ISD,14,english,5,20,1,19,17,9,20,2,18,14,8
23,209901,ALBANY ISD,14,english,5,31,2,29,21,9,31,4,27,25,9
23,209902,MORAN ISD,14,english,5,13,6,7,4,2,13,7,6,2,1
23,210901,CENTER ISD,7,english,5,147,33,114,62,27,148,41,107,54,12
23,210902,JOAQUIN ISD,7,english,5,41,12,29,12,2,41,9,32,22,8
23,210903,SHELBYVILLE ISD,7,english,5,53,5,48,39,16,53,2,51,43,16
23,210904,TENAHA ISD,7,english,5,28,9,19,13,5,28,3,25,21,9
23,210905,TIMPSON ISD,7,english,5,42,8,34,19,2,43,7,36,21,2
23,210906,EXCELSIOR ISD,7,english,5,9,4,5,5,3,9,3,6,3,1
23,211902,STRATFORD ISD,16,english,5,34,3,31,24,13,34,9,25,18,5
23,212801,CUMBERLAND ACAD,7,english,5,129,34,95,63,25,129,39,90,47,15
23,212804,UT TYLER UNIVER,7,english,5,59,4,55,45,23,59,10,49,35,16
23,212901,ARP ISD,7,english,5,76,17,59,34,15,76,16,60,30,7
23,212902,BULLARD ISD,7,english,5,202,22,180,142,56,201,9,192,132,52
23,212903,LINDALE ISD,7,english,5,331,32,299,236,131,331,26,305,240,132
23,212904,TROUP ISD,7,english,5,85,8,77,58,32,85,12,73,39,10
23,212905,TYLER ISD,7,english,5,1224,275,949,655,302,1293,305,988,582,238
23,212906,WHITEHOUSE ISD,7,english,5,348,35,313,260,174,348,36,312,251,103
23,212909,CHAPEL HILL ISD,7,english,5,199,42,157,100,45,214,53,161,110,33
23,212910,WINONA ISD,7,english,5,80,21,59,35,7,80,30,50,16,1
23,213901,GLEN ROSE ISD,11,english,5,141,23,118,76,24,144,25,119,77,38
23,214901,RIO GRANDE CITY,1,english,5,620,175,445,265,114,622,197,425,247,71
23,214902,SAN ISIDRO ISD,1,english,5,14,4,10,7,1,14,6,8,4,1
23,214903,ROMA ISD,1,english,5,395,26,369,298,194,397,22,375,330,222
23,215901,BRECKENRIDGE IS,14,english,5,89,23,66,42,20,90,16,74,41,15
23,216901,STERLING CITY I,15,english,5,13,3,10,8,3,13,0,13,5,2
23,217901,ASPERMONT ISD,14,english,5,12,0,12,7,2,12,0,12,7,1
23,218901,SONORA ISD,15,english,5,37,7,30,18,3,37,7,30,7,3
23,219901,HAPPY ISD,16,english,5,18,5,13,8,4,18,3,15,8,4
23,219903,TULIA ISD,16,english,5,67,36,31,18,8,67,43,24,7,4
23,219905,KRESS ISD,16,english,5,18,5,13,9,3,18,3,15,9,2
23,220801,TREETOPS SCHOOL,11,english,5,27,3,24,16,5,27,8,19,5,1
23,220802,ARLINGTON CLASS,11,english,5,173,13,160,123,66,173,19,154,109,48
23,220809,FORT WORTH ACAD,11,english,5,65,3,62,44,19,63,9,54,36,16
23,220810,WESTLAKE ACADEM,11,english,5,63,3,60,56,49,63,2,61,53,39
23,220811,EAST FORT WORTH,11,english,5,16,2,14,8,7,16,6,10,4,0
23,220814,TEXAS SCHOOL OF,11,english,5,35,1,34,30,13,35,4,31,13,5
23,220815,CHAPEL HILL ACA,11,english,5,68,23,45,24,7,68,31,37,11,2
23,220817,NEWMAN INTERNAT,11,english,5,177,19,158,94,44,176,34,142,85,32
23,220819,HIGH POINT ACAD,11,english,5,146,28,118,85,43,145,44,101,48,22
23,220901,ARLINGTON ISD,11,english,5,3515,953,2562,1487,592,3534,1094,2440,1311,496
23,220902,BIRDVILLE ISD,11,english,5,1507,271,1236,911,481,1531,304,1227,771,329
23,220904,EVERMAN ISD,11,english,5,347,97,250,146,60,360,98,262,134,39
23,220905,FORT WORTH ISD,11,english,5,4810,1443,3367,1971,786,4987,1728,3259,1678,546
23,220906,GRAPEVINE-COLLE,11,english,5,947,98,849,706,455,941,89,852,675,363
23,220907,KELLER ISD,11,english,5,2353,309,2044,1551,820,2468,341,2127,1506,751
23,220908,MANSFIELD ISD,11,english,5,2571,391,2180,1530,728,2581,450,2131,1351,580
23,220910,LAKE WORTH ISD,11,english,5,202,83,119,59,17,216,124,92,34,5
23,220912,CROWLEY ISD,11,english,5,1072,274,798,500,212,1128,355,773,403,126
23,220914,KENNEDALE ISD,11,english,5,213,63,150,92,33,215,72,143,76,22
23,220915,AZLE ISD,11,english,5,530,109,421,275,117,533,99,434,276,105
23,220916,HURST-EULESS-BE,11,english,5,1619,225,1394,1058,628,1619,233,1386,961,456
23,220917,CASTLEBERRY ISD,11,english,5,217,47,170,113,35,227,51,176,86,27
23,220918,EAGLE MT-SAGINA,11,english,5,1597,332,1265,855,386,1608,386,1222,717,282
23,220919,CARROLL ISD,11,english,5,627,8,619,582,445,446,11,435,378,252
23,220920,WHITE SETTLEMEN,11,english,5,499,111,388,264,115,524,117,407,232,83
23,221801,TEXAS COLLEGE P,14,english,5,1347,182,1165,839,395,1360,270,1090,638,255
23,221901,ABILENE ISD,14,english,5,1053,289,764,491,236,1057,298,759,391,127
23,221904,MERKEL ISD,14,english,5,71,11,60,42,18,71,6,65,42,15
23,221905,TRENT ISD,14,english,5,11,5,6,3,1,11,6,5,4,1
23,221911,JIM NED CISD,14,english,5,121,5,116,94,54,121,3,118,94,42
23,221912,WYLIE ISD,14,english,5,411,47,364,272,153,411,34,377,287,133
23,222901,TERRELL COUNTY,18,english,5,9,2,7,4,3,9,0,9,6,3
23,223901,BROWNFIELD ISD,17,english,5,122,52,70,39,15,122,61,61,26,7
23,223902,MEADOW ISD,17,english,5,14,1,13,10,4,14,2,12,6,1
23,223904,WELLMAN-UNION C,17,english,5,32,5,27,12,5,32,2,30,17,9
23,224901,THROCKMORTON CO,9,english,5,9,2,7,4,0,8,3,5,3,0
23,224902,WOODSON ISD,9,english,5,10,2,8,4,0,10,1,9,3,0
23,225902,MOUNT PLEASANT,8,english,5,226,42,184,134,62,327,49,278,168,66
23,225906,CHAPEL HILL ISD,8,english,5,69,9,60,47,13,69,6,63,38,12
23,225907,HARTS BLUFF ISD,8,english,5,63,15,48,33,15,63,9,54,36,18
23,226801,TEXAS LEADERSHI,15,english,5,280,79,201,106,41,279,106,173,60,14
23,226901,CHRISTOVAL ISD,15,english,5,42,4,38,27,13,44,5,39,24,9
23,226903,SAN ANGELO ISD,15,english,5,960,264,696,427,169,959,295,664,353,123
23,226905,WATER VALLEY IS,15,english,5,32,2,30,19,3,32,2,30,19,4
23,226906,WALL ISD,15,english,5,112,11,101,85,44,112,8,104,88,47
23,226907,GRAPE CREEK ISD,15,english,5,92,25,67,41,14,92,20,72,42,9
23,226908,VERIBEST ISD,15,english,5,13,1,12,7,3,13,0,13,10,3
23,227803,WAYSIDE SCHOOLS,13,english,5,134,42,92,53,24,136,29,107,59,23
23,227804,NYOS CHARTER SC,13,english,5,141,10,131,102,66,140,20,120,80,33
23,227805,TEXAS EMPOWERME,13,english,5,30,12,18,8,2,29,9,20,10,0
23,227806,UNIVERSITY OF T,13,english,5,14,11,3,2,1,14,11,3,1,1
23,227814,CHAPARRAL STAR,13,english,5,25,0,25,25,17,25,0,25,22,9
23,227816,HARMONY PUBLIC,13,english,5,337,61,276,209,124,340,55,285,201,119
23,227817,CEDARS INTERNAT,13,english,5,29,9,20,13,4,28,1,27,12,5
23,227819,UNIVERSITY OF T,13,english,5,46,10,36,23,15,46,11,35,20,10
23,227820,KIPP TEXAS PUBL,4,english,5,2403,749,1654,910,346,2407,956,1451,610,174
23,227821,AUSTIN DISCOVER,13,english,5,59,8,51,40,25,58,15,43,26,11
23,227824,VALERE PUBLIC S,13,english,5,45,7,38,25,9,45,9,36,18,4
23,227825,AUSTIN ACHIEVE,13,english,5,152,58,94,51,18,153,81,72,26,11
23,227826,MONTESSORI FOR,13,english,5,37,5,32,22,14,39,14,25,16,7
23,227829,VALOR PUBLIC SC,13,english,5,183,10,173,133,85,181,29,152,100,39
23,227901,AUSTIN ISD,13,english,5,4555,767,3788,2908,1736,4827,1050,3777,2574,1274
23,227904,PFLUGERVILLE IS,13,english,5,1617,288,1329,983,515,1674,310,1364,880,386
23,227905,TEXAS SCH FOR T,13,english,5,0,,,,,0,,,,
23,227906,TEXAS SCH FOR T,13,english,5,29,18,11,5,2,29,15,14,2,0
23,227907,MANOR ISD,13,english,5,603,172,431,262,109,614,229,385,198,64
23,227909,EANES ISD,13,english,5,520,17,503,447,308,487,16,471,404,241
23,227910,DEL VALLE ISD,13,english,5,473,140,333,177,68,681,176,505,256,72
23,227912,LAGO VISTA ISD,13,english,5,114,20,94,75,39,114,19,95,68,32
23,227913,LAKE TRAVIS ISD,13,english,5,808,55,753,614,354,767,73,694,514,244
23,228901,GROVETON ISD,6,english,5,48,15,33,24,7,49,18,31,12,6
23,228903,TRINITY ISD,6,english,5,73,25,48,28,7,73,27,46,24,9
23,228904,CENTERVILLE ISD,6,english,5,8,0,8,6,1,7,0,7,6,2
23,228905,APPLE SPRINGS I,6,english,5,16,8,8,5,2,16,3,13,7,3
23,229901,COLMESNEIL ISD,5,english,5,31,5,26,17,11,31,12,19,12,3
23,229903,WOODVILLE ISD,5,english,5,82,25,57,29,12,82,34,48,19,3
23,229904,WARREN ISD,5,english,5,87,24,63,46,20,88,21,67,35,13
23,229905,SPURGER ISD,5,english,5,28,5,23,15,9,28,1,27,16,2
23,229906,CHESTER ISD,5,english,5,16,4,12,7,2,16,2,14,11,2
23,230901,BIG SANDY ISD,7,english,5,50,9,41,29,16,50,7,43,20,11
23,230902,GILMER ISD,7,english,5,206,35,171,128,63,205,23,182,121,55
23,230903,ORE CITY ISD,7,english,5,59,9,50,37,18,59,9,50,32,14
23,230904,UNION HILL ISD,7,english,5,20,4,16,11,5,20,4,16,9,3
23,230905,HARMONY ISD,7,english,5,79,7,72,53,26,79,3,76,42,16
23,230906,NEW DIANA ISD,7,english,5,87,6,81,64,38,87,9,78,57,25
23,230908,UNION GROVE ISD,7,english,5,52,10,42,28,8,52,10,42,24,6
23,231901,MCCAMEY ISD,18,english,5,33,8,25,14,3,33,14,19,9,2
23,231902,RANKIN ISD,18,english,5,23,1,22,19,8,23,2,21,15,5
23,232901,KNIPPA ISD,20,english,5,26,1,25,17,10,26,1,25,16,5
23,232902,SABINAL ISD,20,english,5,37,7,30,18,8,37,2,35,15,7
23,232903,UVALDE CISD,20,english,5,209,76,133,60,18,207,92,115,38,9
23,232904,UTOPIA ISD,20,english,5,11,3,8,4,2,11,7,4,3,1
23,233901,SAN FELIPE-DEL,15,english,5,674,143,531,324,141,674,134,540,301,75
23,233903,COMSTOCK ISD,15,english,5,21,2,19,16,11,21,1,20,14,9
23,234902,CANTON ISD,10,english,5,178,17,161,113,44,178,4,174,122,51
23,234903,EDGEWOOD ISD,7,english,5,66,10,56,40,15,68,10,58,30,10
23,234904,GRAND SALINE IS,7,english,5,95,26,69,40,19,95,20,75,51,20
23,234905,MARTINS MILL IS,7,english,5,42,7,35,25,12,42,8,34,20,6
23,234906,VAN ISD,7,english,5,161,37,124,76,39,161,35,126,92,32
23,234907,WILLS POINT ISD,10,english,5,190,56,134,83,35,193,49,144,83,25
23,234909,FRUITVALE ISD,7,english,5,30,7,23,11,4,30,9,21,6,1
23,235901,BLOOMINGTON ISD,3,english,5,69,30,39,16,4,70,27,43,18,2
23,235902,VICTORIA ISD,3,english,5,910,248,662,399,157,912,284,628,351,142
23,235904,NURSERY ISD,3,english,5,16,1,15,11,4,16,0,16,10,4
23,236802,SAM HOUSTON STA,6,english,5,63,6,57,40,32,63,7,56,44,26
23,236901,NEW WAVERLY ISD,6,english,5,78,10,68,50,24,77,13,64,43,11
23,236902,HUNTSVILLE ISD,6,english,5,951,279,672,410,144,951,413,538,259,69
23,237902,HEMPSTEAD ISD,4,english,5,98,43,55,24,7,98,32,66,18,2
23,237904,WALLER ISD,4,english,5,638,152,486,316,145,635,151,484,279,113
23,237905,ROYAL ISD,4,english,5,206,83,123,64,20,205,46,159,87,24
23,238902,MONAHANS-WICKET,18,english,5,133,33,100,62,23,133,29,104,52,16
23,238904,GRANDFALLS-ROYA,18,english,5,7,4,3,1,0,7,3,4,2,1
23,239901,BRENHAM ISD,6,english,5,339,71,268,165,72,341,76,265,134,58
23,239903,BURTON ISD,6,english,5,35,1,34,29,15,35,1,34,32,14
23,240901,LAREDO ISD,1,english,5,1386,263,1123,805,430,1392,243,1149,737,286
23,240903,UNITED ISD,1,english,5,2810,463,2347,1730,971,2820,339,2481,1604,591
23,240904,WEBB CISD,1,english,5,26,6,20,10,1,26,2,24,11,3
23,241901,BOLING ISD,3,english,5,89,16,73,45,31,89,18,71,36,13
23,241902,EAST BERNARD IS,3,english,5,73,10,63,42,14,73,10,63,41,21
23,241903,EL CAMPO ISD,3,english,5,200,34,166,100,51,200,12,188,139,64
23,241904,WHARTON ISD,3,english,5,123,44,79,48,24,123,40,83,42,14
23,241906,LOUISE ISD,3,english,5,30,2,28,19,5,29,2,27,20,10
23,242902,SHAMROCK ISD,16,english,5,23,3,20,15,3,23,4,19,12,3
23,242903,WHEELER ISD,16,english,5,35,3,32,21,9,35,1,34,18,6
23,242905,KELTON ISD,16,english,5,10,1,9,6,1,10,2,8,2,0
23,242906,FORT ELLIOTT CI,16,english,5,11,2,9,5,4,11,1,10,7,3
23,243901,BURKBURNETT ISD,9,english,5,228,33,195,124,48,228,37,191,109,44
23,243902,ELECTRA ISD,9,english,5,30,9,21,14,3,30,8,22,14,3
23,243903,IOWA PARK CISD,9,english,5,149,6,143,104,52,148,12,136,123,73
23,243905,WICHITA FALLS I,9,english,5,955,270,685,398,187,955,246,709,381,137
23,243906,CITY VIEW ISD,9,english,5,81,7,74,48,15,82,10,72,49,10
23,244901,HARROLD ISD,9,english,5,13,3,10,6,4,13,5,8,3,0
23,244903,VERNON ISD,9,english,5,128,44,84,40,6,128,32,96,48,14
23,244905,NORTHSIDE ISD,9,english,5,15,1,14,8,2,15,0,15,9,4
23,245901,LASARA ISD,1,english,5,16,6,10,5,0,16,6,10,3,2
23,245902,LYFORD CISD,1,english,5,91,20,71,47,20,92,30,62,27,1
23,245903,RAYMONDVILLE IS,1,english,5,118,18,100,65,31,117,14,103,72,27
23,245904,SAN PERLITA ISD,1,english,5,18,0,18,11,4,18,0,18,18,6
23,246801,MERIDIAN WORLD,13,english,5,151,4,147,123,77,151,8,143,110,64
23,246802,GOODWATER MONTE,13,english,5,34,11,23,16,8,34,15,19,8,3
23,246902,FLORENCE ISD,13,english,5,69,14,55,35,14,70,14,56,23,6
23,246904,GEORGETOWN ISD,13,english,5,914,242,672,417,196,927,288,639,345,135
23,246905,GRANGER ISD,13,english,5,36,12,24,12,4,35,9,26,10,2
23,246906,HUTTO ISD,13,english,5,661,109,552,361,154,682,158,524,277,83
23,246907,JARRELL ISD,13,english,5,248,88,160,88,25,246,86,160,73,28
23,246908,LIBERTY HILL IS,13,english,5,617,59,558,423,252,615,63,552,394,179
23,246909,ROUND ROCK ISD,13,english,5,3263,390,2873,2314,1519,3274,470,2804,2148,1231
23,246911,TAYLOR ISD,13,english,5,208,78,130,61,19,210,91,119,51,14
23,246912,THRALL ISD,13,english,5,49,2,47,36,16,49,4,45,28,9
23,246913,LEANDER ISD,13,english,5,2982,312,2670,2120,1268,3009,485,2524,1807,969
23,246914,COUPLAND ISD,13,english,5,34,7,27,13,4,34,10,24,11,6
23,247901,FLORESVILLE ISD,20,english,5,275,67,208,138,60,276,53,223,123,48
23,247903,LA VERNIA ISD,20,english,5,282,26,256,195,100,283,18,265,185,91
23,247904,POTH ISD,20,english,5,77,5,72,57,27,78,4,74,44,18
23,247906,STOCKDALE ISD,20,english,5,59,8,51,38,22,59,10,49,32,11
23,248901,KERMIT ISD,18,english,5,95,44,51,26,7,95,26,69,21,5
23,248902,WINK-LOVING ISD,18,english,5,25,3,22,14,8,25,1,24,18,5
23,249901,ALVORD ISD,11,english,5,58,9,49,32,16,58,6,52,33,14
23,249902,BOYD ISD,11,english,5,88,34,54,34,14,90,33,57,18,9
23,249903,BRIDGEPORT ISD,11,english,5,145,32,113,83,32,155,27,128,81,29
23,249904,CHICO ISD,11,english,5,38,6,32,21,9,38,6,32,24,9
23,249905,DECATUR ISD,11,english,5,261,41,220,142,60,263,65,198,105,42
23,249906,PARADISE ISD,11,english,5,79,12,67,51,25,79,9,70,49,15
23,249908,SLIDELL ISD,11,english,5,22,6,16,9,5,23,6,17,6,2
23,250902,HAWKINS ISD,7,english,5,64,8,56,36,16,64,20,44,27,7
23,250903,MINEOLA ISD,7,english,5,102,16,86,67,26,102,8,94,63,21
23,250904,QUITMAN ISD,7,english,5,97,15,82,52,26,97,15,82,49,17
23,250905,YANTIS ISD,7,english,5,24,5,19,13,5,23,3,20,12,2
23,250906,ALBA-GOLDEN ISD,7,english,5,60,10,50,33,15,60,11,49,21,7
23,250907,WINNSBORO ISD,7,english,5,115,31,84,53,24,115,21,94,63,30
23,251901,DENVER CITY ISD,17,english,5,99,21,78,48,22,99,25,74,34,9
23,251902,PLAINS ISD,17,english,5,32,10,22,15,4,32,3,29,20,6
23,252901,GRAHAM ISD,9,english,5,166,32,134,93,46,166,21,145,96,39
23,252902,NEWCASTLE ISD,9,english,5,14,1,13,10,4,14,2,12,6,3
23,252903,OLNEY ISD,9,english,5,48,5,43,33,20,48,5,43,36,19
23,253901,ZAPATA COUNTY I,1,english,5,228,73,155,89,43,229,42,187,112,29
23,254901,CRYSTAL CITY IS,20,english,5,118,46,72,30,10,116,51,65,26,6
23,254902,LA PRYOR ISD,20,english,5,36,7,29,16,7,36,11,25,11,2
23,1908,WESTWOOD ISD,7,spanish,5,0,,,,,0,,,,
23,2901,ANDREWS ISD,18,spanish,5,16,10,6,1,1,13,8,5,1,0
23,3902,HUDSON ISD,7,spanish,5,0,,,,,0,,,,
23,3903,LUFKIN ISD,7,spanish,5,8,3,5,3,2,8,4,4,2,0
23,7902,JOURDANTON ISD,20,spanish,5,0,,,,,0,,,,
23,7906,POTEET ISD,20,spanish,5,0,,,,,0,,,,
23,8902,SEALY ISD,6,spanish,5,0,,,,,0,,,,
23,11901,BASTROP ISD,13,spanish,5,16,7,9,2,0,18,16,2,1,0
23,11902,ELGIN ISD,13,spanish,5,26,17,9,2,0,13,12,1,0,0
23,13901,BEEVILLE ISD,2,spanish,5,0,,,,,0,,,,
23,14803,PRIORITY CHARTE,12,spanish,5,0,,,,,0,,,,
23,14903,BELTON ISD,12,spanish,5,6,4,2,1,0,6,3,3,1,0
23,14906,KILLEEN ISD,12,spanish,5,13,3,10,4,1,13,3,10,2,1
23,14907,ROGERS ISD,12,spanish,5,0,,,,,0,,,,
23,14909,TEMPLE ISD,12,spanish,5,11,8,3,1,0,6,4,2,1,0
23,15802,GEORGE GERVIN A,20,spanish,5,6,2,4,2,1,6,3,3,1,0
23,15822,JUBILEE ACADEMI,20,spanish,5,21,7,14,9,4,21,5,16,4,0
23,15825,LIGHTHOUSE PUBL,20,spanish,5,0,,,,,0,,,,
23,15827,SCHOOL OF SCIEN,20,spanish,5,0,,,,,0,,,,
23,15828,HARMONY PUBLIC,20,spanish,5,12,2,10,6,2,0,,,,
23,15830,BROOKS ACADEMIE,20,spanish,5,5,5,0,0,0,5,4,1,0,0
23,15831,SCHOOL OF SCIEN,20,spanish,5,0,,,,,0,,,,
23,15835,GREAT HEARTS TE,20,spanish,5,0,,,,,0,,,,
23,15838,COMPASS ROSE PU,20,spanish,5,0,,,,,0,,,,
23,15901,ALAMO HEIGHTS I,20,spanish,5,15,4,11,7,4,10,1,9,5,0
23,15904,HARLANDALE ISD,20,spanish,5,88,41,47,34,12,81,32,49,21,4
23,15905,EDGEWOOD ISD,20,spanish,5,28,15,13,5,3,16,11,5,1,0
23,15907,SAN ANTONIO ISD,20,spanish,5,399,156,243,126,49,376,136,240,114,34
23,15908,SOUTH SAN ANTON,20,spanish,5,42,18,24,11,6,28,11,17,5,0
23,15909,SOMERSET ISD,20,spanish,5,23,8,15,9,2,0,,,,
23,15910,NORTH EAST ISD,20,spanish,5,479,114,365,235,140,515,93,422,231,66
23,15911,EAST CENTRAL IS,20,spanish,5,49,23,26,13,4,22,10,12,5,0
23,15912,SOUTHWEST ISD,20,spanish,5,30,9,21,10,6,31,13,18,6,0
23,15915,NORTHSIDE ISD,20,spanish,5,147,61,86,38,17,141,50,91,44,16
23,15916,JUDSON ISD,20,spanish,5,27,9,18,12,7,23,9,14,8,3
23,15917,SOUTHSIDE ISD,20,spanish,5,86,33,53,33,16,13,6,7,6,1
23,18904,VALLEY MILLS IS,12,spanish,5,0,,,,,0,,,,
23,19907,TEXARKANA ISD,8,spanish,5,14,3,11,3,1,0,,,,
23,19908,LIBERTY-EYLAU I,8,spanish,5,0,,,,,0,,,,
23,19909,SIMMS ISD,8,spanish,5,0,,,,,0,,,,
23,20901,ALVIN ISD,4,spanish,5,23,11,12,4,0,14,4,10,1,1
23,20904,DANBURY ISD,4,spanish,5,0,,,,,0,,,,
23,20905,BRAZOSPORT ISD,4,spanish,5,15,4,11,6,1,12,4,8,3,0
23,20906,SWEENY ISD,4,spanish,5,0,,,,,0,,,,
23,20908,PEARLAND ISD,4,spanish,5,7,3,4,1,0,7,5,2,0,0
23,21901,COLLEGE STATION,6,spanish,5,17,6,11,7,3,16,5,11,3,1
23,21902,BRYAN ISD,6,spanish,5,23,15,8,0,0,21,13,8,0,0
23,22004,TERLINGUA CSD,18,spanish,5,0,,,,,0,,,,
23,26901,CALDWELL ISD,6,spanish,5,0,,,,,0,,,,
23,27903,BURNET CISD,13,spanish,5,0,,,,,0,,,,
23,27904,MARBLE FALLS IS,13,spanish,5,17,8,9,1,0,11,6,5,1,0
23,28902,LOCKHART ISD,13,spanish,5,15,9,6,1,0,15,10,5,0,0
23,31901,BROWNSVILLE ISD,1,spanish,5,77,27,50,23,9,75,28,47,20,2
23,31903,HARLINGEN CISD,1,spanish,5,14,6,8,4,3,13,5,8,2,0
23,31905,LA FERIA ISD,1,spanish,5,0,,,,,0,,,,
23,31906,LOS FRESNOS CIS,1,spanish,5,13,6,7,4,3,13,4,9,5,2
23,31909,POINT ISABEL IS,1,spanish,5,0,,,,,0,,,,
23,31912,SAN BENITO CISD,1,spanish,5,18,6,12,6,3,13,3,10,3,0
23,31913,SANTA MARIA ISD,1,spanish,5,0,,,,,0,,,,
23,31914,SANTA ROSA ISD,1,spanish,5,0,,,,,0,,,,
23,35901,DIMMITT ISD,16,spanish,5,0,,,,,0,,,,
23,35902,HART ISD,16,spanish,5,0,,,,,0,,,,
23,36902,BARBERS HILL IS,4,spanish,5,0,,,,,0,,,,
23,36903,EAST CHAMBERS I,5,spanish,5,0,,,,,0,,,,
23,37901,ALTO ISD,7,spanish,5,0,,,,,0,,,,
23,37904,JACKSONVILLE IS,7,spanish,5,27,10,17,8,2,5,3,2,0,0
23,37908,NEW SUMMERFIELD,7,spanish,5,0,,,,,0,,,,
23,40901,MORTON ISD,17,spanish,5,0,,,,,0,,,,
23,41901,BRONTE ISD,15,spanish,5,0,,,,,0,,,,
23,43802,LONE STAR LANGU,10,spanish,5,0,,,,,0,,,,
23,43901,ALLEN ISD,10,spanish,5,15,2,13,4,1,16,8,8,4,2
23,43903,CELINA ISD,10,spanish,5,0,,,,,0,,,,
23,43904,FARMERSVILLE IS,10,spanish,5,0,,,,,0,,,,
23,43905,FRISCO ISD,10,spanish,5,34,10,24,14,8,27,7,20,12,4
23,43907,MCKINNEY ISD,10,spanish,5,47,26,21,12,4,39,22,17,4,0
23,43910,PLANO ISD,10,spanish,5,198,77,121,58,17,196,67,129,41,6
23,43911,PRINCETON ISD,10,spanish,5,8,6,2,1,0,8,5,3,1,0
23,43912,PROSPER ISD,10,spanish,5,0,,,,,0,,,,
23,43914,WYLIE ISD,10,spanish,5,0,,,,,0,,,,
23,43917,BLUE RIDGE ISD,10,spanish,5,0,,,,,0,,,,
23,43918,COMMUNITY ISD,10,spanish,5,41,14,27,11,4,0,,,,
23,45902,COLUMBUS ISD,4,spanish,5,0,,,,,0,,,,
23,45903,RICE CISD,3,spanish,5,0,,,,,0,,,,
23,46901,NEW BRAUNFELS I,20,spanish,5,10,4,6,3,1,7,2,5,1,0
23,46902,COMAL ISD,20,spanish,5,7,2,5,1,0,6,3,3,0,0
23,49901,GAINESVILLE ISD,11,spanish,5,0,,,,,0,,,,
23,49903,VALLEY VIEW ISD,11,spanish,5,0,,,,,0,,,,
23,50901,EVANT ISD,12,spanish,5,0,,,,,0,,,,
23,50910,COPPERAS COVE I,12,spanish,5,0,,,,,0,,,,
23,56901,DALHART ISD,16,spanish,5,0,,,,,0,,,,
23,57803,UPLIFT EDUCATIO,10,spanish,5,0,,,,,0,,,,
23,57807,LIFE SCHOOL,10,spanish,5,0,,,,,0,,,,
23,57808,UNIVERSAL ACADE,10,spanish,5,0,,,,,0,,,,
23,57810,ACADEMY OF DALL,10,spanish,5,0,,,,,0,,,,
23,57835,GOLDEN RULE CHA,10,spanish,5,0,,,,,0,,,,
23,57841,CITYSCAPE SCHOO,10,spanish,5,17,1,16,11,5,0,,,,
23,57846,LEGACY PREPARAT,10,spanish,5,0,,,,,0,,,,
23,57848,INTERNATIONAL L,10,spanish,5,50,18,32,11,2,50,29,21,5,1
23,57903,CARROLLTON-FARM,10,spanish,5,195,72,123,72,31,95,46,49,17,1
23,57904,CEDAR HILL ISD,10,spanish,5,0,,,,,0,,,,
23,57905,DALLAS ISD,10,spanish,5,3073,939,2134,1332,663,353,155,198,75,11
23,57906,DESOTO ISD,10,spanish,5,10,4,6,3,1,5,1,4,2,0
23,57907,DUNCANVILLE ISD,10,spanish,5,25,11,14,7,4,13,6,7,3,2
23,57909,GARLAND ISD,10,spanish,5,576,170,406,226,116,114,43,71,29,6
23,57910,GRAND PRAIRIE I,10,spanish,5,288,94,194,113,50,40,22,18,5,1
23,57912,IRVING ISD,10,spanish,5,180,103,77,24,5,164,90,74,21,2
23,57913,LANCASTER ISD,10,spanish,5,5,0,5,2,1,0,,,,
23,57914,MESQUITE ISD,10,spanish,5,149,63,86,37,12,106,55,51,21,5
23,57916,RICHARDSON ISD,10,spanish,5,40,24,16,9,1,36,18,18,4,0
23,57922,COPPELL ISD,10,spanish,5,8,2,6,5,1,9,5,4,4,1
23,61901,DENTON ISD,11,spanish,5,77,28,49,27,10,48,14,34,14,3
23,61902,LEWISVILLE ISD,11,spanish,5,137,56,81,35,9,130,68,62,26,2
23,61903,PILOT POINT ISD,11,spanish,5,0,,,,,0,,,,
23,61906,PONDER ISD,11,spanish,5,0,,,,,0,,,,
23,61911,NORTHWEST ISD,11,spanish,5,7,4,3,2,2,7,3,4,2,0
23,61914,LITTLE ELM ISD,11,spanish,5,19,11,8,1,0,6,6,0,0,0
23,68901,ECTOR COUNTY IS,18,spanish,5,152,62,90,41,11,114,51,63,29,6
23,70801,WAXAHACHIE FAIT,10,spanish,5,19,10,9,4,2,16,5,11,2,1
23,70903,ENNIS ISD,10,spanish,5,0,,,,,0,,,,
23,70905,FERRIS ISD,10,spanish,5,17,5,12,3,0,0,,,,
23,70908,MIDLOTHIAN ISD,10,spanish,5,0,,,,,0,,,,
23,70910,PALMER ISD,10,spanish,5,0,,,,,0,,,,
23,70911,RED OAK ISD,10,spanish,5,0,,,,,0,,,,
23,70912,WAXAHACHIE ISD,10,spanish,5,9,6,3,1,0,0,,,,
23,70915,MAYPEARL ISD,10,spanish,5,0,,,,,0,,,,
23,71801,BURNHAM WOOD CH,19,spanish,5,13,2,11,7,2,13,5,8,2,0
23,71806,HARMONY PUBLIC,19,spanish,5,16,6,10,5,0,14,7,7,1,0
23,71807,LA FE PREPARATO,19,spanish,5,14,7,7,5,1,14,0,14,12,5
23,71809,VISTA DEL FUTUR,19,spanish,5,7,2,5,2,1,7,1,6,3,0
23,71901,CLINT ISD,19,spanish,5,68,23,45,23,5,66,21,45,15,4
23,71902,EL PASO ISD,19,spanish,5,464,139,325,162,74,407,120,287,122,15
23,71903,FABENS ISD,19,spanish,5,29,9,20,9,3,22,3,19,13,0
23,71904,SAN ELIZARIO IS,19,spanish,5,25,11,14,9,3,0,,,,
23,71905,YSLETA ISD,19,spanish,5,131,58,73,30,12,91,43,48,21,5
23,71906,ANTHONY ISD,19,spanish,5,0,,,,,0,,,,
23,71907,CANUTILLO ISD,19,spanish,5,55,16,39,23,10,42,16,26,13,1
23,71908,TORNILLO ISD,19,spanish,5,14,3,11,7,4,0,,,,
23,71909,SOCORRO ISD,19,spanish,5,61,15,46,26,6,54,19,35,13,2
23,72902,DUBLIN ISD,11,spanish,5,0,,,,,0,,,,
23,72903,STEPHENVILLE IS,11,spanish,5,0,,,,,0,,,,
23,74903,BONHAM ISD,10,spanish,5,0,,,,,0,,,,
23,75901,FLATONIA ISD,13,spanish,5,0,,,,,0,,,,
23,79901,LAMAR CISD,4,spanish,5,49,12,37,16,6,32,10,22,8,3
23,79907,FORT BEND ISD,4,spanish,5,31,10,21,11,6,25,15,10,5,1
23,79910,STAFFORD MSD,4,spanish,5,0,,,,,0,,,,
23,80901,MOUNT VERNON IS,8,spanish,5,0,,,,,0,,,,
23,82903,PEARSALL ISD,20,spanish,5,0,,,,,0,,,,
23,83903,SEMINOLE ISD,17,spanish,5,0,,,,,0,,,,
23,84901,DICKINSON ISD,4,spanish,5,12,5,7,2,0,13,7,6,3,0
23,84902,GALVESTON ISD,4,spanish,5,23,14,9,3,0,22,9,13,2,0
23,84906,TEXAS CITY ISD,4,spanish,5,5,2,3,0,0,5,2,3,0,0
23,84908,HITCHCOCK ISD,4,spanish,5,0,,,,,0,,,,
23,84909,SANTA FE ISD,4,spanish,5,0,,,,,0,,,,
23,84910,CLEAR CREEK ISD,4,spanish,5,88,30,58,25,6,77,30,47,16,2
23,84911,FRIENDSWOOD ISD,4,spanish,5,0,,,,,0,,,,
23,86901,FREDERICKSBURG,13,spanish,5,0,,,,,0,,,,
23,90904,PAMPA ISD,16,spanish,5,0,,,,,0,,,,
23,91903,DENISON ISD,10,spanish,5,0,,,,,0,,,,
23,91905,HOWE ISD,10,spanish,5,0,,,,,0,,,,
23,91906,SHERMAN ISD,10,spanish,5,10,6,4,2,0,9,6,3,1,1
23,91910,WHITEWRIGHT ISD,10,spanish,5,0,,,,,0,,,,
23,91914,S AND S CISD,10,spanish,5,0,,,,,0,,,,
23,92902,KILGORE ISD,7,spanish,5,9,0,9,4,3,0,,,,
23,92903,LONGVIEW ISD,7,spanish,5,36,6,30,24,11,0,,,,
23,92904,PINE TREE ISD,7,spanish,5,0,,,,,0,,,,
23,93904,NAVASOTA ISD,6,spanish,5,0,,,,,0,,,,
23,94901,SEGUIN ISD,20,spanish,5,13,7,6,2,0,9,5,4,0,0
23,94902,SCHERTZ-CIBOLO-,20,spanish,5,8,1,7,3,2,5,1,4,0,0
23,95905,PLAINVIEW ISD,17,spanish,5,5,1,4,1,0,5,3,2,1,0
23,96904,MEMPHIS ISD,16,spanish,5,0,,,,,0,,,,
23,97902,HAMILTON ISD,12,spanish,5,0,,,,,0,,,,
23,98904,SPEARMAN ISD,16,spanish,5,0,,,,,0,,,,
23,101802,SER-NINOS CHART,4,spanish,5,13,1,12,6,0,12,2,10,4,0
23,101806,RAUL YZAGUIRRE,4,spanish,5,8,0,8,7,6,0,,,,
23,101814,THE VARNETT PUB,4,spanish,5,10,9,1,0,0,10,9,1,0,0
23,101828,HOUSTON GATEWAY,4,spanish,5,0,,,,,0,,,,
23,101838,SOUTHWEST SCHOO,4,spanish,5,7,3,4,1,1,5,2,3,0,0
23,101856,DRAW ACADEMY,4,spanish,5,0,,,,,0,,,,
23,101858,HARMONY PUBLIC,4,spanish,5,0,,,,,0,,,,
23,101859,STEP CHARTER SC,4,spanish,5,0,,,,,0,,,,
23,101861,THE RHODES SCHO,4,spanish,5,0,,,,,0,,,,
23,101902,ALDINE ISD,4,spanish,5,300,160,140,56,12,252,157,95,24,3
23,101903,ALIEF ISD,4,spanish,5,153,77,76,31,14,5,4,1,0,0
23,101905,CHANNELVIEW ISD,4,spanish,5,69,23,46,19,6,35,10,25,10,1
23,101906,CROSBY ISD,4,spanish,5,5,2,3,2,2,5,2,3,1,0
23,101907,CYPRESS-FAIRBAN,4,spanish,5,21,11,10,1,0,21,15,6,0,0
23,101910,GALENA PARK ISD,4,spanish,5,70,25,45,19,9,59,23,36,17,3
23,101911,GOOSE CREEK CIS,4,spanish,5,30,8,22,16,9,29,7,22,13,3
23,101912,HOUSTON ISD,4,spanish,5,912,422,490,228,75,879,373,506,239,67
23,101913,HUMBLE ISD,4,spanish,5,52,21,31,17,3,41,18,23,5,0
23,101914,KATY ISD,4,spanish,5,231,54,177,119,57,206,57,149,74,23
23,101915,KLEIN ISD,4,spanish,5,59,25,34,19,6,57,22,35,15,3
23,101916,LA PORTE ISD,4,spanish,5,0,,,,,0,,,,
23,101917,PASADENA ISD,4,spanish,5,58,35,23,11,5,51,27,24,6,0
23,101919,SPRING ISD,4,spanish,5,112,51,61,37,18,89,46,43,21,7
23,101920,SPRING BRANCH I,4,spanish,5,108,51,57,27,1,65,34,31,12,1
23,101921,TOMBALL ISD,4,spanish,5,35,6,29,20,10,15,3,12,8,1
23,101924,SHELDON ISD,4,spanish,5,16,12,4,1,0,12,8,4,1,1
23,101925,HUFFMAN ISD,4,spanish,5,0,,,,,5,3,2,0,0
23,102901,KARNACK ISD,7,spanish,5,0,,,,,0,,,,
23,102902,MARSHALL ISD,7,spanish,5,5,2,3,1,1,5,2,3,1,0
23,103902,HARTLEY ISD,16,spanish,5,0,,,,,0,,,,
23,105802,TEXAS PREPARATO,13,spanish,5,0,,,,,0,,,,
23,105902,SAN MARCOS CISD,13,spanish,5,24,10,14,4,3,6,4,2,2,0
23,105904,DRIPPING SPRING,13,spanish,5,0,,,,,0,,,,
23,105905,WIMBERLEY ISD,13,spanish,5,0,,,,,0,,,,
23,105906,HAYS CISD,13,spanish,5,31,14,17,7,3,29,13,16,3,1
23,107901,ATHENS ISD,10,spanish,5,0,,,,,0,,,,
23,107902,BROWNSBORO ISD,7,spanish,5,0,,,,,0,,,,
23,108802,HORIZON MONTESS,1,spanish,5,0,,,,,0,,,,
23,108807,IDEA PUBLIC SCH,1,spanish,5,41,16,25,15,1,36,18,18,7,0
23,108808,VANGUARD ACADEM,1,spanish,5,12,1,11,9,4,9,1,8,2,0
23,108902,DONNA ISD,1,spanish,5,155,101,54,23,14,44,19,25,9,1
23,108903,EDCOUCH-ELSA IS,1,spanish,5,0,,,,,0,,,,
23,108904,EDINBURG CISD,1,spanish,5,64,33,31,10,6,52,25,27,11,4
23,108905,HIDALGO ISD,1,spanish,5,57,19,38,24,5,21,10,11,7,4
23,108906,MCALLEN ISD,1,spanish,5,89,19,70,49,19,49,16,33,16,4
23,108907,MERCEDES ISD,1,spanish,5,17,4,13,3,0,6,2,4,1,0
23,108908,MISSION CISD,1,spanish,5,163,59,104,59,28,26,8,18,11,2
23,108909,PHARR-SAN JUAN-,1,spanish,5,244,74,170,98,55,37,8,29,20,3
23,108910,PROGRESO ISD,1,spanish,5,16,6,10,5,2,0,,,,
23,108911,SHARYLAND ISD,1,spanish,5,31,11,20,7,3,26,14,12,3,0
23,108912,LA JOYA ISD,1,spanish,5,601,240,361,178,69,27,9,18,6,4
23,108913,WESLACO ISD,1,spanish,5,10,1,9,4,2,5,1,4,3,1
23,108915,MONTE ALTO ISD,1,spanish,5,0,,,,,0,,,,
23,108916,VALLEY VIEW ISD,1,spanish,5,24,2,22,14,7,12,1,11,6,0
23,111901,GRANBURY ISD,11,spanish,5,5,4,1,1,1,0,,,,
23,112901,SULPHUR SPRINGS,8,spanish,5,0,,,,,0,,,,
23,114901,BIG SPRING ISD,18,spanish,5,0,,,,,0,,,,
23,115901,FT HANCOCK ISD,19,spanish,5,7,0,7,5,2,0,,,,
23,116901,CADDO MILLS ISD,10,spanish,5,0,,,,,0,,,,
23,116903,COMMERCE ISD,10,spanish,5,0,,,,,0,,,,
23,116905,GREENVILLE ISD,10,spanish,5,12,3,9,5,2,0,,,,
23,116915,BLAND ISD,10,spanish,5,0,,,,,0,,,,
23,116916,BOLES ISD,10,spanish,5,0,,,,,0,,,,
23,117901,BORGER ISD,16,spanish,5,0,,,,,0,,,,
23,120905,INDUSTRIAL ISD,3,spanish,5,0,,,,,0,,,,
23,121904,JASPER ISD,5,spanish,5,0,,,,,0,,,,
23,123807,BOB HOPE SCHOOL,5,spanish,5,11,2,9,5,4,9,3,6,3,0
23,123905,NEDERLAND ISD,5,spanish,5,7,3,4,1,0,7,4,3,0,0
23,123907,PORT ARTHUR ISD,5,spanish,5,17,7,10,4,0,17,8,9,3,2
23,123908,PORT NECHES-GRO,5,spanish,5,0,,,,,0,,,,
23,123910,BEAUMONT ISD,5,spanish,5,21,10,11,5,4,20,7,13,7,3
23,126901,ALVARADO ISD,11,spanish,5,12,6,6,1,0,0,,,,
23,126902,BURLESON ISD,11,spanish,5,0,,,,,0,,,,
23,126903,CLEBURNE ISD,11,spanish,5,19,10,9,4,2,12,2,10,7,1
23,126904,GRANDVIEW ISD,11,spanish,5,0,,,,,0,,,,
23,126908,VENUS ISD,11,spanish,5,5,3,2,1,1,5,3,2,1,0
23,126911,GODLEY ISD,11,spanish,5,0,,,,,0,,,,
23,127906,STAMFORD ISD,14,spanish,5,0,,,,,0,,,,
23,128901,KARNES CITY ISD,20,spanish,5,0,,,,,0,,,,
23,128902,KENEDY ISD,3,spanish,5,0,,,,,0,,,,
23,129901,CRANDALL ISD,10,spanish,5,6,5,1,0,0,5,3,2,0,0
23,129902,FORNEY ISD,10,spanish,5,18,7,11,7,1,12,5,7,1,0
23,129903,KAUFMAN ISD,10,spanish,5,0,,,,,0,,,,
23,129905,MABANK ISD,10,spanish,5,0,,,,,0,,,,
23,129906,TERRELL ISD,10,spanish,5,0,,,,,0,,,,
23,129910,SCURRY-ROSSER I,10,spanish,5,0,,,,,0,,,,
23,130901,BOERNE ISD,20,spanish,5,9,1,8,3,2,0,,,,
23,133901,CENTER POINT IS,20,spanish,5,0,,,,,0,,,,
23,133904,INGRAM ISD,20,spanish,5,0,,,,,0,,,,
23,139909,PARIS ISD,8,spanish,5,0,,,,,0,,,,
23,140904,LITTLEFIELD ISD,17,spanish,5,0,,,,,0,,,,
23,144902,LEXINGTON ISD,13,spanish,5,0,,,,,0,,,,
23,145911,LEON ISD,6,spanish,5,0,,,,,0,,,,
23,146901,CLEVELAND ISD,4,spanish,5,43,27,16,3,0,26,21,5,1,0
23,146902,DAYTON ISD,4,spanish,5,5,3,2,1,1,5,2,3,0,0
23,146906,LIBERTY ISD,5,spanish,5,0,,,,,0,,,,
23,147901,COOLIDGE ISD,12,spanish,5,0,,,,,0,,,,
23,147903,MEXIA ISD,12,spanish,5,0,,,,,0,,,,
23,152901,LUBBOCK ISD,17,spanish,5,60,16,44,22,9,33,13,20,11,5
23,152906,LUBBOCK-COOPER,17,spanish,5,10,2,8,6,3,0,,,,
23,152907,FRENSHIP ISD,17,spanish,5,15,5,10,6,2,0,,,,
23,152908,ROOSEVELT ISD,17,spanish,5,0,,,,,0,,,,
23,154901,MADISONVILLE CI,6,spanish,5,0,,,,,0,,,,
23,157901,MASON ISD,15,spanish,5,0,,,,,0,,,,
23,158902,TIDEHAVEN ISD,3,spanish,5,0,,,,,0,,,,
23,158905,PALACIOS ISD,3,spanish,5,0,,,,,0,,,,
23,159901,EAGLE PASS ISD,20,spanish,5,39,14,25,13,3,38,12,26,12,2
23,161807,HARMONY PUBLIC,12,spanish,5,8,4,4,1,0,7,3,4,1,0
23,161906,LA VEGA ISD,12,spanish,5,0,,,,,0,,,,
23,161914,WACO ISD,12,spanish,5,14,8,6,3,2,15,6,9,3,1
23,161921,CONNALLY ISD,12,spanish,5,0,,,,,0,,,,
23,163901,DEVINE ISD,20,spanish,5,0,,,,,0,,,,
23,163908,MEDINA VALLEY I,20,spanish,5,0,,,,,0,,,,
23,165901,MIDLAND ISD,18,spanish,5,78,25,53,31,8,78,44,34,14,1
23,165902,GREENWOOD ISD,18,spanish,5,0,,,,,0,,,,
23,169902,NOCONA ISD,9,spanish,5,0,,,,,0,,,,
23,170902,CONROE ISD,6,spanish,5,171,73,98,53,12,149,60,89,29,7
23,170903,MONTGOMERY ISD,6,spanish,5,0,,,,,0,,,,
23,170904,WILLIS ISD,6,spanish,5,6,3,3,1,1,5,4,1,0,0
23,170906,MAGNOLIA ISD,6,spanish,5,14,2,12,6,0,11,4,7,4,0
23,170907,SPLENDORA ISD,6,spanish,5,5,4,1,1,0,5,3,2,1,0
23,170908,NEW CANEY ISD,6,spanish,5,56,25,31,13,6,48,21,27,10,1
23,174904,NACOGDOCHES ISD,7,spanish,5,0,,,,,0,,,,
23,175903,CORSICANA ISD,12,spanish,5,5,3,2,0,0,0,,,,
23,175905,FROST ISD,12,spanish,5,0,,,,,0,,,,
23,175911,RICE ISD,12,spanish,5,0,,,,,0,,,,
23,177901,ROSCOE COLLEGIA,14,spanish,5,0,,,,,0,,,,
23,178904,CORPUS CHRISTI,2,spanish,5,21,4,17,7,1,20,5,15,7,0
23,178912,TULOSO-MIDWAY I,2,spanish,5,0,,,,,0,,,,
23,178914,FLOUR BLUFF ISD,2,spanish,5,0,,,,,0,,,,
23,181901,BRIDGE CITY ISD,5,spanish,5,0,,,,,0,,,,
23,181908,LITTLE CYPRESS-,5,spanish,5,0,,,,,0,,,,
23,182902,GRAFORD ISD,11,spanish,5,0,,,,,0,,,,
23,182903,MINERAL WELLS I,11,spanish,5,0,,,,,0,,,,
23,184902,SPRINGTOWN ISD,11,spanish,5,0,,,,,0,,,,
23,184903,WEATHERFORD ISD,11,spanish,5,7,5,2,0,0,5,4,1,0,0
23,184907,ALEDO ISD,11,spanish,5,0,,,,,0,,,,
23,185904,LAZBUDDIE ISD,16,spanish,5,0,,,,,0,,,,
23,187907,LIVINGSTON ISD,6,spanish,5,0,,,,,0,,,,
23,188901,AMARILLO ISD,16,spanish,5,97,19,78,48,24,11,3,8,5,0
23,189902,PRESIDIO ISD,18,spanish,5,0,,,,,0,,,,
23,190903,RAINS ISD,7,spanish,5,0,,,,,0,,,,
23,192901,REAGAN COUNTY I,18,spanish,5,0,,,,,0,,,,
23,195901,PECOS-BARSTOW-T,18,spanish,5,13,4,9,5,3,13,1,12,7,2
23,199901,ROCKWALL ISD,10,spanish,5,0,,,,,0,,,,
23,199902,ROYSE CITY ISD,10,spanish,5,0,,,,,0,,,,
23,201913,CARLISLE ISD,7,spanish,5,0,,,,,0,,,,
23,205901,ARANSAS PASS IS,2,spanish,5,0,,,,,0,,,,
23,205902,GREGORY-PORTLAN,2,spanish,5,0,,,,,0,,,,
23,205903,INGLESIDE ISD,2,spanish,5,0,,,,,0,,,,
23,205904,MATHIS ISD,2,spanish,5,0,,,,,0,,,,
23,208902,SNYDER ISD,14,spanish,5,7,6,1,1,0,0,,,,
23,209901,ALBANY ISD,14,spanish,5,0,,,,,0,,,,
23,210901,CENTER ISD,7,spanish,5,0,,,,,0,,,,
23,212801,CUMBERLAND ACAD,7,spanish,5,0,,,,,0,,,,
23,212905,TYLER ISD,7,spanish,5,86,26,60,39,24,15,8,7,4,2
23,212909,CHAPEL HILL ISD,7,spanish,5,15,4,11,4,2,0,,,,
23,213901,GLEN ROSE ISD,11,spanish,5,0,,,,,0,,,,
23,214901,RIO GRANDE CITY,1,spanish,5,18,7,11,4,2,14,4,10,8,2
23,214903,ROMA ISD,1,spanish,5,12,3,9,8,0,9,0,9,6,1
23,220815,CHAPEL HILL ACA,11,spanish,5,0,,,,,0,,,,
23,220901,ARLINGTON ISD,11,spanish,5,176,83,93,35,5,148,89,59,20,4
23,220902,BIRDVILLE ISD,11,spanish,5,48,21,27,14,4,33,22,11,6,0
23,220904,EVERMAN ISD,11,spanish,5,18,8,10,4,1,6,3,3,0,0
23,220905,FORT WORTH ISD,11,spanish,5,279,148,131,56,18,99,60,39,14,3
23,220906,GRAPEVINE-COLLE,11,spanish,5,0,,,,,0,,,,
23,220907,KELLER ISD,11,spanish,5,58,12,46,26,11,6,3,3,2,0
23,220908,MANSFIELD ISD,11,spanish,5,17,6,11,4,0,13,6,7,2,0
23,220910,LAKE WORTH ISD,11,spanish,5,18,9,9,4,2,0,,,,
23,220912,CROWLEY ISD,11,spanish,5,68,19,49,30,14,5,3,2,1,0
23,220914,KENNEDALE ISD,11,spanish,5,0,,,,,0,,,,
23,220915,AZLE ISD,11,spanish,5,0,,,,,0,,,,
23,220916,HURST-EULESS-BE,11,spanish,5,17,4,13,8,2,15,4,11,7,1
23,220917,CASTLEBERRY ISD,11,spanish,5,17,6,11,4,0,0,,,,
23,220918,EAGLE MT-SAGINA,11,spanish,5,18,9,9,4,1,5,4,1,1,0
23,220920,WHITE SETTLEMEN,11,spanish,5,39,25,14,8,1,15,10,5,0,0
23,221801,TEXAS COLLEGE P,14,spanish,5,8,0,8,2,1,0,,,,
23,221901,ABILENE ISD,14,spanish,5,23,10,13,8,5,19,7,12,3,1
23,223901,BROWNFIELD ISD,17,spanish,5,0,,,,,0,,,,
23,225902,MOUNT PLEASANT,8,spanish,5,109,30,79,52,20,8,5,3,0,0
23,225907,HARTS BLUFF ISD,8,spanish,5,0,,,,,0,,,,
23,226903,SAN ANGELO ISD,15,spanish,5,0,,,,,0,,,,
23,226906,WALL ISD,15,spanish,5,0,,,,,0,,,,
23,227803,WAYSIDE SCHOOLS,13,spanish,5,5,2,3,2,0,0,,,,
23,227816,HARMONY PUBLIC,13,spanish,5,8,3,5,1,0,8,3,5,1,0
23,227820,KIPP TEXAS PUBL,4,spanish,5,39,25,14,3,0,36,27,9,2,0
23,227824,VALERE PUBLIC S,13,spanish,5,0,,,,,0,,,,
23,227901,AUSTIN ISD,13,spanish,5,576,287,289,125,48,303,189,114,23,4
23,227904,PFLUGERVILLE IS,13,spanish,5,155,57,98,53,26,70,18,52,18,5
23,227907,MANOR ISD,13,spanish,5,45,26,19,9,0,35,26,9,2,0
23,227910,DEL VALLE ISD,13,spanish,5,260,100,160,75,29,55,35,20,2,1
23,227912,LAGO VISTA ISD,13,spanish,5,0,,,,,0,,,,
23,227913,LAKE TRAVIS ISD,13,spanish,5,37,17,20,11,2,7,6,1,0,0
23,228901,GROVETON ISD,6,spanish,5,0,,,,,0,,,,
23,230902,GILMER ISD,7,spanish,5,0,,,,,0,,,,
23,230905,HARMONY ISD,7,spanish,5,0,,,,,0,,,,
23,232903,UVALDE CISD,20,spanish,5,18,8,10,3,1,20,7,13,4,1
23,233901,SAN FELIPE-DEL,15,spanish,5,0,,,,,0,,,,
23,234902,CANTON ISD,10,spanish,5,0,,,,,0,,,,
23,234907,WILLS POINT ISD,10,spanish,5,0,,,,,0,,,,
23,235902,VICTORIA ISD,3,spanish,5,12,2,10,5,2,12,2,10,5,0
23,236902,HUNTSVILLE ISD,6,spanish,5,0,,,,,0,,,,
23,237902,HEMPSTEAD ISD,4,spanish,5,0,,,,,0,,,,
23,237904,WALLER ISD,4,spanish,5,10,6,4,2,1,10,4,6,2,0
23,237905,ROYAL ISD,4,spanish,5,0,,,,,0,,,,
23,238902,MONAHANS-WICKET,18,spanish,5,5,2,3,1,1,5,4,1,0,0
23,239901,BRENHAM ISD,6,spanish,5,0,,,,,0,,,,
23,240901,LAREDO ISD,1,spanish,5,49,23,26,15,6,44,19,25,12,4
23,240903,UNITED ISD,1,spanish,5,54,23,31,19,7,46,20,26,10,1
23,241901,BOLING ISD,3,spanish,5,0,,,,,0,,,,
23,241902,EAST BERNARD IS,3,spanish,5,0,,,,,0,,,,
23,241904,WHARTON ISD,3,spanish,5,0,,,,,0,,,,
23,243905,WICHITA FALLS I,9,spanish,5,0,,,,,0,,,,
23,244903,VERNON ISD,9,spanish,5,0,,,,,0,,,,
23,246902,FLORENCE ISD,13,spanish,5,0,,,,,0,,,,
23,246904,GEORGETOWN ISD,13,spanish,5,30,18,12,8,2,20,14,6,2,0
23,246906,HUTTO ISD,13,spanish,5,28,6,22,17,9,0,,,,
23,246907,JARRELL ISD,13,spanish,5,0,,,,,0,,,,
23,246908,LIBERTY HILL IS,13,spanish,5,0,,,,,0,,,,
23,246909,ROUND ROCK ISD,13,spanish,5,109,53,56,32,11,87,52,35,15,3
23,246911,TAYLOR ISD,13,spanish,5,0,,,,,0,,,,
23,246913,LEANDER ISD,13,spanish,5,46,20,26,14,7,22,7,15,6,0
23,247901,FLORESVILLE ISD,20,spanish,5,6,2,4,0,0,0,,,,
23,247903,LA VERNIA ISD,20,spanish,5,0,,,,,0,,,,
23,248901,KERMIT ISD,18,spanish,5,0,,,,,0,,,,
23,249901,ALVORD ISD,11,spanish,5,0,,,,,0,,,,
23,249903,BRIDGEPORT ISD,11,spanish,5,10,7,3,1,0,0,,,,
23,249905,DECATUR ISD,11,spanish,5,0,,,,,0,,,,
23,251901,DENVER CITY ISD,17,spanish,5,0,,,,,0,,,,
23,252901,GRAHAM ISD,9,spanish,5,0,,,,,0,,,,
23,252903,OLNEY ISD,9,spanish,5,0,,,,,0,,,,
23,253901,ZAPATA COUNTY I,1,spanish,5,0,,,,,0,,,,
23,1902,CAYUGA ISD,7,english,6,50,4,46,32,15,49,7,42,30,10
23,1903,ELKHART ISD,7,english,6,81,14,67,50,22,80,11,69,40,13
23,1904,FRANKSTON ISD,7,english,6,51,10,41,25,10,51,4,47,23,9
23,1906,NECHES ISD,7,english,6,24,3,21,15,2,24,4,20,12,3
23,1907,PALESTINE ISD,7,english,6,207,65,142,83,23,207,32,175,94,32
23,1908,WESTWOOD ISD,7,english,6,94,28,66,37,10,95,20,75,31,7
23,1909,SLOCUM ISD,7,english,6,27,3,24,19,9,27,2,25,9,0
23,2901,ANDREWS ISD,18,english,6,304,78,226,129,43,303,73,230,100,41
23,3801,PINEYWOODS COMM,7,english,6,77,13,64,47,23,77,10,67,46,22
23,3902,HUDSON ISD,7,english,6,222,41,181,118,54,222,25,197,128,58
23,3903,LUFKIN ISD,7,english,6,448,122,326,202,89,452,128,324,178,78
23,3904,HUNTINGTON ISD,7,english,6,136,42,94,68,28,136,21,115,66,20
23,3905,DIBOLL ISD,7,english,6,112,24,88,53,17,112,24,88,34,6
23,3906,ZAVALLA ISD,7,english,6,26,8,18,12,5,26,9,17,10,2
23,3907,CENTRAL ISD,7,english,6,111,28,83,49,12,111,27,84,45,15
23,4901,ARANSAS COUNTY,2,english,6,222,59,163,99,29,223,66,157,57,12
23,5901,ARCHER CITY ISD,9,english,6,29,0,29,28,19,29,0,29,27,14
23,5902,HOLLIDAY ISD,9,english,6,87,19,68,54,29,87,14,73,47,13
23,5904,WINDTHORST ISD,9,english,6,45,2,43,36,22,45,1,44,32,16
23,6902,CLAUDE ISD,16,english,6,25,4,21,16,6,25,6,19,12,7
23,7901,CHARLOTTE ISD,20,english,6,25,11,14,8,3,25,10,15,6,2
23,7902,JOURDANTON ISD,20,english,6,119,25,94,61,29,120,28,92,46,22
23,7904,LYTLE ISD,20,english,6,110,32,78,44,11,111,29,82,25,4
23,7905,PLEASANTON ISD,20,english,6,261,85,176,116,36,266,84,182,69,16
23,7906,POTEET ISD,20,english,6,137,59,78,39,9,137,60,77,15,6
23,8901,BELLVILLE ISD,6,english,6,168,39,129,89,48,169,52,117,68,23
23,8902,SEALY ISD,6,english,6,207,64,143,85,23,207,59,148,58,18
23,8903,BRAZOS ISD,6,english,6,62,8,54,43,17,62,8,54,33,6
23,9901,MULESHOE ISD,17,english,6,98,37,61,39,13,99,49,50,19,3
23,10901,MEDINA ISD,20,english,6,14,2,12,9,1,14,2,12,4,0
23,10902,BANDERA ISD,20,english,6,172,45,127,82,29,159,31,128,47,15
23,11901,BASTROP ISD,13,english,6,909,409,500,257,84,897,403,494,193,59
23,11902,ELGIN ISD,13,english,6,358,96,262,141,33,356,141,215,54,7
23,11904,SMITHVILLE ISD,13,english,6,133,19,114,74,28,133,41,92,37,10
23,11905,MCDADE ISD,13,english,6,27,6,21,11,1,27,5,22,13,3
23,12901,SEYMOUR ISD,9,english,6,44,5,39,29,14,44,3,41,27,12
23,13801,ST MARY'S ACADE,2,english,6,33,7,26,13,0,33,8,25,14,2
23,13901,BEEVILLE ISD,2,english,6,186,58,128,71,29,186,62,124,47,14
23,13902,PAWNEE ISD,2,english,6,13,6,7,4,1,13,7,6,3,0
23,13903,PETTUS ISD,2,english,6,35,16,19,8,0,35,24,11,2,0
23,13905,SKIDMORE-TYNAN,2,english,6,56,15,41,25,8,56,22,34,17,4
23,14803,PRIORITY CHARTE,12,english,6,46,12,34,19,8,45,13,32,12,2
23,14804,ORENDA CHARTER,12,english,6,175,8,167,135,72,173,13,160,99,48
23,14901,ACADEMY ISD,12,english,6,126,15,111,81,24,125,14,111,75,28
23,14902,BARTLETT ISD,13,english,6,29,13,16,6,0,29,18,11,5,0
23,14903,BELTON ISD,12,english,6,1000,246,754,488,180,1001,284,717,332,113
23,14905,HOLLAND ISD,12,english,6,47,6,41,27,11,47,1,46,32,12
23,14906,KILLEEN ISD,12,english,6,2926,851,2075,1172,358,2927,933,1994,751,212
23,14907,ROGERS ISD,12,english,6,55,4,51,38,18,56,8,48,35,16
23,14908,SALADO ISD,12,english,6,194,33,161,114,53,195,38,157,97,43
23,14909,TEMPLE ISD,12,english,6,600,219,381,219,71,598,208,390,157,53
23,14910,TROY ISD,12,english,6,114,24,90,67,30,98,22,76,40,8
23,15802,GEORGE GERVIN A,20,english,6,21,6,15,7,2,21,10,11,5,0
23,15806,LEGACY TRADITIO,20,english,6,78,23,55,32,11,76,23,53,10,3
23,15807,SOUTHWEST PREPA,20,english,6,72,35,37,14,5,73,32,41,15,1
23,15808,INSPIRE ACADEMI,20,english,6,48,19,29,21,2,46,21,25,6,0
23,15809,BEXAR COUNTY AC,20,english,6,16,9,7,1,0,17,9,8,0,0
23,15815,HERITAGE ACADEM,20,english,6,65,21,44,26,14,65,21,44,22,8
23,15822,JUBILEE ACADEMI,20,english,6,498,210,288,159,49,497,202,295,86,21
23,15825,LIGHTHOUSE PUBL,20,english,6,31,17,14,5,0,31,23,8,1,0
23,15827,SCHOOL OF SCIEN,20,english,6,442,74,368,282,131,442,74,368,216,98
23,15828,HARMONY PUBLIC,20,english,6,468,132,336,208,81,466,140,326,146,50
23,15830,BROOKS ACADEMIE,20,english,6,251,82,169,82,18,253,111,142,33,4
23,15831,SCHOOL OF SCIEN,20,english,6,555,75,480,355,150,557,65,492,278,112
23,15834,BASIS TEXAS,20,english,6,461,11,450,409,287,390,15,375,308,198
23,15835,GREAT HEARTS TE,20,english,6,1007,90,917,691,297,1007,154,853,494,172
23,15836,ELEANOR KOLITZ,20,english,6,62,3,59,49,40,62,8,54,33,12
23,15838,COMPASS ROSE PU,20,english,6,300,121,179,96,28,299,126,173,49,14
23,15840,SAN ANTONIO PRE,20,english,6,30,9,21,11,2,28,16,12,2,0
23,15901,ALAMO HEIGHTS I,20,english,6,351,38,313,241,120,348,52,296,183,71
23,15904,HARLANDALE ISD,20,english,6,838,351,487,224,54,837,350,487,139,27
23,15905,EDGEWOOD ISD,20,english,6,501,256,245,109,24,500,256,244,73,17
23,15906,RANDOLPH FIELD,20,english,6,117,10,107,83,35,116,10,106,60,20
23,15907,SAN ANTONIO ISD,20,english,6,2813,1236,1577,846,262,2798,1304,1494,488,121
23,15908,SOUTH SAN ANTON,20,english,6,509,258,251,122,35,505,248,257,64,14
23,15909,SOMERSET ISD,20,english,6,277,47,230,150,49,275,52,223,126,42
23,15910,NORTH EAST ISD,20,english,6,4132,996,3136,2131,936,4118,951,3167,1668,701
23,15911,EAST CENTRAL IS,20,english,6,711,238,473,232,66,707,279,428,127,30
23,15912,SOUTHWEST ISD,20,english,6,937,322,615,362,107,940,379,561,173,39
23,15913,LACKLAND ISD,20,english,6,67,8,59,40,14,67,9,58,34,11
23,15914,FT SAM HOUSTON,20,english,6,108,6,102,81,32,108,9,99,76,45
23,15915,NORTHSIDE ISD,20,english,6,7141,1774,5367,3479,1285,7112,2003,5109,2225,584
23,15916,JUDSON ISD,20,english,6,1570,537,1033,591,177,1562,586,976,305,68
23,15917,SOUTHSIDE ISD,20,english,6,355,130,225,121,38,353,115,238,101,27
23,16901,JOHNSON CITY IS,13,english,6,50,7,43,31,16,50,15,35,14,1
23,16902,BLANCO ISD,13,english,6,82,16,66,38,14,82,14,68,42,15
23,17901,BORDEN COUNTY I,17,english,6,15,1,14,10,6,15,1,14,10,1
23,18901,CLIFTON ISD,12,english,6,85,15,70,40,16,85,17,68,35,13
23,18902,MERIDIAN ISD,12,english,6,22,12,10,8,0,22,8,14,4,1
23,18903,MORGAN ISD,12,english,6,9,2,7,2,1,9,1,8,2,0
23,18904,VALLEY MILLS IS,12,english,6,44,17,27,13,5,44,14,30,12,0
23,18905,WALNUT SPRINGS,12,english,6,7,4,3,3,0,7,4,3,0,0
23,18906,IREDELL ISD,12,english,6,7,1,6,3,0,7,2,5,0,0
23,18907,KOPPERL ISD,12,english,6,12,6,6,2,1,12,6,6,2,1
23,18908,CRANFILLS GAP I,12,english,6,8,1,7,6,2,8,1,7,5,1
23,19901,DEKALB ISD,8,english,6,60,16,44,18,3,62,19,43,17,1
23,19902,HOOKS ISD,8,english,6,72,9,63,42,22,72,8,64,41,9
23,19903,MAUD ISD,8,english,6,32,2,30,22,8,33,6,27,18,5
23,19905,NEW BOSTON ISD,8,english,6,65,21,44,28,7,65,18,47,16,2
23,19906,REDWATER ISD,8,english,6,75,7,68,47,21,75,6,69,39,12
23,19907,TEXARKANA ISD,8,english,6,482,172,310,196,77,445,173,272,82,19
23,19908,LIBERTY-EYLAU I,8,english,6,150,66,84,39,8,150,71,79,28,8
23,19909,SIMMS ISD,8,english,6,42,6,36,23,6,42,5,37,20,5
23,19910,MALTA ISD,8,english,6,18,0,18,14,7,18,0,18,14,8
23,19911,RED LICK ISD,8,english,6,47,3,44,37,19,47,7,40,20,5
23,19912,PLEASANT GROVE,8,english,6,154,15,139,119,56,153,23,130,78,28
23,19913,HUBBARD ISD,8,english,6,0,,,,,0,,,,
23,19914,LEARY ISD,8,english,6,6,1,5,5,2,6,1,5,2,0
23,20901,ALVIN ISD,4,english,6,2105,365,1740,1232,549,2104,445,1659,919,357
23,20902,ANGLETON ISD,4,english,6,498,118,380,240,96,498,120,378,191,57
23,20904,DANBURY ISD,4,english,6,44,10,34,23,4,44,3,41,30,17
23,20905,BRAZOSPORT ISD,4,english,6,796,221,575,352,134,792,212,580,261,80
23,20906,SWEENY ISD,4,english,6,145,41,104,69,13,144,38,106,47,10
23,20907,COLUMBIA-BRAZOR,4,english,6,205,58,147,91,38,206,40,166,82,30
23,20908,PEARLAND ISD,4,english,6,1645,185,1460,1193,703,1654,181,1473,1046,588
23,20910,DAMON ISD,4,english,6,9,3,6,3,3,9,1,8,3,1
23,21803,BRAZOS SCHOOL F,6,english,6,14,1,13,9,2,14,0,14,8,2
23,21805,ARROW ACADEMY,6,english,6,78,18,60,34,9,78,19,59,20,4
23,21901,COLLEGE STATION,6,english,6,1053,204,849,591,287,1045,195,850,540,274
23,21902,BRYAN ISD,6,english,6,1068,393,675,373,151,1067,391,676,301,106
23,22004,TERLINGUA CSD,18,english,6,8,5,3,2,0,8,4,4,0,0
23,22901,ALPINE ISD,18,english,6,54,9,45,24,8,54,10,44,23,5
23,22902,MARATHON ISD,18,english,6,0,,,,,0,,,,
23,23902,SILVERTON ISD,16,english,6,16,2,14,8,2,16,2,14,11,5
23,24901,BROOKS COUNTY I,1,english,6,87,30,57,29,7,84,48,36,5,0
23,25901,BANGS ISD,15,english,6,66,14,52,32,19,65,12,53,21,3
23,25902,BROWNWOOD ISD,15,english,6,232,55,177,114,36,231,61,170,94,47
23,25904,BLANKET ISD,15,english,6,15,1,14,10,2,15,7,8,6,4
23,25905,MAY ISD,15,english,6,8,1,7,5,1,8,0,8,3,2
23,25906,ZEPHYR ISD,15,english,6,16,7,9,4,3,16,8,8,2,1
23,25908,BROOKESMITH ISD,15,english,6,22,6,16,7,0,22,8,14,5,0
23,25909,EARLY ISD,15,english,6,73,10,63,34,10,73,10,63,38,15
23,26901,CALDWELL ISD,6,english,6,136,41,95,63,20,135,28,107,48,18
23,26902,SOMERVILLE ISD,6,english,6,32,16,16,6,1,33,16,17,6,1
23,26903,SNOOK ISD,6,english,6,40,13,27,20,6,40,8,32,16,8
23,27903,BURNET CISD,13,english,6,237,69,168,111,41,237,61,176,70,19
23,27904,MARBLE FALLS IS,13,english,6,269,98,171,103,35,269,106,163,69,21
23,28902,LOCKHART ISD,13,english,6,463,171,292,155,44,233,146,87,6,0
23,28903,LULING ISD,13,english,6,103,44,59,32,11,101,43,58,21,3
23,28906,PRAIRIE LEA ISD,13,english,6,19,15,4,3,0,19,13,6,0,0
23,29901,CALHOUN COUNTY,3,english,6,266,74,192,119,44,266,76,190,75,23
23,30901,CROSS PLAINS IS,14,english,6,18,1,17,11,6,18,1,17,12,4
23,30902,CLYDE CISD,14,english,6,100,15,85,57,16,100,15,85,43,11
23,30903,BAIRD ISD,14,english,6,17,6,11,4,0,17,3,14,3,1
23,30906,EULA ISD,14,english,6,33,2,31,23,12,33,5,28,16,6
23,31901,BROWNSVILLE ISD,1,english,6,2465,625,1840,1274,523,2473,678,1795,780,228
23,31903,HARLINGEN CISD,1,english,6,1214,308,906,549,171,1210,419,791,272,59
23,31905,LA FERIA ISD,1,english,6,190,45,145,90,23,190,48,142,65,19
23,31906,LOS FRESNOS CIS,1,english,6,746,158,588,416,173,748,164,584,298,104
23,31909,POINT ISABEL IS,1,english,6,130,24,106,70,21,131,45,86,30,7
23,31911,RIO HONDO ISD,1,english,6,110,34,76,40,8,108,30,78,20,1
23,31912,SAN BENITO CISD,1,english,6,533,225,308,123,24,633,267,366,92,16
23,31913,SANTA MARIA ISD,1,english,6,46,17,29,10,1,46,13,33,3,2
23,31914,SANTA ROSA ISD,1,english,6,70,22,48,25,8,69,24,45,14,1
23,31916,SOUTH TEXAS ISD,1,english,6,374,14,360,326,205,374,19,355,283,175
23,32902,PITTSBURG ISD,8,english,6,152,6,146,113,35,152,5,147,111,41
23,33901,GROOM ISD,16,english,6,14,0,14,12,5,14,0,14,5,1
23,33902,PANHANDLE ISD,16,english,6,43,6,37,29,16,43,4,39,32,23
23,33904,WHITE DEER ISD,16,english,6,28,3,25,15,3,28,4,24,11,3
23,34901,ATLANTA ISD,8,english,6,121,26,95,61,16,120,40,80,26,9
23,34902,AVINGER ISD,8,english,6,6,0,6,3,2,6,1,5,2,0
23,34903,HUGHES SPRINGS,8,english,6,91,17,74,51,21,91,14,77,37,7
23,34905,LINDEN-KILDARE,8,english,6,39,12,27,15,4,38,11,27,16,2
23,34906,MCLEOD ISD,8,english,6,28,2,26,16,6,28,4,24,7,1
23,34907,QUEEN CITY ISD,8,english,6,73,22,51,32,8,74,28,46,14,7
23,34909,BLOOMBURG ISD,8,english,6,19,3,16,11,3,19,6,13,1,1
23,35901,DIMMITT ISD,16,english,6,92,46,46,23,2,92,44,48,9,2
23,35902,HART ISD,16,english,6,9,1,8,5,1,9,1,8,5,0
23,35903,NAZARETH ISD,16,english,6,15,0,15,12,9,15,0,15,11,5
23,36901,ANAHUAC ISD,4,english,6,104,30,74,43,4,109,28,81,33,12
23,36902,BARBERS HILL IS,4,english,6,571,63,508,408,201,570,55,515,379,209
23,36903,EAST CHAMBERS I,5,english,6,126,29,97,64,21,127,32,95,40,6
23,37901,ALTO ISD,7,english,6,36,6,30,22,10,37,3,34,25,11
23,37904,JACKSONVILLE IS,7,english,6,340,130,210,121,35,342,141,201,67,18
23,37907,RUSK ISD,7,english,6,135,31,104,74,26,135,24,111,46,10
23,37908,NEW SUMMERFIELD,7,english,6,34,5,29,13,4,34,6,28,10,1
23,37909,WELLS ISD,7,english,6,12,3,9,5,1,12,3,9,5,1
23,38901,CHILDRESS ISD,16,english,6,69,12,57,37,12,69,11,58,38,15
23,39902,HENRIETTA ISD,9,english,6,74,16,58,33,10,74,14,60,18,1
23,39903,PETROLIA CISD,9,english,6,37,10,27,15,3,37,5,32,15,5
23,39904,BELLEVUE ISD,9,english,6,7,1,6,5,2,7,0,7,5,2
23,39905,MIDWAY ISD,9,english,6,7,0,7,5,2,7,0,7,4,0
23,40901,MORTON ISD,17,english,6,27,19,8,4,1,27,10,17,2,0
23,40902,WHITEFACE CISD,17,english,6,26,3,23,11,1,26,8,18,3,0
23,41901,BRONTE ISD,15,english,6,10,1,9,7,3,10,0,10,5,2
23,41902,ROBERT LEE ISD,15,english,6,27,2,25,21,11,27,5,22,13,1
23,42901,COLEMAN ISD,15,english,6,61,17,44,33,9,61,18,43,24,12
23,42903,SANTA ANNA ISD,15,english,6,18,5,13,6,3,18,6,12,3,0
23,42905,PANTHER CREEK C,15,english,6,11,1,10,8,4,11,2,9,4,2
23,43801,IMAGINE INTERNA,10,english,6,153,1,152,140,102,152,4,148,123,79
23,43901,ALLEN ISD,10,english,6,1618,124,1494,1275,780,1616,115,1501,1177,720
23,43902,ANNA ISD,10,english,6,371,85,286,172,61,372,115,257,93,27
23,43903,CELINA ISD,10,english,6,320,29,291,221,100,301,39,262,151,58
23,43904,FARMERSVILLE IS,10,english,6,138,31,107,65,21,137,23,114,58,15
23,43905,FRISCO ISD,10,english,6,5189,368,4821,4162,2661,4973,405,4568,3358,1945
23,43907,MCKINNEY ISD,10,english,6,1648,232,1416,1101,540,1643,196,1447,971,480
23,43908,MELISSA ISD,10,english,6,413,21,392,331,195,399,40,359,243,74
23,43910,PLANO ISD,10,english,6,3470,636,2834,2268,1333,3262,643,2619,1704,884
23,43911,PRINCETON ISD,10,english,6,600,119,481,323,135,595,123,472,275,119
23,43912,PROSPER ISD,10,english,6,2015,167,1848,1481,806,1995,178,1817,1177,527
23,43914,WYLIE ISD,10,english,6,1441,155,1286,1031,562,1442,153,1289,916,482
23,43917,BLUE RIDGE ISD,10,english,6,70,16,54,37,9,70,26,44,12,2
23,43918,COMMUNITY ISD,10,english,6,345,90,255,148,42,343,98,245,119,29
23,43919,LOVEJOY ISD,10,english,6,342,5,337,313,214,321,7,314,278,197
23,44902,WELLINGTON ISD,16,english,6,44,5,39,28,12,44,18,26,6,0
23,45902,COLUMBUS ISD,4,english,6,106,32,74,49,22,106,35,71,24,8
23,45903,RICE CISD,3,english,6,93,32,61,35,17,93,40,53,20,3
23,45905,WEIMAR ISD,3,english,6,50,9,41,29,12,50,7,43,23,9
23,46802,TRINITY CHARTER,20,english,6,18,13,5,3,1,17,12,5,0,0
23,46901,NEW BRAUNFELS I,20,english,6,714,137,577,408,151,714,130,584,327,93
23,46902,COMAL ISD,20,english,6,2236,285,1951,1484,722,2231,281,1950,1212,485
23,47901,COMANCHE ISD,14,english,6,100,18,82,57,20,100,24,76,25,4
23,47902,DE LEON ISD,14,english,6,51,7,44,32,10,51,6,45,22,12
23,47903,GUSTINE ISD,14,english,6,13,5,8,4,2,13,7,6,3,1
23,47905,SIDNEY ISD,14,english,6,6,0,6,4,1,6,0,6,1,1
23,48901,EDEN CISD,15,english,6,15,7,8,4,3,15,5,10,5,3
23,48903,PAINT ROCK ISD,15,english,6,19,5,14,5,1,19,5,14,6,2
23,49901,GAINESVILLE ISD,11,english,6,201,80,121,53,9,202,58,144,61,12
23,49902,MUENSTER ISD,11,english,6,39,2,37,29,15,39,2,37,28,12
23,49903,VALLEY VIEW ISD,11,english,6,67,25,42,18,5,67,27,40,9,1
23,49905,CALLISBURG ISD,11,english,6,87,17,70,32,6,87,11,76,42,12
23,49906,ERA ISD,11,english,6,39,7,32,20,4,39,9,30,15,3
23,49907,LINDSAY ISD,11,english,6,30,3,27,22,10,30,1,29,19,8
23,49908,WALNUT BEND ISD,11,english,6,8,1,7,3,0,8,4,4,1,0
23,49909,SIVELLS BEND IS,11,english,6,7,0,7,3,0,7,1,6,3,0
23,50901,EVANT ISD,12,english,6,16,7,9,5,1,16,8,8,3,0
23,50902,GATESVILLE ISD,12,english,6,205,38,167,98,35,206,52,154,51,16
23,50904,OGLESBY ISD,12,english,6,8,1,7,6,2,8,0,8,3,0
23,50909,JONESBORO ISD,12,english,6,22,10,12,7,0,22,14,8,0,0
23,50910,COPPERAS COVE I,12,english,6,591,138,453,285,110,590,113,477,219,70
23,51901,PADUCAH ISD,17,english,6,14,5,9,4,2,14,5,9,1,1
23,52901,CRANE ISD,15,english,6,86,35,51,36,5,86,33,53,18,2
23,53001,CROCKETT COUNTY,15,english,6,51,8,43,21,7,51,15,36,13,3
23,54901,CROSBYTON CISD,17,english,6,20,7,13,8,3,20,6,14,5,2
23,54902,LORENZO ISD,17,english,6,17,5,12,8,2,17,3,14,5,2
23,54903,RALLS ISD,17,english,6,36,21,15,5,1,36,19,17,7,1
23,55901,CULBERSON COUNT,18,english,6,28,8,20,16,4,28,11,17,9,1
23,56901,DALHART ISD,16,english,6,120,43,77,47,9,120,46,74,26,5
23,56902,TEXLINE ISD,16,english,6,19,0,19,15,12,19,0,19,16,9
23,57802,PEGASUS SCHOOL,10,english,6,41,16,25,16,3,41,23,18,0,0
23,57803,UPLIFT EDUCATIO,10,english,6,1926,558,1368,806,283,1911,633,1278,537,162
23,57806,ADVANTAGE ACADE,10,english,6,92,43,49,27,4,92,51,41,10,1
23,57807,LIFE SCHOOL,10,english,6,437,131,306,170,49,438,146,292,120,25
23,57808,UNIVERSAL ACADE,10,english,6,138,18,120,94,47,137,21,116,79,49
23,57810,ACADEMY OF DALL,10,english,6,35,18,17,5,2,34,20,14,4,0
23,57813,TRINITY BASIN P,10,english,6,437,124,313,174,37,438,142,296,123,25
23,57814,ACADEMY FOR ACA,10,english,6,6,4,2,0,0,5,3,2,0,0
23,57816,A W BROWN LEADE,10,english,6,64,19,45,24,5,63,24,39,12,2
23,57819,JEAN MASSIEU AC,10,english,6,18,6,12,9,2,18,6,12,4,1
23,57827,NOVA ACADEMY SO,10,english,6,45,7,38,26,11,45,10,35,11,1
23,57829,A+ ACADEMY,10,english,6,114,44,70,37,9,114,53,61,19,1
23,57830,INSPIRED VISION,10,english,6,100,41,59,20,6,100,38,62,12,0
23,57831,GATEWAY CHARTER,10,english,6,28,10,18,9,2,27,10,17,8,0
23,57833,EDUCATION CENTE,10,english,6,26,5,21,12,5,26,9,17,7,2
23,57835,GOLDEN RULE CHA,10,english,6,108,36,72,34,12,108,30,78,22,7
23,57836,ST ANTHONY SCHO,10,english,6,34,7,27,21,8,34,10,24,4,1
23,57839,LA ACADEMIA DE,10,english,6,98,30,68,33,10,97,41,56,15,3
23,57841,CITYSCAPE SCHOO,10,english,6,94,33,61,32,4,93,22,71,26,6
23,57844,MANARA ACADEMY,10,english,6,36,9,27,19,7,37,10,27,9,4
23,57845,UME PREPARATORY,10,english,6,118,16,102,75,30,118,16,102,56,10
23,57846,LEGACY PREPARAT,10,english,6,149,65,84,27,5,149,78,71,11,2
23,57847,VILLAGE TECH SC,10,english,6,113,41,72,50,20,113,38,75,25,4
23,57848,INTERNATIONAL L,10,english,6,1987,682,1305,734,243,1992,766,1226,447,118
23,57850,PIONEER TECHNOL,10,english,6,220,30,190,130,51,213,38,175,84,24
23,57903,CARROLLTON-FARM,10,english,6,1535,450,1085,711,284,1544,478,1066,492,159
23,57904,CEDAR HILL ISD,10,english,6,473,154,319,188,76,474,175,299,93,20
23,57905,DALLAS ISD,10,english,6,8760,2713,6047,3878,1555,8767,2419,6348,3141,1041
23,57906,DESOTO ISD,10,english,6,440,153,287,174,58,440,181,259,79,19
23,57907,DUNCANVILLE ISD,10,english,6,771,273,498,273,88,774,256,518,207,48
23,57909,GARLAND ISD,10,english,6,3589,1021,2568,1626,641,3319,1075,2244,903,205
23,57910,GRAND PRAIRIE I,10,english,6,1839,543,1296,815,319,1829,532,1297,528,168
23,57911,HIGHLAND PARK I,10,english,6,450,11,439,399,264,460,4,456,400,238
23,57912,IRVING ISD,10,english,6,2066,838,1228,708,217,2066,823,1243,525,181
23,57913,LANCASTER ISD,10,english,6,483,181,302,165,51,487,234,253,75,19
23,57914,MESQUITE ISD,10,english,6,2819,1006,1813,966,298,2816,766,2050,1025,334
23,57916,RICHARDSON ISD,10,english,6,2613,621,1992,1449,740,2619,537,2082,1318,701
23,57919,SUNNYVALE ISD,10,english,6,171,16,155,129,65,169,18,151,81,30
23,57922,COPPELL ISD,10,english,6,1146,71,1075,959,625,547,49,498,316,119
23,58902,DAWSON ISD,17,english,6,12,3,9,6,2,12,6,6,2,0
23,58905,KLONDIKE ISD,17,english,6,15,0,15,14,6,15,1,14,7,4
23,58906,LAMESA ISD,17,english,6,98,41,57,27,6,98,47,51,15,2
23,58909,SANDS CISD,17,english,6,18,0,18,14,5,18,1,17,8,5
23,59901,HEREFORD ISD,16,english,6,286,104,182,104,24,288,93,195,85,21
23,59902,WALCOTT ISD,16,english,6,17,0,17,13,5,17,0,17,9,1
23,60902,COOPER ISD,8,english,6,51,14,37,19,4,51,14,37,8,3
23,60914,FANNINDEL ISD,8,english,6,9,4,5,3,1,9,3,6,4,1
23,61802,NORTH TEXAS COL,11,english,6,43,15,28,16,4,43,22,21,9,3
23,61804,LEADERSHIP PREP,10,english,6,120,19,101,74,36,119,22,97,46,15
23,61805,TRIVIUM ACADEMY,11,english,6,58,5,53,48,35,56,4,52,43,24
23,61901,DENTON ISD,11,english,6,2259,528,1731,1188,494,2267,675,1592,732,252
23,61902,LEWISVILLE ISD,11,english,6,3496,608,2888,2201,1151,3487,653,2834,1706,773
23,61903,PILOT POINT ISD,11,english,6,109,23,86,63,38,110,33,77,30,7
23,61905,KRUM ISD,11,english,6,174,47,127,84,33,175,38,137,59,9
23,61906,PONDER ISD,11,english,6,117,23,94,63,20,117,14,103,57,19
23,61907,AUBREY ISD,11,english,6,281,63,218,140,42,283,58,225,137,59
23,61908,SANGER ISD,11,english,6,212,25,187,144,72,210,37,173,105,48
23,61910,ARGYLE ISD,11,english,6,394,33,361,303,153,332,19,313,257,133
23,61911,NORTHWEST ISD,11,english,6,2173,376,1797,1313,553,1828,339,1489,834,244
23,61912,LAKE DALLAS ISD,11,english,6,282,75,207,139,47,281,55,226,117,31
23,61914,LITTLE ELM ISD,11,english,6,590,199,391,232,71,553,174,379,142,31
23,62901,CUERO ISD,3,english,6,149,36,113,72,25,149,37,112,50,10
23,62902,NORDHEIM ISD,3,english,6,14,0,14,11,5,14,4,10,6,1
23,62903,YOAKUM ISD,3,english,6,74,22,52,37,11,75,23,52,16,0
23,62904,YORKTOWN ISD,3,english,6,30,13,17,11,5,30,9,21,5,2
23,62905,WESTHOFF ISD,3,english,6,6,0,6,6,3,6,0,6,4,1
23,62906,MEYERSVILLE ISD,3,english,6,10,1,9,7,5,10,2,8,7,6
23,63903,SPUR ISD,17,english,6,9,2,7,2,1,9,1,8,2,1
23,63906,PATTON SPRINGS,17,english,6,6,1,5,4,1,6,2,4,3,2
23,64903,CARRIZO SPRINGS,20,english,6,140,34,106,60,17,141,51,90,33,9
23,65901,CLARENDON ISD,16,english,6,23,5,18,11,1,23,5,18,11,1
23,65902,HEDLEY ISD,16,english,6,12,3,9,6,1,12,7,5,1,0
23,66005,RAMIREZ CSD,2,english,6,0,,,,,0,,,,
23,66901,BENAVIDES ISD,2,english,6,13,2,11,5,1,13,2,11,2,0
23,66902,SAN DIEGO ISD,2,english,6,105,37,68,42,10,103,26,77,43,15
23,66903,FREER ISD,2,english,6,64,26,38,15,3,65,28,37,8,2
23,67902,CISCO ISD,14,english,6,42,4,38,29,13,42,7,35,20,3
23,67903,EASTLAND ISD,14,english,6,75,8,67,49,23,74,16,58,25,8
23,67904,GORMAN ISD,14,english,6,17,5,12,8,3,17,6,11,3,1
23,67907,RANGER ISD,14,english,6,26,6,20,7,3,26,3,23,14,4
23,67908,RISING STAR ISD,14,english,6,10,2,8,5,1,10,5,5,2,0
23,68802,COMPASS ACADEMY,18,english,6,119,28,91,57,17,119,34,85,25,3
23,68901,ECTOR COUNTY IS,18,english,6,2170,699,1471,874,270,2168,633,1535,712,264
23,69901,ROCKSPRINGS ISD,15,english,6,12,2,10,3,0,12,1,11,3,0
23,69902,NUECES CANYON C,15,english,6,18,2,16,14,4,19,4,15,5,0
23,70801,WAXAHACHIE FAIT,10,english,6,227,115,112,55,18,227,119,108,34,3
23,70901,AVALON ISD,10,english,6,15,8,7,2,0,15,5,10,1,1
23,70903,ENNIS ISD,10,english,6,402,80,322,222,83,402,83,319,163,55
23,70905,FERRIS ISD,10,english,6,190,64,126,63,9,190,72,118,40,10
23,70907,ITALY ISD,10,english,6,42,8,34,22,7,42,4,38,21,7
23,70908,MIDLOTHIAN ISD,10,english,6,826,132,694,485,177,827,107,720,436,183
23,70909,MILFORD ISD,10,english,6,18,4,14,10,1,18,6,12,5,0
23,70910,PALMER ISD,10,english,6,99,22,77,60,30,99,14,85,61,23
23,70911,RED OAK ISD,10,english,6,482,174,308,160,37,484,158,326,125,27
23,70912,WAXAHACHIE ISD,10,english,6,757,152,605,381,144,759,160,599,287,86
23,70915,MAYPEARL ISD,10,english,6,88,22,66,41,17,88,16,72,30,8
23,71801,BURNHAM WOOD CH,19,english,6,87,26,61,36,6,87,16,71,42,13
23,71806,HARMONY PUBLIC,19,english,6,462,87,375,267,114,458,101,357,182,60
23,71809,VISTA DEL FUTUR,19,english,6,26,6,20,15,1,26,5,21,10,3
23,71810,EL PASO LEADERS,19,english,6,121,58,63,27,7,121,45,76,22,4
23,71901,CLINT ISD,19,english,6,734,254,480,264,90,734,263,471,146,34
23,71902,EL PASO ISD,19,english,6,3167,896,2271,1451,517,3162,975,2187,925,280
23,71903,FABENS ISD,19,english,6,144,75,69,30,4,144,37,107,47,11
23,71904,SAN ELIZARIO IS,19,english,6,195,55,140,72,19,195,43,152,62,12
23,71905,YSLETA ISD,19,english,6,2445,547,1898,1168,390,2440,649,1791,792,255
23,71906,ANTHONY ISD,19,english,6,56,19,37,23,6,58,17,41,13,2
23,71907,CANUTILLO ISD,19,english,6,426,101,325,189,55,227,89,138,25,3
23,71908,TORNILLO ISD,19,english,6,57,27,30,10,2,57,34,23,3,1
23,71909,SOCORRO ISD,19,english,6,3274,703,2571,1589,558,3273,749,2524,1132,290
23,72901,THREE WAY ISD,11,english,6,16,4,12,4,1,16,5,11,3,0
23,72902,DUBLIN ISD,11,english,6,72,10,62,47,14,72,6,66,42,13
23,72903,STEPHENVILLE IS,11,english,6,283,52,231,160,80,282,50,232,135,52
23,72904,BLUFF DALE ISD,11,english,6,26,3,23,15,3,26,4,22,9,3
23,72908,HUCKABAY ISD,11,english,6,18,2,16,12,3,18,2,16,10,1
23,72909,LINGLEVILLE ISD,11,english,6,24,4,20,14,3,24,9,15,3,0
23,72910,MORGAN MILL ISD,11,english,6,7,0,7,5,3,7,0,7,3,0
23,73901,CHILTON ISD,12,english,6,34,7,27,18,4,34,9,25,2,0
23,73903,MARLIN ISD,12,english,6,69,21,48,26,5,69,25,44,18,6
23,73904,WESTPHALIA ISD,12,english,6,18,2,16,16,7,18,1,17,15,11
23,73905,ROSEBUD-LOTT IS,12,english,6,48,11,37,25,13,48,14,34,23,6
23,74903,BONHAM ISD,10,english,6,126,35,91,55,23,125,29,96,41,11
23,74904,DODD CITY ISD,10,english,6,27,1,26,20,8,27,2,25,11,4
23,74905,ECTOR ISD,10,english,6,15,6,9,3,1,15,5,10,3,2
23,74907,HONEY GROVE ISD,8,english,6,47,5,42,29,17,47,2,45,32,13
23,74909,LEONARD ISD,10,english,6,68,12,56,41,17,68,16,52,17,6
23,74911,SAVOY ISD,10,english,6,25,3,22,18,14,25,2,23,12,2
23,74912,TRENTON ISD,10,english,6,49,13,36,22,3,49,11,38,20,7
23,74917,SAM RAYBURN ISD,10,english,6,39,1,38,30,16,39,3,36,23,7
23,75901,FLATONIA ISD,13,english,6,52,3,49,28,16,51,3,48,38,13
23,75902,LA GRANGE ISD,13,english,6,146,35,111,77,36,145,42,103,47,11
23,75903,SCHULENBURG ISD,13,english,6,44,14,30,16,3,44,14,30,13,5
23,75906,FAYETTEVILLE IS,13,english,6,18,2,16,12,6,19,5,14,9,2
23,75908,ROUND TOP-CARMI,13,english,6,19,0,19,17,8,19,0,19,16,8
23,76903,ROBY CISD,14,english,6,25,3,22,13,5,24,9,15,7,3
23,76904,ROTAN ISD,14,english,6,21,7,14,9,5,21,5,16,6,1
23,77901,FLOYDADA COLLEG,17,english,6,50,21,29,18,1,50,19,31,16,3
23,77902,LOCKNEY ISD,17,english,6,28,7,21,11,0,28,8,20,6,0
23,78901,CROWELL ISD,9,english,6,14,6,8,4,1,14,4,10,5,1
23,79901,LAMAR CISD,4,english,6,3098,449,2649,2016,1013,3097,579,2518,1429,592
23,79906,NEEDVILLE ISD,4,english,6,292,21,271,216,111,292,13,279,182,74
23,79907,FORT BEND ISD,4,english,6,5913,1088,4825,3567,1791,5776,1199,4577,2786,1407
23,79910,STAFFORD MSD,4,english,6,257,93,164,110,43,258,81,177,67,30
23,80901,MOUNT VERNON IS,8,english,6,108,16,92,71,29,107,12,95,66,35
23,81902,FAIRFIELD ISD,12,english,6,149,43,106,83,35,149,40,109,58,26
23,81904,TEAGUE ISD,12,english,6,72,22,50,28,7,71,15,56,16,3
23,81905,WORTHAM ISD,12,english,6,35,11,24,9,1,35,12,23,11,3
23,81906,DEW ISD,12,english,6,12,1,11,9,2,12,1,11,1,0
23,82902,DILLEY ISD,20,english,6,50,22,28,15,1,50,25,25,8,0
23,82903,PEARSALL ISD,20,english,6,133,61,72,37,5,131,65,66,11,4
23,83901,SEAGRAVES ISD,17,english,6,42,18,24,11,4,42,16,26,11,3
23,83902,LOOP ISD,17,english,6,10,1,9,8,2,10,4,6,2,1
23,83903,SEMINOLE ISD,17,english,6,208,59,149,97,42,209,35,174,97,42
23,84802,ODYSSEY ACADEMY,4,english,6,116,32,84,37,7,116,39,77,23,2
23,84804,AMBASSADORS PRE,4,english,6,15,0,15,13,9,14,1,13,10,3
23,84901,DICKINSON ISD,4,english,6,865,225,640,403,135,863,226,637,291,90
23,84902,GALVESTON ISD,4,english,6,411,144,267,141,46,409,150,259,115,35
23,84903,HIGH ISLAND ISD,5,english,6,13,1,12,7,5,13,1,12,4,2
23,84906,TEXAS CITY ISD,4,english,6,591,206,385,218,63,589,225,364,109,24
23,84908,HITCHCOCK ISD,4,english,6,124,50,74,37,8,124,55,69,20,5
23,84909,SANTA FE ISD,4,english,6,342,61,281,176,64,339,93,246,103,21
23,84910,CLEAR CREEK ISD,4,english,6,2981,401,2580,1938,908,2916,513,2403,1378,509
23,84911,FRIENDSWOOD ISD,4,english,6,482,31,451,352,161,257,16,241,164,57
23,85902,POST ISD,17,english,6,52,24,28,13,3,52,25,27,7,3
23,85903,SOUTHLAND ISD,17,english,6,19,7,12,5,2,19,6,13,3,1
23,86901,FREDERICKSBURG,13,english,6,220,75,145,102,39,220,55,165,90,40
23,86902,HARPER ISD,15,english,6,45,4,41,30,17,45,4,41,25,13
23,87901,GLASSCOCK COUNT,18,english,6,19,2,17,15,8,19,0,19,16,5
23,88902,GOLIAD ISD,3,english,6,90,14,76,61,28,89,27,62,23,4
23,89901,GONZALES ISD,13,english,6,181,54,127,81,24,180,56,124,53,12
23,89903,NIXON-SMILEY CI,13,english,6,72,20,52,37,16,72,17,55,17,0
23,89905,WAELDER ISD,13,english,6,18,10,8,4,1,18,6,12,3,0
23,90902,LEFORS ISD,16,english,6,8,5,3,1,0,8,4,4,1,1
23,90903,MCLEAN ISD,16,english,6,11,2,9,7,1,11,1,10,2,0
23,90904,PAMPA ISD,16,english,6,202,62,140,75,22,202,62,140,68,23
23,90905,GRANDVIEW-HOPKI,16,english,6,0,,,,,0,,,,
23,91901,BELLS ISD,10,english,6,70,13,57,47,23,69,4,65,47,12
23,91902,COLLINSVILLE IS,10,english,6,33,7,26,15,6,33,8,25,13,5
23,91903,DENISON ISD,10,english,6,350,68,282,184,64,351,72,279,126,56
23,91905,HOWE ISD,10,english,6,101,16,85,64,34,101,10,91,52,20
23,91906,SHERMAN ISD,10,english,6,516,184,332,183,49,518,184,334,128,23
23,91907,TIOGA ISD,10,english,6,57,15,42,22,5,56,10,46,17,4
23,91908,VAN ALSTYNE ISD,10,english,6,179,18,161,114,53,180,36,144,53,10
23,91909,WHITESBORO ISD,10,english,6,117,18,99,77,26,114,22,92,39,13
23,91910,WHITEWRIGHT ISD,10,english,6,53,5,48,36,11,52,4,48,42,24
23,91913,POTTSBORO ISD,10,english,6,111,18,93,59,20,80,22,58,23,1
23,91914,S AND S CISD,10,english,6,88,33,55,29,10,88,32,56,19,5
23,91917,GUNTER ISD,10,english,6,82,15,67,50,21,82,15,67,33,13
23,91918,TOM BEAN ISD,10,english,6,47,10,37,16,2,46,10,36,14,5
23,92901,GLADEWATER ISD,7,english,6,122,33,89,65,20,122,33,89,35,9
23,92902,KILGORE ISD,7,english,6,289,84,205,127,40,288,77,211,87,22
23,92903,LONGVIEW ISD,7,english,6,599,144,455,316,139,597,128,469,256,108
23,92904,PINE TREE ISD,7,english,6,333,48,285,208,87,331,60,271,130,44
23,92906,SABINE ISD,7,english,6,142,33,109,77,33,141,23,118,58,19
23,92907,SPRING HILL ISD,7,english,6,165,32,133,93,40,165,22,143,75,32
23,92908,WHITE OAK ISD,7,english,6,109,17,92,54,21,93,18,75,26,3
23,93901,ANDERSON-SHIRO,6,english,6,83,13,70,44,19,83,3,80,69,40
23,93903,IOLA ISD,6,english,6,43,7,36,28,9,43,3,40,28,16
23,93904,NAVASOTA ISD,6,english,6,211,64,147,76,14,212,72,140,50,12
23,93905,RICHARDS ISD,6,english,6,15,2,13,11,4,15,2,13,8,3
23,94901,SEGUIN ISD,20,english,6,462,141,321,167,51,464,188,276,97,21
23,94902,SCHERTZ-CIBOLO-,20,english,6,1108,194,914,615,247,1106,163,943,598,240
23,94903,NAVARRO ISD,20,english,6,155,27,128,87,27,155,24,131,73,20
23,94904,MARION ISD,20,english,6,119,31,88,45,16,119,34,85,34,6
23,95901,ABERNATHY ISD,17,english,6,57,16,41,25,7,57,3,54,36,14
23,95903,HALE CENTER ISD,17,english,6,51,18,33,11,3,51,17,34,9,2
23,95904,PETERSBURG ISD,17,english,6,22,8,14,9,2,22,5,17,10,3
23,95905,PLAINVIEW ISD,17,english,6,350,144,206,112,32,349,139,210,84,20
23,96904,MEMPHIS ISD,16,english,6,28,11,17,8,2,28,8,20,6,0
23,96905,TURKEY-QUITAQUE,16,english,6,12,2,10,9,4,12,1,11,7,2
23,97902,HAMILTON ISD,12,english,6,60,16,44,30,9,60,14,46,23,5
23,97903,HICO ISD,12,english,6,39,3,36,27,6,39,13,26,5,1
23,98901,GRUVER ISD,16,english,6,30,1,29,24,10,30,1,29,24,11
23,98903,PRINGLE-MORSE C,16,english,6,9,1,8,5,3,9,1,8,1,0
23,98904,SPEARMAN ISD,16,english,6,63,6,57,35,7,63,8,55,38,19
23,99902,CHILLICOTHE ISD,9,english,6,11,5,6,2,1,11,5,6,4,1
23,99903,QUANAH ISD,9,english,6,27,7,20,10,4,27,6,21,10,1
23,100903,KOUNTZE ISD,5,english,6,60,14,46,31,18,60,10,50,27,9
23,100904,SILSBEE ISD,5,english,6,198,64,134,74,28,200,100,100,25,4
23,100905,HARDIN-JEFFERSO,5,english,6,212,36,176,111,42,212,23,189,102,30
23,100907,LUMBERTON ISD,5,english,6,300,50,250,158,60,299,64,235,113,44
23,100908,WEST HARDIN COU,5,english,6,39,9,30,17,3,39,9,30,13,2
23,101802,SER-NINOS CHART,4,english,6,88,19,69,42,16,88,24,64,25,8
23,101803,ARISTOI CLASSIC,4,english,6,118,8,110,100,43,117,12,105,69,26
23,101804,GEORGE I SANCHE,4,english,6,90,52,38,15,2,90,53,37,7,0
23,101806,RAUL YZAGUIRRE,4,english,6,183,52,131,74,27,183,68,115,55,20
23,101810,ACADEMY OF ACCE,4,english,6,76,20,56,31,15,76,21,55,17,2
23,101814,THE VARNETT PUB,4,english,6,109,36,73,39,13,109,37,72,26,10
23,101815,ALIEF MONTESSOR,4,english,6,22,1,21,11,4,22,3,19,9,3
23,101819,AMIGOS POR VIDA,4,english,6,60,5,55,43,23,60,3,57,33,14
23,101828,HOUSTON GATEWAY,4,english,6,181,14,167,127,58,181,6,175,140,80
23,101837,CALVIN NELMS CH,4,english,6,34,5,29,20,6,34,5,29,23,9
23,101838,SOUTHWEST SCHOO,4,english,6,101,48,53,28,6,101,42,59,12,1
23,101842,COMQUEST ACADEM,4,english,6,0,,,,,0,,,,
23,101845,YES PREP PUBLIC,4,english,6,2125,523,1602,1012,371,2117,674,1443,585,143
23,101846,HARMONY PUBLIC,4,english,6,326,51,275,198,76,326,77,249,146,66
23,101847,BEATRICE MAYES,4,english,6,47,2,45,33,15,47,13,34,7,1
23,101849,ACCELERATED INT,4,english,6,16,2,14,9,4,16,4,12,4,2
23,101853,BAKERRIPLEY COM,4,english,6,80,31,49,21,5,80,26,54,24,5
23,101855,MEYERPARK ELEME,4,english,6,14,4,10,7,1,14,6,8,5,0
23,101856,DRAW ACADEMY,4,english,6,65,28,37,18,2,65,24,41,11,1
23,101858,HARMONY PUBLIC,4,english,6,629,106,523,363,167,597,128,469,275,124
23,101859,STEP CHARTER SC,4,english,6,52,9,43,25,13,52,10,42,22,10
23,101861,THE RHODES SCHO,4,english,6,38,8,30,12,3,36,18,18,7,5
23,101862,HARMONY PUBLIC,4,english,6,446,36,410,345,194,418,46,372,291,181
23,101864,THE LAWSON ACAD,4,english,6,35,9,26,12,3,35,14,21,6,2
23,101868,THE PRO-VISION,4,english,6,47,33,14,4,0,48,33,15,1,1
23,101870,BETA ACADEMY,4,english,6,95,2,93,77,30,95,5,90,56,17
23,101871,A+ UNLIMITED PO,4,english,6,45,13,32,20,6,43,18,25,8,3
23,101872,ETOILE ACADEMY,4,english,6,111,54,57,25,5,111,57,54,23,11
23,101873,YELLOWSTONE COL,4,english,6,71,17,54,20,2,71,34,37,6,0
23,101874,LEGACY SCHOOL O,4,english,6,39,18,21,11,1,39,18,21,9,0
23,101876,REVE PREPARATOR,4,english,6,25,10,15,7,0,25,18,7,2,0
23,101902,ALDINE ISD,4,english,6,4202,1845,2357,1191,308,4204,2005,2199,686,183
23,101903,ALIEF ISD,4,english,6,2712,991,1721,1027,358,2711,962,1749,776,295
23,101905,CHANNELVIEW ISD,4,english,6,648,221,427,242,64,647,217,430,137,32
23,101906,CROSBY ISD,4,english,6,469,123,346,213,59,470,147,323,159,50
23,101907,CYPRESS-FAIRBAN,4,english,6,8492,1670,6822,5018,2514,8449,1886,6563,3936,1837
23,101908,DEER PARK ISD,4,english,6,942,164,778,532,222,865,151,714,384,128
23,101910,GALENA PARK ISD,4,english,6,1533,413,1120,713,280,1532,406,1126,586,252
23,101911,GOOSE CREEK CIS,4,english,6,1777,573,1204,748,254,1775,512,1263,613,208
23,101912,HOUSTON ISD,4,english,6,11336,3851,7485,4715,1975,11292,4119,7173,3229,1259
23,101913,HUMBLE ISD,4,english,6,3611,818,2793,1809,684,3631,981,2650,1279,439
23,101914,KATY ISD,4,english,6,6924,897,6027,4861,2835,6726,873,5853,4152,2350
23,101915,KLEIN ISD,4,english,6,3888,873,3015,2172,985,3564,931,2633,1187,326
23,101916,LA PORTE ISD,4,english,6,506,123,383,234,79,507,109,398,172,38
23,101917,PASADENA ISD,4,english,6,3457,1035,2422,1442,469,2898,1022,1876,581,99
23,101919,SPRING ISD,4,english,6,2271,782,1489,841,252,2267,889,1378,425,121
23,101920,SPRING BRANCH I,4,english,6,2353,567,1786,1334,718,2320,540,1780,1091,556
23,101921,TOMBALL ISD,4,english,6,1708,183,1525,1251,682,1714,173,1541,1127,626
23,101924,SHELDON ISD,4,english,6,773,275,498,273,77,773,305,468,139,22
23,101925,HUFFMAN ISD,4,english,6,299,98,201,111,26,298,112,186,86,23
23,102901,KARNACK ISD,7,english,6,9,2,7,4,2,9,0,9,2,1
23,102902,MARSHALL ISD,7,english,6,317,115,202,122,45,318,116,202,93,20
23,102903,WASKOM ISD,7,english,6,63,7,56,44,20,63,16,47,15,4
23,102904,HALLSVILLE ISD,7,english,6,1514,498,1016,555,177,1511,664,847,312,137
23,102905,HARLETON ISD,7,english,6,50,2,48,33,10,49,3,46,27,6
23,102906,ELYSIAN FIELDS,7,english,6,61,6,55,47,22,60,2,58,39,13
23,103901,CHANNING ISD,16,english,6,13,3,10,8,3,13,3,10,5,0
23,103902,HARTLEY ISD,16,english,6,15,1,14,14,7,15,1,14,12,9
23,104901,HASKELL CISD,14,english,6,38,6,32,21,3,38,14,24,11,4
23,104903,RULE ISD,14,english,6,7,0,7,4,1,7,2,5,4,2
23,104907,PAINT CREEK ISD,14,english,6,9,0,9,6,1,9,1,8,5,3
23,105802,TEXAS PREPARATO,13,english,6,8,5,3,2,1,8,5,3,1,0
23,105803,KI CHARTER ACAD,13,english,6,28,18,10,3,0,26,18,8,2,0
23,105804,DORAL ACADEMY O,13,english,6,27,3,24,17,7,27,9,18,10,5
23,105902,SAN MARCOS CISD,13,english,6,546,210,336,202,75,546,224,322,118,25
23,105904,DRIPPING SPRING,13,english,6,641,44,597,491,266,518,60,458,273,78
23,105905,WIMBERLEY ISD,13,english,6,230,20,210,167,80,231,25,206,133,64
23,105906,HAYS CISD,13,english,6,1631,366,1265,863,376,1626,414,1212,617,221
23,106901,CANADIAN ISD,16,english,6,51,5,46,39,17,51,4,47,32,12
23,107901,ATHENS ISD,10,english,6,215,55,160,105,41,215,66,149,62,24
23,107902,BROWNSBORO ISD,7,english,6,199,29,170,129,59,198,25,173,115,47
23,107904,CROSS ROADS ISD,7,english,6,39,3,36,28,15,39,3,36,27,13
23,107905,EUSTACE ISD,7,english,6,130,20,110,75,19,128,12,116,68,18
23,107906,MALAKOFF ISD,7,english,6,104,10,94,66,25,104,21,83,28,7
23,107907,TRINIDAD ISD,7,english,6,6,0,6,2,1,6,1,5,1,0
23,107908,MURCHISON ISD,7,english,6,12,2,10,4,2,12,2,10,7,0
23,107910,LAPOYNOR ISD,7,english,6,32,9,23,16,8,32,6,26,9,2
23,108802,HORIZON MONTESS,1,english,6,83,16,67,39,20,83,18,65,25,13
23,108807,IDEA PUBLIC SCH,1,english,6,6366,1386,4980,3397,1369,6353,1566,4787,2483,935
23,108808,VANGUARD ACADEM,1,english,6,460,72,388,281,118,459,112,347,177,55
23,108809,EXCELLENCE IN L,1,english,6,28,7,21,13,4,28,9,19,6,0
23,108902,DONNA ISD,1,english,6,911,339,572,335,102,907,342,565,222,45
23,108903,EDCOUCH-ELSA IS,1,english,6,286,130,156,59,13,285,110,175,41,6
23,108904,EDINBURG CISD,1,english,6,2229,606,1623,1092,434,2230,703,1527,670,197
23,108905,HIDALGO ISD,1,english,6,154,42,112,62,22,154,40,114,48,12
23,108906,MCALLEN ISD,1,english,6,1456,315,1141,824,374,1183,310,873,395,112
23,108907,MERCEDES ISD,1,english,6,325,136,189,97,23,325,140,185,49,9
23,108908,MISSION CISD,1,english,6,979,341,638,387,125,976,378,598,205,48
23,108909,PHARR-SAN JUAN-,1,english,6,2006,688,1318,745,253,2005,688,1317,540,157
23,108910,PROGRESO ISD,1,english,6,109,30,79,45,16,108,40,68,21,4
23,108911,SHARYLAND ISD,1,english,6,711,77,634,494,233,712,95,617,399,199
23,108912,LA JOYA ISD,1,english,6,1641,483,1158,707,253,1344,398,946,376,82
23,108913,WESLACO ISD,1,english,6,1183,369,814,454,136,1176,441,735,286,100
23,108914,LA VILLA ISD,1,english,6,44,18,26,13,2,44,17,27,9,2
23,108915,MONTE ALTO ISD,1,english,6,57,11,46,30,11,58,11,47,21,6
23,108916,VALLEY VIEW ISD,1,english,6,234,44,190,130,64,235,52,183,110,50
23,109901,ABBOTT ISD,12,english,6,22,2,20,14,7,22,1,21,10,5
23,109902,BYNUM ISD,12,english,6,8,1,7,5,1,8,1,7,4,2
23,109903,COVINGTON ISD,12,english,6,24,6,18,8,2,24,7,17,4,0
23,109904,HILLSBORO ISD,12,english,6,145,41,104,63,17,145,42,103,43,13
23,109905,HUBBARD ISD,12,english,6,26,7,19,10,2,26,6,20,7,1
23,109907,ITASCA ISD,12,english,6,58,22,36,17,1,58,28,30,6,1
23,109908,MALONE ISD,12,english,6,6,2,4,2,0,6,2,4,0,0
23,109910,MOUNT CALM ISD,12,english,6,17,5,12,6,3,17,6,11,4,0
23,109911,WHITNEY ISD,12,english,6,98,20,78,49,9,98,26,72,33,10
23,109912,AQUILLA ISD,12,english,6,31,8,23,15,6,32,9,23,11,3
23,109913,BLUM ISD,12,english,6,24,8,16,11,0,24,5,19,7,0
23,109914,PENELOPE ISD,12,english,6,15,5,10,6,2,15,1,14,5,1
23,110901,ANTON ISD,17,english,6,13,4,9,4,3,13,6,7,3,0
23,110902,LEVELLAND ISD,17,english,6,187,45,142,94,24,186,67,119,36,4
23,110905,ROPES ISD,17,english,6,37,5,32,23,6,37,5,32,19,5
23,110906,SMYER ISD,17,english,6,35,5,30,23,9,35,4,31,16,8
23,110907,SUNDOWN ISD,17,english,6,47,6,41,25,9,47,0,47,41,21
23,110908,WHITHARRAL ISD,17,english,6,18,3,15,10,1,18,5,13,8,1
23,111901,GRANBURY ISD,11,english,6,585,140,445,302,126,586,137,449,221,111
23,111902,LIPAN ISD,11,english,6,37,3,34,22,9,37,5,32,15,6
23,111903,TOLAR ISD,11,english,6,67,10,57,35,13,68,19,49,24,2
23,112901,SULPHUR SPRINGS,8,english,6,310,73,237,161,62,309,81,228,122,57
23,112905,CUMBY COLLEGIAT,8,english,6,33,9,24,18,4,32,9,23,8,2
23,112906,NORTH HOPKINS I,8,english,6,42,7,35,25,8,42,4,38,24,10
23,112907,MILLER GROVE IS,8,english,6,29,5,24,17,5,29,7,22,10,1
23,112908,COMO-PICKTON CI,8,english,6,64,16,48,33,11,65,24,41,12,5
23,112909,SALTILLO ISD,8,english,6,19,3,16,6,2,19,4,15,11,1
23,112910,SULPHUR BLUFF I,8,english,6,10,2,8,5,2,10,5,5,1,0
23,113901,CROCKETT ISD,6,english,6,91,47,44,21,7,91,53,38,8,3
23,113902,GRAPELAND ISD,6,english,6,38,9,29,17,5,38,11,27,8,3
23,113903,LOVELADY ISD,6,english,6,42,5,37,26,12,42,7,35,18,6
23,113905,LATEXO ISD,6,english,6,36,9,27,15,4,36,8,28,7,1
23,113906,KENNARD ISD,6,english,6,16,3,13,6,1,16,2,14,5,1
23,114901,BIG SPRING ISD,18,english,6,244,76,168,94,32,241,81,160,71,21
23,114902,COAHOMA ISD,18,english,6,75,25,50,28,9,75,16,59,27,11
23,114904,FORSAN ISD,18,english,6,56,9,47,34,11,56,7,49,17,3
23,115901,FT HANCOCK ISD,19,english,6,30,10,20,11,5,30,3,27,10,2
23,115902,SIERRA BLANCA I,19,english,6,8,3,5,4,0,8,2,6,3,0
23,115903,DELL CITY ISD,19,english,6,0,,,,,0,,,,
23,116901,CADDO MILLS ISD,10,english,6,196,30,166,131,41,197,27,170,102,36
23,116902,CELESTE ISD,10,english,6,37,12,25,16,3,36,10,26,12,5
23,116903,COMMERCE ISD,10,english,6,99,31,68,40,13,99,39,60,19,3
23,116905,GREENVILLE ISD,10,english,6,370,148,222,105,35,368,124,244,106,34
23,116906,LONE OAK ISD,10,english,6,72,19,53,35,6,72,14,58,32,6
23,116908,QUINLAN ISD,10,english,6,220,91,129,70,20,223,91,132,53,15
23,116909,WOLFE CITY ISD,10,english,6,45,8,37,19,4,45,14,31,17,5
23,116910,CAMPBELL ISD,10,english,6,32,16,16,10,2,32,15,17,1,0
23,116915,BLAND ISD,10,english,6,58,16,42,25,9,58,11,47,19,5
23,116916,BOLES ISD,10,english,6,46,16,30,13,6,44,11,33,18,3
23,117901,BORGER ISD,16,english,6,148,30,118,75,31,149,35,114,66,29
23,117903,SANFORD-FRITCH,16,english,6,42,10,32,20,2,42,8,34,18,4
23,117904,PLEMONS-STINNET,16,english,6,46,7,39,18,11,46,7,39,24,7
23,117907,SPRING CREEK IS,16,english,6,6,1,5,3,2,7,4,3,1,0
23,118902,IRION COUNTY IS,15,english,6,23,3,20,15,6,23,3,20,18,8
23,119901,BRYSON ISD,9,english,6,21,1,20,15,4,22,2,20,9,2
23,119902,JACKSBORO ISD,9,english,6,91,36,55,31,3,90,30,60,22,7
23,119903,PERRIN-WHITT CI,9,english,6,24,4,20,14,7,24,2,22,11,4
23,120901,EDNA ISD,3,english,6,95,17,78,50,18,95,20,75,43,22
23,120902,GANADO ISD,3,english,6,46,5,41,26,9,46,8,38,11,1
23,120905,INDUSTRIAL ISD,3,english,6,86,2,84,74,47,86,4,82,49,20
23,121902,BROOKELAND ISD,5,english,6,25,2,23,19,10,25,1,24,14,6
23,121903,BUNA ISD,5,english,6,109,23,86,62,24,109,40,69,21,5
23,121904,JASPER ISD,5,english,6,137,74,63,24,4,139,68,71,23,5
23,121905,KIRBYVILLE CISD,5,english,6,105,19,86,54,21,106,9,97,52,17
23,121906,EVADALE ISD,5,english,6,30,9,21,17,3,30,6,24,10,3
23,122901,FT DAVIS ISD,18,english,6,19,2,17,9,2,19,1,18,7,2
23,122902,VALENTINE ISD,18,english,6,0,,,,,0,,,,
23,123803,TEKOA ACADEMY O,5,english,6,20,3,17,11,3,20,4,16,14,9
23,123805,EHRHART SCHOOL,5,english,6,61,6,55,38,13,61,8,53,35,15
23,123807,BOB HOPE SCHOOL,5,english,6,178,33,145,92,34,178,42,136,71,29
23,123905,NEDERLAND ISD,5,english,6,387,57,330,253,106,386,75,311,167,64
23,123907,PORT ARTHUR ISD,5,english,6,500,227,273,123,30,503,215,288,83,14
23,123908,PORT NECHES-GRO,5,english,6,381,83,298,206,67,382,70,312,166,50
23,123910,BEAUMONT ISD,5,english,6,997,452,545,261,56,1010,516,494,114,18
23,123913,SABINE PASS ISD,5,english,6,31,0,31,23,12,31,4,27,15,7
23,123914,HAMSHIRE-FANNET,5,english,6,159,35,124,69,25,166,43,123,44,6
23,124901,JIM HOGG COUNTY,1,english,6,71,23,48,23,7,71,25,46,18,3
23,125901,ALICE ISD,2,english,6,314,99,215,112,25,313,98,215,68,17
23,125902,BEN BOLT-PALITO,2,english,6,29,9,20,9,3,28,9,19,9,3
23,125903,ORANGE GROVE IS,2,english,6,134,20,114,86,35,134,29,105,41,10
23,125905,PREMONT ISD,2,english,6,51,15,36,22,5,51,21,30,6,2
23,125906,LA GLORIA ISD,2,english,6,7,0,7,5,0,7,2,5,1,0
23,126901,ALVARADO ISD,11,english,6,251,67,184,119,36,250,69,181,81,19
23,126902,BURLESON ISD,11,english,6,910,160,750,477,171,905,140,765,492,215
23,126903,CLEBURNE ISD,11,english,6,540,183,357,210,61,536,144,392,161,58
23,126904,GRANDVIEW ISD,11,english,6,105,18,87,58,20,105,18,87,48,15
23,126905,JOSHUA ISD,11,english,6,432,62,370,262,96,434,54,380,256,121
23,126906,KEENE ISD,11,english,6,86,11,75,48,18,84,16,68,37,12
23,126907,RIO VISTA ISD,11,english,6,74,11,63,44,14,74,16,58,22,5
23,126908,VENUS ISD,11,english,6,147,50,97,41,12,149,58,91,28,4
23,126911,GODLEY ISD,11,english,6,215,43,172,111,38,215,43,172,88,23
23,127901,ANSON ISD,14,english,6,56,19,37,21,10,56,17,39,19,6
23,127903,HAMLIN COLLEGIA,14,english,6,19,9,10,6,2,19,8,11,6,1
23,127904,HAWLEY ISD,14,english,6,62,20,42,22,3,62,21,41,11,0
23,127905,LUEDERS-AVOCA I,14,english,6,5,0,5,2,1,5,2,3,2,2
23,127906,STAMFORD ISD,14,english,6,23,3,20,15,7,23,2,21,11,6
23,128901,KARNES CITY ISD,20,english,6,206,66,140,68,16,205,96,109,34,6
23,128902,KENEDY ISD,3,english,6,47,17,30,12,0,47,17,30,12,0
23,128903,RUNGE ISD,3,english,6,14,5,9,5,1,14,7,7,1,0
23,128904,FALLS CITY ISD,20,english,6,27,0,27,27,16,27,0,27,25,18
23,129901,CRANDALL ISD,10,english,6,458,92,366,235,99,458,102,356,155,53
23,129902,FORNEY ISD,10,english,6,1240,299,941,642,274,1241,295,946,519,209
23,129903,KAUFMAN ISD,10,english,6,298,79,219,129,51,297,51,246,150,68
23,129904,KEMP ISD,10,english,6,116,62,54,26,4,115,45,70,19,2
23,129905,MABANK ISD,10,english,6,293,81,212,125,40,294,60,234,109,27
23,129906,TERRELL ISD,10,english,6,369,114,255,136,31,373,119,254,81,21
23,129910,SCURRY-ROSSER I,10,english,6,81,16,65,49,13,81,6,75,53,13
23,130801,MEADOWLAND CHAR,20,english,6,5,3,2,0,0,5,2,3,1,1
23,130901,BOERNE ISD,20,english,6,757,75,682,505,250,752,92,660,434,200
23,130902,COMFORT ISD,13,english,6,73,21,52,31,11,73,18,55,18,2
23,131001,KENEDY COUNTY W,2,english,6,13,3,10,7,3,13,2,11,7,3
23,132902,JAYTON-GIRARD I,17,english,6,17,3,14,11,2,17,3,14,7,4
23,133901,CENTER POINT IS,20,english,6,39,13,26,13,2,39,15,24,9,3
23,133902,HUNT ISD,20,english,6,18,1,17,10,5,18,1,17,7,2
23,133903,KERRVILLE ISD,20,english,6,324,98,226,137,58,323,104,219,90,25
23,133904,INGRAM ISD,20,english,6,90,19,71,52,16,90,15,75,39,12
23,133905,DIVIDE ISD,20,english,6,0,,,,,0,,,,
23,134901,JUNCTION ISD,15,english,6,36,9,27,11,5,35,12,23,8,1
23,135001,GUTHRIE CSD,17,english,6,14,1,13,8,1,14,2,12,7,1
23,136901,BRACKETT ISD,20,english,6,36,9,27,19,3,36,7,29,10,0
23,137901,KINGSVILLE ISD,2,english,6,136,69,67,36,12,135,69,66,17,1
23,137902,RICARDO ISD,2,english,6,57,8,49,31,11,57,13,44,18,7
23,137903,RIVIERA ISD,2,english,6,23,4,19,14,6,23,4,19,9,3
23,137904,SANTA GERTRUDIS,2,english,6,45,5,40,30,16,45,6,39,21,10
23,138902,KNOX CITY-O'BRI,9,english,6,18,1,17,9,2,18,4,14,6,2
23,138903,MUNDAY CISD,9,english,6,26,4,22,13,3,26,6,20,6,0
23,138904,BENJAMIN ISD,9,english,6,6,1,5,4,3,6,1,5,1,0
23,139905,CHISUM ISD,8,english,6,91,15,76,53,17,90,14,76,39,11
23,139909,PARIS ISD,8,english,6,265,86,179,117,43,265,89,176,83,36
23,139911,NORTH LAMAR ISD,8,english,6,171,48,123,74,23,170,44,126,45,12
23,139912,PRAIRILAND ISD,8,english,6,77,13,64,39,11,78,22,56,16,2
23,140901,AMHERST ISD,17,english,6,8,3,5,0,0,8,3,5,0,0
23,140904,LITTLEFIELD ISD,17,english,6,84,32,52,32,2,84,28,56,14,1
23,140905,OLTON ISD,17,english,6,34,13,21,10,1,34,19,15,2,0
23,140907,SPRINGLAKE-EART,17,english,6,19,5,14,12,4,18,2,16,6,4
23,140908,SUDAN ISD,17,english,6,39,7,32,24,14,39,4,35,21,7
23,141901,LAMPASAS ISD,12,english,6,263,56,207,150,58,263,39,224,138,50
23,141902,LOMETA ISD,12,english,6,19,5,14,9,5,19,5,14,6,3
23,142901,COTULLA ISD,20,english,6,77,17,60,30,9,76,22,54,25,6
23,143901,HALLETTSVILLE I,3,english,6,64,11,53,29,7,62,2,60,44,24
23,143902,MOULTON ISD,3,english,6,13,1,12,11,2,13,0,13,5,4
23,143903,SHINER ISD,3,english,6,48,4,44,33,20,48,0,48,42,29
23,143904,VYSEHRAD ISD,3,english,6,11,3,8,6,2,11,2,9,6,1
23,143905,SWEET HOME ISD,3,english,6,9,2,7,6,1,9,0,9,5,4
23,143906,EZZELL ISD,3,english,6,10,0,10,7,2,10,0,10,6,3
23,144901,GIDDINGS ISD,13,english,6,127,31,96,48,8,127,29,98,32,11
23,144902,LEXINGTON ISD,13,english,6,62,7,55,37,15,46,6,40,20,2
23,144903,DIME BOX ISD,13,english,6,10,2,8,2,0,10,2,8,1,0
23,145901,BUFFALO ISD,6,english,6,64,8,56,42,17,64,7,57,26,5
23,145902,CENTERVILLE ISD,6,english,6,47,19,28,14,2,47,18,29,6,2
23,145906,NORMANGEE ISD,6,english,6,45,6,39,27,4,45,5,40,24,7
23,145907,OAKWOOD ISD,6,english,6,16,3,13,6,0,16,2,14,8,4
23,145911,LEON ISD,6,english,6,51,10,41,21,6,51,11,40,16,4
23,146901,CLEVELAND ISD,4,english,6,859,432,427,197,41,853,437,416,105,16
23,146902,DAYTON ISD,4,english,6,454,142,312,172,54,449,127,322,124,29
23,146903,DEVERS ISD,4,english,6,21,2,19,16,11,21,2,19,17,10
23,146904,HARDIN ISD,5,english,6,86,27,59,33,6,86,27,59,19,3
23,146905,HULL-DAISETTA I,5,english,6,34,18,16,7,2,34,14,20,2,0
23,146906,LIBERTY ISD,5,english,6,176,55,121,65,17,173,59,114,36,7
23,146907,TARKINGTON ISD,4,english,6,126,31,95,71,32,126,28,98,50,17
23,147901,COOLIDGE ISD,12,english,6,23,4,19,10,1,23,7,16,5,0
23,147902,GROESBECK ISD,12,english,6,101,18,83,54,18,101,28,73,29,7
23,147903,MEXIA ISD,12,english,6,113,55,58,34,7,113,55,58,15,2
23,148901,BOOKER ISD,16,english,6,29,2,27,20,11,29,3,26,10,3
23,148902,FOLLETT ISD,16,english,6,9,4,5,0,0,9,6,3,1,0
23,148905,DARROUZETT ISD,16,english,6,7,3,4,0,0,7,7,0,0,0
23,149901,GEORGE WEST ISD,2,english,6,77,13,64,55,30,77,12,65,38,21
23,149902,THREE RIVERS IS,2,english,6,42,5,37,24,6,43,10,33,9,3
23,150901,LLANO ISD,13,english,6,136,37,99,57,21,134,33,101,49,14
23,152504,TEXAS TECH UNIV,17,english,6,36,2,34,29,17,36,6,30,23,8
23,152802,RISE ACADEMY,17,english,6,15,0,15,13,6,15,0,15,13,1
23,152901,LUBBOCK ISD,17,english,6,1712,502,1210,732,317,1705,559,1146,491,175
23,152902,NEW DEAL ISD,17,english,6,50,8,42,33,14,50,12,38,18,5
23,152903,SLATON ISD,17,english,6,72,32,40,19,3,73,34,39,11,1
23,152906,LUBBOCK-COOPER,17,english,6,575,75,500,343,159,576,82,494,277,106
23,152907,FRENSHIP ISD,17,english,6,781,148,633,463,214,784,164,620,336,123
23,152908,ROOSEVELT ISD,17,english,6,88,30,58,29,10,87,34,53,18,3
23,152909,SHALLOWATER ISD,17,english,6,124,6,118,106,53,124,4,120,95,32
23,152910,IDALOU ISD,17,english,6,64,10,54,38,19,65,7,58,30,8
23,153903,O'DONNELL ISD,17,english,6,20,0,20,12,4,20,0,20,15,4
23,153904,TAHOKA ISD,17,english,6,36,8,28,19,8,36,7,29,21,7
23,153905,NEW HOME ISD,17,english,6,38,0,38,33,24,38,0,38,31,23
23,153907,WILSON ISD,17,english,6,14,3,11,8,3,14,3,11,1,0
23,154901,MADISONVILLE CI,6,english,6,161,23,138,96,26,161,12,149,81,20
23,154903,NORTH ZULCH ISD,6,english,6,19,1,18,14,6,19,2,17,12,5
23,155901,JEFFERSON ISD,8,english,6,66,28,38,23,7,57,19,38,14,2
23,156902,STANTON ISD,18,english,6,77,19,58,34,12,76,8,68,35,14
23,156905,GRADY ISD,18,english,6,18,1,17,17,9,18,0,18,12,3
23,157901,MASON ISD,15,english,6,45,8,37,27,12,45,4,41,22,5
23,158901,BAY CITY ISD,3,english,6,252,71,181,123,59,251,105,146,55,14
23,158902,TIDEHAVEN ISD,3,english,6,67,6,61,52,23,67,7,60,37,24
23,158904,MATAGORDA ISD,3,english,6,5,2,3,1,0,5,1,4,1,0
23,158905,PALACIOS ISD,3,english,6,103,23,80,57,30,103,27,76,29,7
23,158906,VAN VLECK ISD,3,english,6,75,9,66,48,15,75,9,66,30,12
23,159901,EAGLE PASS ISD,20,english,6,898,226,672,417,121,897,176,721,371,126
23,160901,BRADY ISD,15,english,6,54,12,42,25,8,54,7,47,24,5
23,160904,ROCHELLE ISD,15,english,6,17,0,17,14,5,17,0,17,17,7
23,160905,LOHN ISD,15,english,6,12,5,7,2,0,12,6,6,2,0
23,161802,RAPOPORT ACADEM,12,english,6,65,19,46,25,6,65,31,34,17,4
23,161807,HARMONY PUBLIC,12,english,6,911,182,729,509,204,910,208,702,394,172
23,161901,CRAWFORD ISD,12,english,6,48,3,45,36,10,48,3,45,36,19
23,161903,MIDWAY ISD,12,english,6,673,117,556,406,216,670,93,577,358,159
23,161906,LA VEGA ISD,12,english,6,207,38,169,93,28,207,65,142,57,10
23,161907,LORENA ISD,12,english,6,127,8,119,93,50,126,26,100,60,20
23,161908,MART ISD,12,english,6,30,3,27,21,6,30,3,27,12,3
23,161909,MCGREGOR ISD,12,english,6,110,23,87,58,21,108,21,87,50,14
23,161910,MOODY ISD,12,english,6,44,7,37,23,11,38,7,31,15,2
23,161912,RIESEL ISD,12,english,6,34,2,32,25,13,34,4,30,23,9
23,161914,WACO ISD,12,english,6,911,415,496,247,66,914,422,492,146,50
23,161916,WEST ISD,12,english,6,74,11,63,48,17,75,3,72,55,35
23,161918,AXTELL ISD,12,english,6,57,12,45,30,12,57,16,41,21,10
23,161919,BRUCEVILLE-EDDY,12,english,6,43,10,33,15,2,43,13,30,9,0
23,161920,CHINA SPRING IS,12,english,6,247,23,224,169,77,246,36,210,128,50
23,161921,CONNALLY ISD,12,english,6,170,73,97,39,4,172,80,92,13,3
23,161922,ROBINSON ISD,12,english,6,193,19,174,132,52,193,16,177,109,43
23,161923,BOSQUEVILLE ISD,12,english,6,58,7,51,40,16,58,10,48,26,9
23,161924,HALLSBURG ISD,12,english,6,21,3,18,13,3,21,2,19,17,7
23,161925,GHOLSON ISD,12,english,6,21,0,21,11,3,22,8,14,8,4
23,162904,MCMULLEN COUNTY,2,english,6,19,1,18,14,7,19,0,19,14,7
23,163901,DEVINE ISD,20,english,6,130,30,100,63,22,130,24,106,49,16
23,163902,D'HANIS ISD,20,english,6,24,0,24,19,7,24,1,23,16,6
23,163903,NATALIA ISD,20,english,6,94,22,72,36,8,94,42,52,14,1
23,163904,HONDO ISD,20,english,6,133,51,82,42,17,134,43,91,39,13
23,163908,MEDINA VALLEY I,20,english,6,632,83,549,406,179,631,119,512,292,117
23,164901,MENARD ISD,15,english,6,16,4,12,7,3,16,6,10,3,2
23,165802,MIDLAND ACADEMY,18,english,6,35,2,33,23,13,35,5,30,15,6
23,165901,MIDLAND ISD,18,english,6,2065,570,1495,982,358,2059,532,1527,807,324
23,165902,GREENWOOD ISD,18,english,6,264,77,187,108,32,261,87,174,50,10
23,166901,CAMERON ISD,6,english,6,106,30,76,44,10,77,30,47,9,0
23,166902,GAUSE ISD,6,english,6,17,2,15,5,2,17,4,13,2,0
23,166903,MILANO ISD,6,english,6,21,5,16,6,3,21,2,19,8,1
23,166904,ROCKDALE ISD,6,english,6,99,19,80,49,17,99,18,81,35,9
23,166905,THORNDALE ISD,13,english,6,39,5,34,19,6,39,7,32,14,7
23,166907,BUCKHOLTS ISD,12,english,6,6,0,6,1,0,6,3,3,1,0
23,167901,GOLDTHWAITE ISD,12,english,6,32,0,32,20,10,32,0,32,26,9
23,167902,MULLIN ISD,12,english,6,14,5,9,4,1,14,8,6,2,0
23,167904,PRIDDY ISD,12,english,6,6,1,5,2,1,6,1,5,3,1
23,168901,COLORADO ISD,14,english,6,48,9,39,24,12,49,18,31,13,4
23,168902,LORAINE ISD,14,english,6,11,2,9,4,0,11,1,10,4,1
23,168903,WESTBROOK ISD,14,english,6,14,4,10,6,2,14,4,10,4,1
23,169901,BOWIE ISD,9,english,6,112,25,87,52,18,111,32,79,37,10
23,169902,NOCONA ISD,9,english,6,54,7,47,33,18,54,16,38,23,7
23,169906,GOLD BURG ISD,9,english,6,9,3,6,3,2,9,3,6,1,0
23,169908,MONTAGUE ISD,9,english,6,15,0,15,8,2,14,0,14,13,4
23,169909,PRAIRIE VALLEY,9,english,6,0,,,,,0,,,,
23,169910,FORESTBURG ISD,9,english,6,14,3,11,6,2,14,3,11,5,1
23,169911,SAINT JO ISD,9,english,6,21,2,19,14,6,21,1,20,11,8
23,170801,TEXAS SERENITY,4,english,6,22,15,7,3,1,22,14,8,1,0
23,170902,CONROE ISD,6,english,6,5101,786,4315,3340,1804,5100,773,4327,2981,1669
23,170903,MONTGOMERY ISD,6,english,6,753,106,647,479,187,750,102,648,428,209
23,170904,WILLIS ISD,6,english,6,627,187,440,260,77,622,192,430,153,33
23,170906,MAGNOLIA ISD,6,english,6,1008,190,818,585,257,1009,175,834,525,246
23,170907,SPLENDORA ISD,6,english,6,380,118,262,135,26,378,147,231,62,7
23,170908,NEW CANEY ISD,6,english,6,1326,451,875,534,198,1320,456,864,383,139
23,171901,DUMAS ISD,16,english,6,295,66,229,146,57,296,62,234,92,27
23,171902,SUNRAY COLLEGIA,16,english,6,51,12,39,27,11,51,11,40,12,4
23,172902,DAINGERFIELD-LO,8,english,6,58,19,39,15,1,58,31,27,8,2
23,172905,PEWITT CISD,8,english,6,53,8,45,27,11,53,10,43,19,8
23,173901,MOTLEY COUNTY I,17,english,6,13,3,10,6,0,13,0,13,5,1
23,174901,CHIRENO ISD,7,english,6,40,7,33,24,3,40,10,30,15,5
23,174902,CUSHING ISD,7,english,6,34,11,23,11,2,34,9,25,6,0
23,174903,GARRISON ISD,7,english,6,66,13,53,39,18,65,11,54,25,7
23,174904,NACOGDOCHES ISD,7,english,6,433,180,253,130,41,431,170,261,95,33
23,174906,WODEN ISD,7,english,6,65,12,53,33,10,61,14,47,8,0
23,174908,CENTRAL HEIGHTS,7,english,6,99,14,85,55,21,99,17,82,45,20
23,174909,MARTINSVILLE IS,7,english,6,21,1,20,17,10,21,2,19,10,3
23,174911,DOUGLASS ISD,7,english,6,32,6,26,22,14,32,7,25,18,12
23,175902,BLOOMING GROVE,12,english,6,74,23,51,29,7,72,22,50,20,2
23,175903,CORSICANA ISD,12,english,6,419,138,281,154,38,418,116,302,129,35
23,175904,DAWSON ISD,12,english,6,40,8,32,23,10,40,8,32,18,8
23,175905,FROST ISD,12,english,6,29,11,18,12,3,29,10,19,6,0
23,175907,KERENS ISD,12,english,6,43,13,30,14,5,43,9,34,12,5
23,175910,MILDRED ISD,12,english,6,82,17,65,44,16,82,18,64,30,8
23,175911,RICE ISD,12,english,6,70,14,56,34,13,70,13,57,38,9
23,176901,BURKEVILLE ISD,5,english,6,18,10,8,4,0,18,11,7,1,0
23,176902,NEWTON ISD,5,english,6,76,23,53,24,10,76,34,42,14,2
23,176903,DEWEYVILLE ISD,5,english,6,41,6,35,23,9,40,16,24,6,1
23,177901,ROSCOE COLLEGIA,14,english,6,433,156,277,131,38,439,194,245,64,12
23,177902,SWEETWATER ISD,14,english,6,130,41,89,65,27,130,43,87,42,13
23,177903,BLACKWELL CISD,14,english,6,7,0,7,5,2,7,0,7,6,2
23,177905,HIGHLAND ISD,14,english,6,17,2,15,11,2,17,0,17,14,4
23,178801,DR M L GARZA-GO,2,english,6,19,1,18,8,2,19,4,15,4,2
23,178807,CORPUS CHRISTI,2,english,6,13,1,12,7,3,13,4,9,6,0
23,178808,SEASHORE CHARTE,2,english,6,55,7,48,39,19,56,8,48,19,2
23,178901,AGUA DULCE ISD,2,english,6,27,4,23,14,4,27,8,19,5,0
23,178902,BISHOP CISD,2,english,6,95,11,84,55,23,93,14,79,38,14
23,178903,CALALLEN ISD,2,english,6,312,66,246,161,51,297,71,226,104,25
23,178904,CORPUS CHRISTI,2,english,6,2260,656,1604,950,334,2177,874,1303,407,78
23,178905,DRISCOLL ISD,2,english,6,30,4,26,18,8,30,4,26,13,2
23,178906,LONDON ISD,2,english,6,142,9,133,111,62,139,10,129,98,54
23,178908,PORT ARANSAS IS,2,english,6,31,6,25,21,13,31,4,27,17,5
23,178909,ROBSTOWN ISD,2,english,6,157,62,95,50,8,156,74,82,24,2
23,178912,TULOSO-MIDWAY I,2,english,6,255,33,222,161,62,255,46,209,90,25
23,178913,BANQUETE ISD,2,english,6,52,4,48,26,7,52,8,44,22,6
23,178914,FLOUR BLUFF ISD,2,english,6,425,60,365,248,77,358,41,317,158,36
23,178915,WEST OSO ISD,2,english,6,127,45,82,42,3,129,50,79,18,2
23,179901,PERRYTON ISD,16,english,6,141,31,110,59,25,141,34,107,53,10
23,180901,BOYS RANCH ISD,16,english,6,8,3,5,4,1,8,3,5,4,2
23,180902,VEGA ISD,16,english,6,30,1,29,25,13,30,0,30,21,9
23,180903,ADRIAN ISD,16,english,6,9,1,8,4,3,9,2,7,3,0
23,180904,WILDORADO ISD,16,english,6,16,1,15,10,3,16,2,14,7,0
23,181901,BRIDGE CITY ISD,5,english,6,230,50,180,122,38,230,66,164,74,21
23,181905,ORANGEFIELD ISD,5,english,6,126,33,93,67,30,127,37,90,44,13
23,181906,WEST ORANGE-COV,5,english,6,154,65,89,52,17,154,88,66,16,0
23,181907,VIDOR ISD,5,english,6,324,70,254,164,50,325,69,256,148,67
23,181908,LITTLE CYPRESS-,5,english,6,246,75,171,93,31,246,76,170,80,24
23,182901,GORDON ISD,11,english,6,14,2,12,7,3,14,4,10,3,1
23,182902,GRAFORD ISD,11,english,6,32,2,30,17,9,32,3,29,18,3
23,182903,MINERAL WELLS I,11,english,6,216,70,146,80,28,216,51,165,82,39
23,182904,SANTO ISD,11,english,6,36,3,33,27,10,36,6,30,16,5
23,182905,STRAWN ISD,11,english,6,7,4,3,1,0,7,3,4,1,0
23,182906,PALO PINTO ISD,11,english,6,8,1,7,5,3,8,1,7,5,2
23,183901,BECKVILLE ISD,7,english,6,45,11,34,20,6,45,6,39,22,7
23,183902,CARTHAGE ISD,7,english,6,181,40,141,83,24,181,38,143,75,26
23,183904,GARY ISD,7,english,6,32,7,25,17,4,32,3,29,9,3
23,184901,POOLVILLE ISD,11,english,6,55,15,40,24,9,56,10,46,24,8
23,184902,SPRINGTOWN ISD,11,english,6,295,85,210,123,27,294,93,201,92,29
23,184903,WEATHERFORD ISD,11,english,6,570,152,418,265,90,574,144,430,202,56
23,184904,MILLSAP ISD,11,english,6,75,15,60,39,18,76,15,61,33,13
23,184907,ALEDO ISD,11,english,6,604,57,547,444,248,604,70,534,342,141
23,184908,PEASTER ISD,11,english,6,114,16,98,64,18,115,12,103,61,20
23,184909,BROCK ISD,11,english,6,151,5,146,131,78,151,11,140,108,49
23,184911,GARNER ISD,11,english,6,22,5,17,6,1,22,3,19,8,1
23,185901,BOVINA ISD,16,english,6,26,10,16,9,3,26,7,19,10,1
23,185902,FARWELL ISD,16,english,6,40,4,36,23,12,40,2,38,27,11
23,185903,FRIONA ISD,16,english,6,70,11,59,39,14,71,19,52,19,6
23,185904,LAZBUDDIE ISD,16,english,6,13,0,13,6,3,13,0,13,9,4
23,186901,BUENA VISTA ISD,18,english,6,23,4,19,13,4,23,7,16,9,3
23,186902,FORT STOCKTON I,18,english,6,161,69,92,34,4,161,66,95,20,2
23,186903,IRAAN-SHEFFIELD,18,english,6,29,7,22,9,0,28,4,24,12,2
23,187901,BIG SANDY ISD,6,english,6,41,6,35,23,5,41,10,31,10,2
23,187903,GOODRICH ISD,6,english,6,11,4,7,2,2,11,5,6,2,2
23,187904,CORRIGAN-CAMDEN,6,english,6,56,17,39,24,4,56,15,41,12,3
23,187906,LEGGETT ISD,6,english,6,19,10,9,4,2,20,7,13,3,0
23,187907,LIVINGSTON ISD,6,english,6,281,63,218,123,43,280,69,211,92,19
23,187910,ONALASKA ISD,6,english,6,92,21,71,46,19,93,19,74,38,12
23,188901,AMARILLO ISD,16,english,6,2147,518,1629,1024,399,2153,565,1588,750,273
23,188902,RIVER ROAD ISD,16,english,6,84,21,63,34,11,84,14,70,35,16
23,188903,HIGHLAND PARK I,16,english,6,59,14,45,21,7,59,8,51,23,4
23,188904,BUSHLAND ISD,16,english,6,116,13,103,89,57,116,15,101,74,26
23,189901,MARFA ISD,18,english,6,12,3,9,3,0,13,5,8,3,0
23,189902,PRESIDIO ISD,18,english,6,71,16,55,41,15,70,12,58,29,9
23,190903,RAINS ISD,7,english,6,124,35,89,48,11,124,33,91,37,9
23,191901,CANYON ISD,16,english,6,836,117,719,495,188,835,84,751,518,244
23,192901,REAGAN COUNTY I,18,english,6,49,12,37,21,8,49,17,32,8,3
23,193801,BIG SPRINGS CHA,20,english,6,12,5,7,4,0,12,11,1,0,0
23,193902,LEAKEY ISD,20,english,6,24,5,19,9,4,24,4,20,10,2
23,194902,AVERY ISD,8,english,6,32,9,23,11,4,32,8,24,13,1
23,194903,RIVERCREST ISD,8,english,6,55,17,38,23,6,55,10,45,26,9
23,194904,CLARKSVILLE ISD,8,english,6,28,17,11,2,0,28,13,15,2,0
23,194905,DETROIT ISD,8,english,6,42,11,31,15,3,42,4,38,27,16
23,195901,PECOS-BARSTOW-T,18,english,6,191,67,124,65,22,190,76,114,31,4
23,195902,BALMORHEA ISD,18,english,6,6,0,6,2,1,6,0,6,4,2
23,196901,AUSTWELL-TIVOLI,3,english,6,11,2,9,3,2,11,2,9,3,0
23,196902,WOODSBORO ISD,3,english,6,35,12,23,14,3,35,6,29,8,1
23,196903,REFUGIO ISD,3,english,6,42,11,31,19,6,42,13,29,6,0
23,197902,MIAMI ISD,16,english,6,17,2,15,8,3,17,1,16,10,2
23,198901,BREMOND ISD,6,english,6,43,9,34,15,3,43,11,32,4,0
23,198902,CALVERT ISD,6,english,6,7,3,4,2,0,7,4,3,2,0
23,198903,FRANKLIN ISD,6,english,6,95,4,91,73,30,94,2,92,82,43
23,198905,HEARNE ISD,6,english,6,41,26,15,7,1,41,22,19,0,0
23,198906,MUMFORD ISD,6,english,6,38,1,37,31,21,38,1,37,24,9
23,199901,ROCKWALL ISD,10,english,6,1338,155,1183,918,493,1359,100,1259,904,476
23,199902,ROYSE CITY ISD,10,english,6,685,151,534,334,115,681,185,496,206,48
23,200901,BALLINGER ISD,15,english,6,64,29,35,17,3,64,28,36,7,2
23,200902,MILES ISD,15,english,6,40,5,35,26,10,40,5,35,30,19
23,200904,WINTERS ISD,15,english,6,34,4,30,19,3,34,5,29,11,4
23,200906,OLFEN ISD,15,english,6,9,0,9,6,1,9,2,7,4,0
23,201902,HENDERSON ISD,7,english,6,238,100,138,68,13,238,90,148,60,25
23,201903,LANEVILLE ISD,7,english,6,9,3,6,4,1,9,1,8,7,1
23,201904,LEVERETTS CHAPE,7,english,6,16,4,12,5,3,16,9,7,3,1
23,201907,MOUNT ENTERPRIS,7,english,6,32,8,24,15,9,32,9,23,12,5
23,201908,OVERTON ISD,7,english,6,35,10,25,18,4,35,5,30,17,8
23,201910,TATUM ISD,7,english,6,105,11,94,67,32,105,20,85,51,22
23,201913,CARLISLE ISD,7,english,6,37,5,32,18,1,37,7,30,12,4
23,201914,WEST RUSK COUNT,7,english,6,85,13,72,46,16,85,26,59,20,3
23,202903,HEMPHILL ISD,7,english,6,61,12,49,28,6,61,16,45,17,2
23,202905,WEST SABINE ISD,7,english,6,42,14,28,10,2,42,19,23,3,0
23,203901,SAN AUGUSTINE I,7,english,6,37,16,21,11,2,37,13,24,11,3
23,203902,BROADDUS ISD,7,english,6,27,3,24,20,6,27,2,25,19,7
23,204901,COLDSPRING-OAKH,6,english,6,107,45,62,27,7,107,37,70,32,6
23,204904,SHEPHERD ISD,6,english,6,142,69,73,32,4,141,72,69,22,1
23,205901,ARANSAS PASS IS,2,english,6,127,50,77,44,10,131,53,78,17,3
23,205902,GREGORY-PORTLAN,2,english,6,346,47,299,209,89,345,66,279,171,86
23,205903,INGLESIDE ISD,2,english,6,147,27,120,85,27,147,27,120,59,11
23,205904,MATHIS ISD,2,english,6,112,18,94,53,16,111,30,81,26,7
23,205905,ODEM-EDROY ISD,2,english,6,65,19,46,21,5,65,25,40,11,2
23,205906,SINTON ISD,2,english,6,127,35,92,59,19,126,41,85,32,2
23,205907,TAFT ISD,2,english,6,51,26,25,14,5,51,22,29,9,1
23,206901,SAN SABA ISD,15,english,6,47,8,39,24,9,47,12,35,10,3
23,206902,RICHLAND SPRING,15,english,6,6,0,6,4,1,6,0,6,2,0
23,206903,CHEROKEE ISD,15,english,6,10,1,9,6,5,10,0,10,5,2
23,207901,SCHLEICHER ISD,15,english,6,25,7,18,9,4,25,1,24,12,6
23,208901,HERMLEIGH ISD,14,english,6,25,5,20,11,2,25,5,20,7,2
23,208902,SNYDER ISD,14,english,6,174,66,108,39,12,174,67,107,34,10
23,208903,IRA ISD,14,english,6,22,2,20,18,13,21,2,19,16,10
23,209901,ALBANY ISD,14,english,6,32,4,28,22,12,32,7,25,13,4
23,209902,MORAN ISD,14,english,6,12,5,7,3,0,12,6,6,1,0
23,210901,CENTER ISD,7,english,6,171,49,122,77,20,171,49,122,45,10
23,210902,JOAQUIN ISD,7,english,6,38,9,29,21,7,37,5,32,16,2
23,210903,SHELBYVILLE ISD,7,english,6,56,13,43,25,14,56,15,41,14,3
23,210904,TENAHA ISD,7,english,6,31,16,15,6,1,31,7,24,11,4
23,210905,TIMPSON ISD,7,english,6,48,21,27,17,7,48,13,35,11,1
23,210906,EXCELSIOR ISD,7,english,6,5,0,5,0,0,5,0,5,0,0
23,211902,STRATFORD ISD,16,english,6,42,8,34,29,13,42,10,32,19,6
23,212801,CUMBERLAND ACAD,7,english,6,130,26,104,66,29,131,44,87,26,8
23,212804,UT TYLER UNIVER,7,english,6,73,5,68,56,32,73,5,68,44,20
23,212901,ARP ISD,7,english,6,68,15,53,27,5,69,17,52,12,1
23,212902,BULLARD ISD,7,english,6,230,38,192,138,60,230,29,201,138,71
23,212903,LINDALE ISD,7,english,6,327,52,275,226,126,324,34,290,215,138
23,212904,TROUP ISD,7,english,6,77,16,61,42,20,76,17,59,31,11
23,212905,TYLER ISD,7,english,6,1274,318,956,644,280,1278,366,912,450,179
23,212906,WHITEHOUSE ISD,7,english,6,367,41,326,225,112,374,40,334,232,104
23,212909,CHAPEL HILL ISD,7,english,6,208,40,168,110,35,206,47,159,77,23
23,212910,WINONA ISD,7,english,6,76,12,64,49,19,76,17,59,32,11
23,213801,BRAZOS RIVER CH,11,english,6,0,,,,,0,,,,
23,213901,GLEN ROSE ISD,11,english,6,138,10,128,112,54,88,16,72,18,0
23,214901,RIO GRANDE CITY,1,english,6,664,247,417,218,65,662,260,402,149,27
23,214902,SAN ISIDRO ISD,1,english,6,7,3,4,3,2,7,3,4,0,0
23,214903,ROMA ISD,1,english,6,454,107,347,232,86,453,138,315,154,40
23,215901,BRECKENRIDGE IS,14,english,6,87,24,63,35,16,87,19,68,41,20
23,216901,STERLING CITY I,15,english,6,18,1,17,11,2,18,1,17,6,2
23,217901,ASPERMONT ISD,14,english,6,11,3,8,3,2,11,0,11,4,2
23,218901,SONORA ISD,15,english,6,49,5,44,30,12,49,6,43,30,17
23,219901,HAPPY ISD,16,english,6,17,2,15,8,3,17,1,16,5,2
23,219903,TULIA ISD,16,english,6,45,29,16,9,3,46,25,21,4,1
23,219905,KRESS ISD,16,english,6,22,7,15,9,2,22,3,19,10,4
23,220801,TREETOPS SCHOOL,11,english,6,32,1,31,24,9,32,8,24,13,4
23,220802,ARLINGTON CLASS,11,english,6,178,15,163,118,61,178,20,158,100,38
23,220809,FORT WORTH ACAD,11,english,6,86,6,80,63,28,82,17,65,26,5
23,220810,WESTLAKE ACADEM,11,english,6,76,1,75,68,47,74,1,73,61,43
23,220815,CHAPEL HILL ACA,11,english,6,82,18,64,45,17,82,22,60,20,4
23,220817,NEWMAN INTERNAT,11,english,6,204,22,182,114,38,204,48,156,60,20
23,220819,HIGH POINT ACAD,11,english,6,109,13,96,69,26,110,40,70,23,4
23,220901,ARLINGTON ISD,11,english,6,3798,1108,2690,1638,607,3803,1112,2691,1302,492
23,220902,BIRDVILLE ISD,11,english,6,1635,402,1233,842,357,1638,401,1237,643,226
23,220904,EVERMAN ISD,11,english,6,369,153,216,102,23,367,172,195,59,14
23,220905,FORT WORTH ISD,11,english,6,4562,1976,2586,1360,436,4301,1968,2333,617,122
23,220906,GRAPEVINE-COLLE,11,english,6,1038,140,898,701,377,1029,146,883,586,308
23,220907,KELLER ISD,11,english,6,2520,354,2166,1645,766,2623,323,2300,1483,751
23,220908,MANSFIELD ISD,11,english,6,2594,459,2135,1451,582,2590,466,2124,1245,476
23,220910,LAKE WORTH ISD,11,english,6,239,105,134,66,22,177,100,77,13,0
23,220912,CROWLEY ISD,11,english,6,1199,416,783,428,132,1195,497,698,193,39
23,220914,KENNEDALE ISD,11,english,6,196,45,151,102,46,198,56,142,58,22
23,220915,AZLE ISD,11,english,6,517,108,409,261,79,516,101,415,229,69
23,220916,HURST-EULESS-BE,11,english,6,1602,177,1425,1121,588,1600,166,1434,993,519
23,220917,CASTLEBERRY ISD,11,english,6,292,90,202,129,42,289,122,167,62,11
23,220918,EAGLE MT-SAGINA,11,english,6,1700,393,1307,867,303,1691,443,1248,544,163
23,220919,CARROLL ISD,11,english,6,634,18,616,577,428,470,18,452,373,235
23,220920,WHITE SETTLEMEN,11,english,6,476,92,384,259,86,477,152,325,133,36
23,221801,TEXAS COLLEGE P,14,english,6,1356,201,1155,820,317,1356,243,1113,541,185
23,221901,ABILENE ISD,14,english,6,1049,345,704,413,135,1043,396,647,223,76
23,221904,MERKEL ISD,14,english,6,74,17,57,35,13,74,22,52,25,4
23,221905,TRENT ISD,14,english,6,16,9,7,5,2,15,8,7,3,2
23,221911,JIM NED CISD,14,english,6,107,3,104,89,48,107,10,97,49,15
23,221912,WYLIE ISD,14,english,6,429,49,380,282,125,430,52,378,200,67
23,222901,TERRELL COUNTY,18,english,6,7,1,6,6,2,7,0,7,4,4
23,223901,BROWNFIELD ISD,17,english,6,104,43,61,33,11,104,41,63,16,3
23,223902,MEADOW ISD,17,english,6,14,4,10,7,2,14,3,11,5,1
23,223904,WELLMAN-UNION C,17,english,6,16,0,16,12,4,16,4,12,6,2
23,224901,THROCKMORTON CO,9,english,6,5,1,4,1,1,5,3,2,0,0
23,224902,WOODSON ISD,9,english,6,5,1,4,0,0,5,0,5,1,0
23,225902,MOUNT PLEASANT,8,english,6,316,70,246,171,62,316,73,243,104,33
23,225906,CHAPEL HILL ISD,8,english,6,81,3,78,64,28,81,3,78,51,22
23,225907,HARTS BLUFF ISD,8,english,6,65,16,49,33,12,65,13,52,24,6
23,226801,TEXAS LEADERSHI,15,english,6,304,68,236,149,42,303,80,223,100,30
23,226901,CHRISTOVAL ISD,15,english,6,48,8,40,24,6,48,7,41,21,5
23,226903,SAN ANGELO ISD,15,english,6,927,308,619,359,137,923,313,610,235,73
23,226905,WATER VALLEY IS,15,english,6,22,1,21,14,5,22,2,20,12,3
23,226906,WALL ISD,15,english,6,94,4,90,76,44,94,4,90,66,24
23,226907,GRAPE CREEK ISD,15,english,6,81,21,60,36,8,82,26,56,18,3
23,226908,VERIBEST ISD,15,english,6,19,2,17,16,6,19,1,18,11,3
23,227803,WAYSIDE SCHOOLS,13,english,6,113,52,61,30,6,0,,,,
23,227804,NYOS CHARTER SC,13,english,6,153,18,135,105,49,149,20,129,80,35
23,227805,TEXAS EMPOWERME,13,english,6,33,6,27,15,5,33,4,29,18,5
23,227806,UNIVERSITY OF T,13,english,6,58,30,28,17,7,59,30,29,13,6
23,227814,CHAPARRAL STAR,13,english,6,28,2,26,24,12,29,1,28,18,6
23,227816,HARMONY PUBLIC,13,english,6,336,106,230,159,77,335,88,247,138,88
23,227817,CEDARS INTERNAT,13,english,6,30,5,25,12,4,30,4,26,9,1
23,227820,KIPP TEXAS PUBL,4,english,6,2581,845,1736,964,320,2580,1049,1531,479,90
23,227821,AUSTIN DISCOVER,13,english,6,14,4,10,10,5,14,6,8,4,2
23,227824,VALERE PUBLIC S,13,english,6,67,15,52,29,6,67,18,49,17,1
23,227825,AUSTIN ACHIEVE,13,english,6,158,58,100,41,9,159,73,86,23,9
23,227826,MONTESSORI FOR,13,english,6,14,3,11,7,6,14,2,12,7,4
23,227829,VALOR PUBLIC SC,13,english,6,192,19,173,139,78,190,25,165,105,51
23,227901,AUSTIN ISD,13,english,6,4779,1351,3428,2500,1339,4484,1475,3009,1594,610
23,227904,PFLUGERVILLE IS,13,english,6,1778,436,1342,880,364,1764,494,1270,569,180
23,227905,TEXAS SCH FOR T,13,english,6,0,,,,,0,,,,
23,227906,TEXAS SCH FOR T,13,english,6,18,18,0,0,0,18,15,3,0,0
23,227907,MANOR ISD,13,english,6,655,252,403,199,60,660,313,347,108,31
23,227909,EANES ISD,13,english,6,608,20,588,507,311,276,17,259,196,54
23,227910,DEL VALLE ISD,13,english,6,800,379,421,225,62,797,427,370,111,20
23,227912,LAGO VISTA ISD,13,english,6,135,26,109,78,37,134,24,110,69,24
23,227913,LAKE TRAVIS ISD,13,english,6,860,94,766,621,345,912,83,829,612,299
23,228901,GROVETON ISD,6,english,6,62,14,48,36,21,62,4,58,35,18
23,228903,TRINITY ISD,6,english,6,99,31,68,38,17,99,36,63,23,4
23,228904,CENTERVILLE ISD,6,english,6,13,7,6,4,1,13,2,11,4,0
23,228905,APPLE SPRINGS I,6,english,6,12,1,11,9,4,13,0,13,10,5
23,229901,COLMESNEIL ISD,5,english,6,36,9,27,14,2,36,10,26,11,3
23,229903,WOODVILLE ISD,5,english,6,85,29,56,26,9,84,33,51,17,4
23,229904,WARREN ISD,5,english,6,99,18,81,48,15,98,19,79,33,6
23,229905,SPURGER ISD,5,english,6,23,2,21,17,5,23,1,22,13,5
23,229906,CHESTER ISD,5,english,6,17,4,13,9,4,17,3,14,7,4
23,230901,BIG SANDY ISD,7,english,6,49,16,33,18,6,49,15,34,10,2
23,230902,GILMER ISD,7,english,6,187,33,154,114,53,187,25,162,87,36
23,230903,ORE CITY ISD,7,english,6,57,20,37,24,6,46,21,25,10,2
23,230904,UNION HILL ISD,7,english,6,23,9,14,10,7,23,13,10,6,1
23,230905,HARMONY ISD,7,english,6,88,6,82,62,37,88,7,81,50,19
23,230906,NEW DIANA ISD,7,english,6,94,11,83,64,35,94,11,83,41,15
23,230908,UNION GROVE ISD,7,english,6,51,3,48,38,19,51,7,44,30,17
23,231901,MCCAMEY ISD,18,english,6,31,15,16,6,0,31,13,18,6,4
23,231902,RANKIN ISD,18,english,6,21,4,17,10,6,21,7,14,6,4
23,232901,KNIPPA ISD,20,english,6,30,1,29,27,14,30,0,30,21,12
23,232902,SABINAL ISD,20,english,6,28,9,19,16,7,28,6,22,13,4
23,232903,UVALDE CISD,20,english,6,284,92,192,111,35,282,98,184,75,19
23,232904,UTOPIA ISD,20,english,6,15,3,12,6,2,15,8,7,0,0
23,233901,SAN FELIPE-DEL,15,english,6,664,213,451,268,95,661,148,513,248,75
23,233903,COMSTOCK ISD,15,english,6,21,7,14,9,2,21,5,16,6,1
23,234801,RANCH ACADEMY,7,english,6,0,,,,,0,,,,
23,234902,CANTON ISD,10,english,6,182,28,154,106,42,182,17,165,97,35
23,234903,EDGEWOOD ISD,7,english,6,78,20,58,42,11,78,14,64,26,8
23,234904,GRAND SALINE IS,7,english,6,84,26,58,36,12,83,23,60,25,9
23,234905,MARTINS MILL IS,7,english,6,43,7,36,27,8,42,9,33,16,8
23,234906,VAN ISD,7,english,6,167,19,148,110,50,167,17,150,94,39
23,234907,WILLS POINT ISD,10,english,6,208,64,144,74,24,207,74,133,48,13
23,234909,FRUITVALE ISD,7,english,6,25,3,22,17,4,24,2,22,9,2
23,235901,BLOOMINGTON ISD,3,english,6,60,40,20,9,5,58,39,19,3,0
23,235902,VICTORIA ISD,3,english,6,881,328,553,311,85,877,349,528,198,57
23,236802,SAM HOUSTON STA,6,english,6,25,2,23,21,12,25,1,24,17,7
23,236901,NEW WAVERLY ISD,6,english,6,88,22,66,38,11,88,24,64,20,6
23,236902,HUNTSVILLE ISD,6,english,6,981,258,723,475,173,980,321,659,234,69
23,237902,HEMPSTEAD ISD,4,english,6,94,41,53,24,6,93,52,41,9,3
23,237904,WALLER ISD,4,english,6,661,209,452,273,102,661,275,386,126,39
23,237905,ROYAL ISD,4,english,6,189,80,109,60,13,189,69,120,36,12
23,238902,MONAHANS-WICKET,18,english,6,171,61,110,67,20,171,56,115,57,23
23,238904,GRANDFALLS-ROYA,18,english,6,8,3,5,3,0,8,3,5,4,0
23,239901,BRENHAM ISD,6,english,6,357,82,275,159,56,357,103,254,118,37
23,239903,BURTON ISD,6,english,6,31,1,30,21,13,31,1,30,24,15
23,240901,LAREDO ISD,1,english,6,1333,511,822,480,180,1334,496,838,358,114
23,240903,UNITED ISD,1,english,6,3067,678,2389,1708,751,3058,580,2478,1311,346
23,240904,WEBB CISD,1,english,6,16,6,10,5,3,16,5,11,6,2
23,241901,BOLING ISD,3,english,6,90,6,84,59,17,90,11,79,44,11
23,241902,EAST BERNARD IS,3,english,6,75,13,62,41,11,75,13,62,37,13
23,241903,EL CAMPO ISD,3,english,6,234,68,166,108,47,235,69,166,55,17
23,241904,WHARTON ISD,3,english,6,92,44,48,20,5,92,57,35,9,4
23,241906,LOUISE ISD,3,english,6,43,3,40,28,15,43,7,36,27,10
23,242902,SHAMROCK ISD,16,english,6,19,7,12,6,2,19,5,14,4,0
23,242903,WHEELER ISD,16,english,6,34,1,33,21,9,34,2,32,20,5
23,242905,KELTON ISD,16,english,6,13,1,12,9,4,13,3,10,6,2
23,242906,FORT ELLIOTT CI,16,english,6,13,2,11,9,1,13,2,11,5,2
23,243901,BURKBURNETT ISD,9,english,6,231,77,154,89,25,230,51,179,78,15
23,243902,ELECTRA ISD,9,english,6,33,9,24,13,3,33,6,27,10,1
23,243903,IOWA PARK CISD,9,english,6,134,20,114,87,38,134,23,111,69,17
23,243905,WICHITA FALLS I,9,english,6,884,310,574,315,102,880,277,603,293,98
23,243906,CITY VIEW ISD,9,english,6,92,19,73,43,16,92,19,73,30,9
23,244901,HARROLD ISD,9,english,6,15,3,12,9,4,15,4,11,5,3
23,244903,VERNON ISD,9,english,6,120,48,72,35,9,120,54,66,25,4
23,244905,NORTHSIDE ISD,9,english,6,22,10,12,7,3,22,5,17,9,3
23,245901,LASARA ISD,1,english,6,32,9,23,11,3,33,18,15,2,0
23,245902,LYFORD CISD,1,english,6,90,37,53,33,12,91,38,53,19,1
23,245903,RAYMONDVILLE IS,1,english,6,147,32,115,80,32,145,32,113,48,11
23,245904,SAN PERLITA ISD,1,english,6,8,1,7,6,3,8,0,8,2,0
23,246801,MERIDIAN WORLD,13,english,6,149,10,139,117,74,130,11,119,83,42
23,246802,GOODWATER MONTE,13,english,6,16,3,13,6,4,16,5,11,3,0
23,246902,FLORENCE ISD,13,english,6,98,45,53,32,10,97,42,55,17,3
23,246904,GEORGETOWN ISD,13,english,6,964,267,697,430,135,850,274,576,210,31
23,246905,GRANGER ISD,13,english,6,40,7,33,14,3,40,13,27,11,3
23,246906,HUTTO ISD,13,english,6,679,146,533,361,142,674,164,510,221,52
23,246907,JARRELL ISD,13,english,6,269,89,180,101,34,267,106,161,50,5
23,246908,LIBERTY HILL IS,13,english,6,647,94,553,419,172,644,108,536,290,116
23,246909,ROUND ROCK ISD,13,english,6,3417,511,2906,2317,1395,3382,475,2907,2045,1122
23,246911,TAYLOR ISD,13,english,6,205,75,130,65,18,204,84,120,33,6
23,246912,THRALL ISD,13,english,6,63,9,54,42,19,63,9,54,39,18
23,246913,LEANDER ISD,13,english,6,3130,433,2697,2019,1007,3111,438,2673,1733,859
23,246914,COUPLAND ISD,13,english,6,32,6,26,16,4,32,7,25,11,3
23,247901,FLORESVILLE ISD,20,english,6,276,59,217,145,50,275,84,191,81,27
23,247903,LA VERNIA ISD,20,english,6,252,42,210,150,54,252,37,215,129,40
23,247904,POTH ISD,20,english,6,80,5,75,54,25,80,4,76,58,31
23,247906,STOCKDALE ISD,20,english,6,56,13,43,31,14,56,12,44,22,7
23,248901,KERMIT ISD,18,english,6,100,46,54,31,11,100,32,68,27,13
23,248902,WINK-LOVING ISD,18,english,6,26,2,24,19,14,26,0,26,19,12
23,249901,ALVORD ISD,11,english,6,65,11,54,37,9,65,8,57,40,14
23,249902,BOYD ISD,11,english,6,106,22,84,54,13,106,27,79,32,11
23,249903,BRIDGEPORT ISD,11,english,6,146,42,104,61,12,147,37,110,45,9
23,249904,CHICO ISD,11,english,6,40,9,31,17,4,40,10,30,9,2
23,249905,DECATUR ISD,11,english,6,296,60,236,144,48,295,55,240,128,31
23,249906,PARADISE ISD,11,english,6,118,14,104,72,27,118,13,105,52,23
23,249908,SLIDELL ISD,11,english,6,37,7,30,14,3,37,15,22,6,4
23,250902,HAWKINS ISD,7,english,6,51,11,40,18,5,51,14,37,14,5
23,250903,MINEOLA ISD,7,english,6,118,12,106,77,30,119,6,113,71,29
23,250904,QUITMAN ISD,7,english,6,90,19,71,40,9,90,20,70,23,2
23,250905,YANTIS ISD,7,english,6,20,5,15,3,1,20,5,15,4,1
23,250906,ALBA-GOLDEN ISD,7,english,6,70,22,48,21,4,70,23,47,14,1
23,250907,WINNSBORO ISD,7,english,6,87,20,67,45,15,86,22,64,27,9
23,251901,DENVER CITY ISD,17,english,6,110,29,81,39,11,110,36,74,33,11
23,251902,PLAINS ISD,17,english,6,28,9,19,15,4,28,5,23,12,4
23,252901,GRAHAM ISD,9,english,6,165,47,118,73,17,167,52,115,55,20
23,252902,NEWCASTLE ISD,9,english,6,17,3,14,9,2,17,3,14,9,4
23,252903,OLNEY ISD,9,english,6,46,8,38,28,14,47,5,42,29,9
23,253901,ZAPATA COUNTY I,1,english,6,246,94,152,83,18,246,91,155,49,12
23,254901,CRYSTAL CITY IS,20,english,6,107,38,69,26,2,107,34,73,20,1
23,254902,LA PRYOR ISD,20,english,6,25,5,20,12,4,25,9,16,9,4
23,1902,CAYUGA ISD,7,english,7,54,3,51,45,26,53,10,43,27,12
23,1903,ELKHART ISD,7,english,7,92,25,67,45,20,92,31,61,32,3
23,1904,FRANKSTON ISD,7,english,7,63,9,54,37,17,63,20,43,28,4
23,1906,NECHES ISD,7,english,7,24,2,22,13,5,24,0,24,24,9
23,1907,PALESTINE ISD,7,english,7,215,54,161,91,39,215,79,136,77,17
23,1908,WESTWOOD ISD,7,english,7,101,29,72,40,15,84,57,27,4,0
23,1909,SLOCUM ISD,7,english,7,26,4,22,15,4,26,7,19,11,1
23,2901,ANDREWS ISD,18,english,7,296,62,234,152,66,294,80,214,136,44
23,3801,PINEYWOODS COMM,7,english,7,76,18,58,37,24,77,26,51,34,10
23,3902,HUDSON ISD,7,english,7,206,20,186,145,76,205,21,184,142,62
23,3903,LUFKIN ISD,7,english,7,480,147,333,193,78,482,230,252,154,61
23,3904,HUNTINGTON ISD,7,english,7,109,19,90,58,27,110,21,89,52,13
23,3905,DIBOLL ISD,7,english,7,107,25,82,48,17,106,23,83,48,10
23,3906,ZAVALLA ISD,7,english,7,27,3,24,13,6,27,9,18,13,3
23,3907,CENTRAL ISD,7,english,7,103,21,82,52,20,103,38,65,27,4
23,4901,ARANSAS COUNTY,2,english,7,240,83,157,103,45,172,112,60,15,0
23,5901,ARCHER CITY ISD,9,english,7,31,1,30,24,18,31,4,27,22,10
23,5902,HOLLIDAY ISD,9,english,7,83,4,79,67,48,82,11,71,55,24
23,5904,WINDTHORST ISD,9,english,7,38,1,37,33,13,38,3,35,27,7
23,6902,CLAUDE ISD,16,english,7,24,4,20,13,6,24,4,20,14,7
23,7901,CHARLOTTE ISD,20,english,7,32,9,23,8,4,31,16,15,8,0
23,7902,JOURDANTON ISD,20,english,7,129,27,102,63,24,129,22,107,82,31
23,7904,LYTLE ISD,20,english,7,131,44,87,49,10,131,59,72,35,6
23,7905,PLEASANTON ISD,20,english,7,226,56,170,114,51,229,88,141,90,21
23,7906,POTEET ISD,20,english,7,143,34,109,68,25,87,52,35,6,0
23,8901,BELLVILLE ISD,6,english,7,202,37,165,115,65,204,68,136,98,51
23,8902,SEALY ISD,6,english,7,221,56,165,91,26,149,63,86,24,2
23,8903,BRAZOS ISD,6,english,7,72,10,62,46,20,72,19,53,35,9
23,9901,MULESHOE ISD,17,english,7,84,33,51,29,9,85,51,34,15,2
23,10901,MEDINA ISD,20,english,7,11,3,8,6,2,7,3,4,2,0
23,10902,BANDERA ISD,20,english,7,175,47,128,79,35,171,63,108,61,17
23,11901,BASTROP ISD,13,english,7,929,361,568,308,113,637,439,198,46,1
23,11902,ELGIN ISD,13,english,7,381,132,249,116,33,0,,,,
23,11904,SMITHVILLE ISD,13,english,7,118,32,86,58,35,84,47,37,16,1
23,11905,MCDADE ISD,13,english,7,22,6,16,7,4,22,7,15,8,3
23,12901,SEYMOUR ISD,9,english,7,45,5,40,27,14,42,4,38,29,16
23,13901,BEEVILLE ISD,2,english,7,222,61,161,100,43,193,111,82,38,1
23,13902,PAWNEE ISD,2,english,7,9,0,9,9,5,9,1,8,5,1
23,13903,PETTUS ISD,2,english,7,35,6,29,18,11,35,17,18,9,0
23,13905,SKIDMORE-TYNAN,2,english,7,61,4,57,41,17,61,10,51,35,2
23,14803,PRIORITY CHARTE,12,english,7,43,15,28,19,8,42,22,20,10,4
23,14804,ORENDA CHARTER,12,english,7,163,8,155,129,83,159,28,131,100,31
23,14901,ACADEMY ISD,12,english,7,134,11,123,102,54,104,25,79,41,3
23,14902,BARTLETT ISD,13,english,7,26,12,14,8,1,26,13,13,5,0
23,14903,BELTON ISD,12,english,7,981,215,766,510,238,579,284,295,96,5
23,14905,HOLLAND ISD,12,english,7,45,6,39,30,10,45,5,40,30,12
23,14906,KILLEEN ISD,12,english,7,2809,762,2047,1163,414,2616,1055,1561,741,137
23,14907,ROGERS ISD,12,english,7,74,17,57,40,17,74,27,47,34,13
23,14908,SALADO ISD,12,english,7,217,41,176,121,53,214,50,164,110,39
23,14909,TEMPLE ISD,12,english,7,580,190,390,247,101,462,255,207,90,6
23,14910,TROY ISD,12,english,7,130,11,119,97,41,129,27,102,62,13
23,15802,GEORGE GERVIN A,20,english,7,20,8,12,9,5,20,10,10,3,2
23,15806,LEGACY TRADITIO,20,english,7,66,16,50,30,9,66,39,27,9,1
23,15807,SOUTHWEST PREPA,20,english,7,68,26,42,15,4,70,36,34,13,1
23,15808,INSPIRE ACADEMI,20,english,7,58,16,42,25,9,58,35,23,11,3
23,15809,BEXAR COUNTY AC,20,english,7,19,8,11,5,2,19,16,3,2,1
23,15815,HERITAGE ACADEM,20,english,7,95,26,69,35,15,95,45,50,23,3
23,15822,JUBILEE ACADEMI,20,english,7,550,218,332,164,58,547,334,213,85,13
23,15825,LIGHTHOUSE PUBL,20,english,7,26,13,13,2,0,26,20,6,0,0
23,15827,SCHOOL OF SCIEN,20,english,7,373,49,324,234,109,372,94,278,176,65
23,15828,HARMONY PUBLIC,20,english,7,457,109,348,253,143,457,158,299,194,62
23,15830,BROOKS ACADEMIE,20,english,7,240,75,165,89,26,212,119,93,35,7
23,15831,SCHOOL OF SCIEN,20,english,7,413,27,386,308,181,411,86,325,227,91
23,15834,BASIS TEXAS,20,english,7,324,2,322,301,223,19,0,19,19,18
23,15835,GREAT HEARTS TE,20,english,7,930,57,873,699,404,928,151,777,548,195
23,15836,ELEANOR KOLITZ,20,english,7,49,0,49,45,26,33,3,30,20,0
23,15838,COMPASS ROSE PU,20,english,7,239,95,144,95,33,233,125,108,47,10
23,15840,SAN ANTONIO PRE,20,english,7,30,12,18,8,1,32,20,12,2,0
23,15901,ALAMO HEIGHTS I,20,english,7,363,42,321,270,167,148,52,96,39,5
23,15904,HARLANDALE ISD,20,english,7,848,283,565,284,72,595,330,265,79,2
23,15905,EDGEWOOD ISD,20,english,7,563,251,312,134,33,568,326,242,98,14
23,15906,RANDOLPH FIELD,20,english,7,120,4,116,91,48,92,9,83,68,13
23,15907,SAN ANTONIO ISD,20,english,7,2907,1262,1645,919,387,2862,1671,1191,560,116
23,15908,SOUTH SAN ANTON,20,english,7,559,279,280,125,48,459,343,116,27,2
23,15909,SOMERSET ISD,20,english,7,316,69,247,154,74,313,83,230,158,62
23,15910,NORTH EAST ISD,20,english,7,4222,885,3337,2317,1195,2560,1031,1529,676,78
23,15911,EAST CENTRAL IS,20,english,7,791,253,538,295,104,0,,,,
23,15912,SOUTHWEST ISD,20,english,7,1022,340,682,392,133,1027,515,512,238,49
23,15913,LACKLAND ISD,20,english,7,57,4,53,47,21,46,5,41,25,5
23,15914,FT SAM HOUSTON,20,english,7,117,11,106,85,52,92,28,64,40,8
23,15915,NORTHSIDE ISD,20,english,7,7315,1680,5635,3776,1654,4479,2170,2309,898,74
23,15916,JUDSON ISD,20,english,7,1554,473,1081,630,225,1191,708,483,129,7
23,15917,SOUTHSIDE ISD,20,english,7,427,158,269,164,69,424,172,252,153,47
23,16901,JOHNSON CITY IS,13,english,7,60,11,49,34,13,42,13,29,11,1
23,16902,BLANCO ISD,13,english,7,79,9,70,50,19,52,6,46,27,4
23,17901,BORDEN COUNTY I,17,english,7,13,2,11,9,4,13,1,12,9,4
23,18901,CLIFTON ISD,12,english,7,70,15,55,34,18,56,20,36,16,1
23,18902,MERIDIAN ISD,12,english,7,23,8,15,7,1,23,12,11,3,0
23,18903,MORGAN ISD,12,english,7,8,2,6,4,0,8,3,5,3,0
23,18904,VALLEY MILLS IS,12,english,7,48,11,37,14,5,48,21,27,19,3
23,18905,WALNUT SPRINGS,12,english,7,10,4,6,3,0,10,4,6,1,0
23,18906,IREDELL ISD,12,english,7,8,2,6,2,0,8,4,4,1,0
23,18907,KOPPERL ISD,12,english,7,13,3,10,7,4,13,5,8,6,1
23,18908,CRANFILLS GAP I,12,english,7,8,2,6,3,1,8,2,6,3,0
23,19901,DEKALB ISD,8,english,7,59,13,46,22,8,58,14,44,21,4
23,19902,HOOKS ISD,8,english,7,77,11,66,44,16,76,26,50,25,9
23,19903,MAUD ISD,8,english,7,31,1,30,20,12,31,3,28,17,8
23,19905,NEW BOSTON ISD,8,english,7,89,21,68,42,17,89,20,69,45,14
23,19906,REDWATER ISD,8,english,7,91,3,88,76,32,74,10,64,41,2
23,19907,TEXARKANA ISD,8,english,7,468,118,350,225,116,463,168,295,141,31
23,19908,LIBERTY-EYLAU I,8,english,7,131,59,72,43,13,131,74,57,23,2
23,19909,SIMMS ISD,8,english,7,43,4,39,24,11,43,8,35,27,2
23,19911,RED LICK ISD,8,english,7,54,3,51,45,33,35,5,30,14,1
23,19912,PLEASANT GROVE,8,english,7,172,16,156,114,55,172,38,134,90,30
23,19913,HUBBARD ISD,8,english,7,8,0,8,6,4,8,2,6,4,1
23,19914,LEARY ISD,8,english,7,6,1,5,4,0,7,2,5,2,1
23,20901,ALVIN ISD,4,english,7,2211,376,1835,1323,743,1946,646,1300,750,129
23,20902,ANGLETON ISD,4,english,7,532,127,405,243,105,535,160,375,231,55
23,20904,DANBURY ISD,4,english,7,49,10,39,28,13,48,13,35,20,3
23,20905,BRAZOSPORT ISD,4,english,7,872,197,675,421,163,623,291,332,122,8
23,20906,SWEENY ISD,4,english,7,146,29,117,76,19,119,34,85,39,1
23,20907,COLUMBIA-BRAZOR,4,english,7,231,63,168,113,56,231,88,143,84,22
23,20908,PEARLAND ISD,4,english,7,1687,144,1543,1285,872,910,308,602,302,39
23,20910,DAMON ISD,4,english,7,6,2,4,4,1,6,3,3,2,2
23,21901,COLLEGE STATION,6,english,7,1055,179,876,647,366,626,243,383,193,23
23,21902,BRYAN ISD,6,english,7,1064,372,692,392,161,1062,515,547,299,83
23,22004,TERLINGUA CSD,18,english,7,5,3,2,0,0,5,4,1,1,0
23,22901,ALPINE ISD,18,english,7,66,5,61,43,15,66,17,49,36,6
23,22902,MARATHON ISD,18,english,7,0,,,,,0,,,,
23,22903,SAN VICENTE ISD,18,english,7,0,,,,,0,,,,
23,23902,SILVERTON ISD,16,english,7,11,1,10,7,4,11,1,10,7,1
23,24901,BROOKS COUNTY I,1,english,7,95,24,71,35,5,92,41,51,21,5
23,25901,BANGS ISD,15,english,7,65,10,55,37,18,65,27,38,17,3
23,25902,BROWNWOOD ISD,15,english,7,234,64,170,108,42,233,87,146,100,32
23,25904,BLANKET ISD,15,english,7,9,0,9,5,3,9,2,7,2,0
23,25905,MAY ISD,15,english,7,22,1,21,17,4,22,4,18,10,2
23,25906,ZEPHYR ISD,15,english,7,20,2,18,14,6,20,6,14,5,2
23,25908,BROOKESMITH ISD,15,english,7,16,6,10,4,3,16,7,9,4,1
23,25909,EARLY ISD,15,english,7,96,10,86,59,22,96,10,86,56,13
23,26901,CALDWELL ISD,6,english,7,136,26,110,83,48,136,36,100,72,37
23,26902,SOMERVILLE ISD,6,english,7,39,16,23,8,3,39,18,21,7,1
23,26903,SNOOK ISD,6,english,7,47,13,34,18,9,49,19,30,18,9
23,27903,BURNET CISD,13,english,7,228,79,149,108,47,229,98,131,80,12
23,27904,MARBLE FALLS IS,13,english,7,319,87,232,149,76,224,105,119,42,1
23,28902,LOCKHART ISD,13,english,7,453,177,276,144,52,472,267,205,57,2
23,28903,LULING ISD,13,english,7,96,31,65,34,14,73,45,28,9,0
23,28906,PRAIRIE LEA ISD,13,english,7,10,6,4,4,0,10,7,3,0,0
23,29901,CALHOUN COUNTY,3,english,7,263,70,193,116,50,185,89,96,38,1
23,30901,CROSS PLAINS IS,14,english,7,25,4,21,12,9,25,7,18,9,3
23,30902,CLYDE CISD,14,english,7,115,13,102,73,38,113,20,93,58,12
23,30903,BAIRD ISD,14,english,7,17,4,13,5,4,17,8,9,6,2
23,30906,EULA ISD,14,english,7,43,6,37,28,16,43,11,32,21,6
23,31901,BROWNSVILLE ISD,1,english,7,2395,498,1897,1392,764,1865,1004,861,294,23
23,31903,HARLINGEN CISD,1,english,7,1262,288,974,649,305,1266,521,745,401,76
23,31905,LA FERIA ISD,1,english,7,210,38,172,113,53,209,91,118,66,18
23,31906,LOS FRESNOS CIS,1,english,7,751,131,620,459,230,748,253,495,308,122
23,31909,POINT ISABEL IS,1,english,7,136,27,109,75,38,114,57,57,18,1
23,31911,RIO HONDO ISD,1,english,7,127,41,86,46,11,131,86,45,18,3
23,31912,SAN BENITO CISD,1,english,7,670,222,448,247,79,661,336,325,154,27
23,31913,SANTA MARIA ISD,1,english,7,31,9,22,9,3,31,17,14,2,1
23,31914,SANTA ROSA ISD,1,english,7,67,8,59,41,19,67,24,43,22,3
23,31916,SOUTH TEXAS ISD,1,english,7,382,18,364,312,219,44,22,22,13,1
23,32902,PITTSBURG ISD,8,english,7,175,15,160,126,61,175,27,148,102,36
23,33901,GROOM ISD,16,english,7,7,0,7,3,1,7,2,5,4,1
23,33902,PANHANDLE ISD,16,english,7,44,4,40,28,8,44,3,41,35,15
23,33904,WHITE DEER ISD,16,english,7,34,7,27,17,7,34,14,20,13,4
23,34901,ATLANTA ISD,8,english,7,127,22,105,69,31,128,54,74,41,7
23,34902,AVINGER ISD,8,english,7,10,0,10,9,5,10,1,9,5,1
23,34903,HUGHES SPRINGS,8,english,7,94,7,87,72,45,95,20,75,49,12
23,34905,LINDEN-KILDARE,8,english,7,39,7,32,21,6,39,11,28,12,2
23,34906,MCLEOD ISD,8,english,7,40,7,33,24,8,40,11,29,17,3
23,34907,QUEEN CITY ISD,8,english,7,69,10,59,38,16,69,25,44,24,3
23,34909,BLOOMBURG ISD,8,english,7,24,2,22,16,12,24,11,13,6,1
23,35901,DIMMITT ISD,16,english,7,88,35,53,25,6,76,58,18,3,0
23,35902,HART ISD,16,english,7,18,2,16,10,3,18,3,15,8,0
23,35903,NAZARETH ISD,16,english,7,15,0,15,15,11,15,0,15,15,11
23,36901,ANAHUAC ISD,4,english,7,102,19,83,51,17,70,23,47,19,0
23,36902,BARBERS HILL IS,4,english,7,612,55,557,455,250,597,88,509,411,210
23,36903,EAST CHAMBERS I,5,english,7,102,25,77,46,19,102,42,60,29,7
23,37901,ALTO ISD,7,english,7,37,10,27,19,6,34,11,23,17,3
23,37904,JACKSONVILLE IS,7,english,7,319,116,203,110,41,320,177,143,70,16
23,37907,RUSK ISD,7,english,7,165,25,140,98,49,165,56,109,53,14
23,37908,NEW SUMMERFIELD,7,english,7,37,7,30,21,9,37,15,22,13,3
23,37909,WELLS ISD,7,english,7,15,1,14,8,4,16,6,10,2,0
23,38901,CHILDRESS ISD,16,english,7,83,17,66,39,15,83,23,60,32,5
23,39902,HENRIETTA ISD,9,english,7,69,12,57,39,16,69,20,49,32,5
23,39903,PETROLIA CISD,9,english,7,40,8,32,25,13,40,7,33,20,4
23,39904,BELLEVUE ISD,9,english,7,10,0,10,9,4,10,0,10,9,1
23,39905,MIDWAY ISD,9,english,7,7,1,6,1,1,7,1,6,2,1
23,40901,MORTON ISD,17,english,7,33,21,12,5,1,33,22,11,3,0
23,40902,WHITEFACE CISD,17,english,7,24,6,18,7,4,24,9,15,8,1
23,41901,BRONTE ISD,15,english,7,15,3,12,9,6,15,3,12,10,1
23,41902,ROBERT LEE ISD,15,english,7,13,6,7,6,2,13,6,7,5,2
23,42901,COLEMAN ISD,15,english,7,54,12,42,28,10,54,18,36,21,2
23,42903,SANTA ANNA ISD,15,english,7,18,2,16,11,6,18,3,15,8,3
23,42905,PANTHER CREEK C,15,english,7,10,4,6,4,2,10,5,5,1,0
23,43801,IMAGINE INTERNA,10,english,7,154,1,153,137,104,105,3,102,83,21
23,43901,ALLEN ISD,10,english,7,1607,135,1472,1243,804,1602,186,1416,1184,664
23,43902,ANNA ISD,10,english,7,369,78,291,188,97,371,144,227,126,32
23,43903,CELINA ISD,10,english,7,321,25,296,222,121,269,51,218,147,42
23,43904,FARMERSVILLE IS,10,english,7,170,30,140,104,46,169,45,124,69,13
23,43905,FRISCO ISD,10,english,7,5376,296,5080,4459,3140,5330,527,4803,4003,2301
23,43907,MCKINNEY ISD,10,english,7,1764,208,1556,1219,697,1700,335,1365,989,389
23,43908,MELISSA ISD,10,english,7,405,20,385,301,166,316,42,274,183,48
23,43910,PLANO ISD,10,english,7,3697,528,3169,2529,1624,1930,751,1179,557,57
23,43911,PRINCETON ISD,10,english,7,587,132,455,301,127,586,187,399,261,134
23,43912,PROSPER ISD,10,english,7,1846,104,1742,1507,973,1820,217,1603,1248,580
23,43914,WYLIE ISD,10,english,7,1459,134,1325,1081,664,1454,219,1235,942,454
23,43917,BLUE RIDGE ISD,10,english,7,65,11,54,36,17,65,23,42,22,1
23,43918,COMMUNITY ISD,10,english,7,299,81,218,122,51,298,118,180,99,20
23,43919,LOVEJOY ISD,10,english,7,348,4,344,321,241,39,10,29,17,1
23,44902,WELLINGTON ISD,16,english,7,42,5,37,29,10,42,11,31,17,3
23,45902,COLUMBUS ISD,4,english,7,97,20,77,48,16,97,31,66,31,3
23,45903,RICE CISD,3,english,7,79,18,61,27,12,59,51,8,2,0
23,45905,WEIMAR ISD,3,english,7,60,11,49,29,12,60,17,43,27,5
23,46802,TRINITY CHARTER,20,english,7,26,9,17,7,3,26,18,8,4,1
23,46901,NEW BRAUNFELS I,20,english,7,733,146,587,409,188,732,191,541,330,95
23,46902,COMAL ISD,20,english,7,2209,324,1885,1411,738,2196,480,1716,1232,490
23,47901,COMANCHE ISD,14,english,7,84,12,72,56,32,84,25,59,40,12
23,47902,DE LEON ISD,14,english,7,46,5,41,31,16,46,11,35,27,6
23,47903,GUSTINE ISD,14,english,7,14,4,10,5,3,14,6,8,4,2
23,47905,SIDNEY ISD,14,english,7,14,0,14,9,7,14,4,10,5,0
23,48901,EDEN CISD,15,english,7,16,4,12,6,3,16,8,8,5,1
23,48903,PAINT ROCK ISD,15,english,7,16,6,10,3,1,16,9,7,1,1
23,49901,GAINESVILLE ISD,11,english,7,210,96,114,56,20,210,111,99,41,4
23,49902,MUENSTER ISD,11,english,7,42,6,36,23,8,42,10,32,22,4
23,49903,VALLEY VIEW ISD,11,english,7,77,26,51,28,4,77,38,39,24,4
23,49905,CALLISBURG ISD,11,english,7,95,15,80,48,22,95,14,81,52,13
23,49906,ERA ISD,11,english,7,37,7,30,23,7,37,7,30,18,6
23,49907,LINDSAY ISD,11,english,7,35,0,35,29,15,36,3,33,23,10
23,49908,WALNUT BEND ISD,11,english,7,0,,,,,0,,,,
23,49909,SIVELLS BEND IS,11,english,7,8,0,8,6,2,8,0,8,5,2
23,50901,EVANT ISD,12,english,7,18,0,18,11,6,18,4,14,4,1
23,50902,GATESVILLE ISD,12,english,7,205,40,165,123,72,152,48,104,49,5
23,50904,OGLESBY ISD,12,english,7,15,3,12,7,4,15,6,9,6,0
23,50909,JONESBORO ISD,12,english,7,23,5,18,11,2,23,7,16,7,0
23,50910,COPPERAS COVE I,12,english,7,598,132,466,317,140,0,,,,
23,51901,PADUCAH ISD,17,english,7,12,3,9,6,4,12,3,9,7,1
23,52901,CRANE ISD,15,english,7,81,31,50,34,13,81,46,35,15,3
23,53001,CROCKETT COUNTY,15,english,7,53,13,40,23,10,53,21,32,16,5
23,54901,CROSBYTON CISD,17,english,7,18,5,13,8,4,18,10,8,3,2
23,54902,LORENZO ISD,17,english,7,18,7,11,4,3,18,9,9,3,1
23,54903,RALLS ISD,17,english,7,31,11,20,15,4,31,11,20,6,1
23,55901,CULBERSON COUNT,18,english,7,19,8,11,6,2,19,13,6,1,0
23,56901,DALHART ISD,16,english,7,120,38,82,46,11,120,49,71,45,13
23,56902,TEXLINE ISD,16,english,7,14,1,13,12,5,14,0,14,9,6
23,57802,PEGASUS SCHOOL,10,english,7,49,21,28,12,2,49,34,15,1,0
23,57803,UPLIFT EDUCATIO,10,english,7,1912,477,1435,912,444,1132,494,638,302,68
23,57806,ADVANTAGE ACADE,10,english,7,95,36,59,26,6,96,62,34,9,2
23,57807,LIFE SCHOOL,10,english,7,425,96,329,213,90,423,187,236,104,16
23,57808,UNIVERSAL ACADE,10,english,7,116,13,103,80,49,114,23,91,69,41
23,57810,ACADEMY OF DALL,10,english,7,26,10,16,4,0,27,17,10,3,0
23,57813,TRINITY BASIN P,10,english,7,442,112,330,202,79,441,169,272,149,40
23,57814,ACADEMY FOR ACA,10,english,7,20,10,10,4,2,20,17,3,2,0
23,57816,A W BROWN LEADE,10,english,7,43,15,28,13,7,43,29,14,10,3
23,57819,JEAN MASSIEU AC,10,english,7,16,8,8,5,3,16,8,8,4,0
23,57827,NOVA ACADEMY SO,10,english,7,48,4,44,30,9,48,15,33,18,4
23,57829,A+ ACADEMY,10,english,7,142,58,84,44,13,142,61,81,35,13
23,57830,INSPIRED VISION,10,english,7,107,43,64,30,8,106,58,48,25,3
23,57831,GATEWAY CHARTER,10,english,7,30,1,29,18,4,30,15,15,6,0
23,57835,GOLDEN RULE CHA,10,english,7,86,16,70,46,17,86,34,52,20,5
23,57836,ST ANTHONY SCHO,10,english,7,38,2,36,31,9,37,6,31,18,7
23,57839,LA ACADEMIA DE,10,english,7,98,24,74,38,8,97,47,50,18,0
23,57841,CITYSCAPE SCHOO,10,english,7,72,15,57,29,12,72,32,40,19,2
23,57844,MANARA ACADEMY,10,english,7,48,14,34,23,13,48,17,31,21,5
23,57845,UME PREPARATORY,10,english,7,108,7,101,83,46,75,10,65,40,6
23,57846,LEGACY PREPARAT,10,english,7,132,38,94,39,16,132,80,52,26,3
23,57847,VILLAGE TECH SC,10,english,7,106,21,85,48,22,105,49,56,21,1
23,57848,INTERNATIONAL L,10,english,7,1918,612,1306,759,281,33,30,3,0,0
23,57850,PIONEER TECHNOL,10,english,7,200,23,177,120,52,179,53,126,71,20
23,57903,CARROLLTON-FARM,10,english,7,1647,497,1150,680,322,1013,532,481,184,42
23,57904,CEDAR HILL ISD,10,english,7,449,151,298,184,76,351,200,151,50,8
23,57905,DALLAS ISD,10,english,7,9125,2727,6398,4008,1829,2001,1202,799,273,31
23,57906,DESOTO ISD,10,english,7,476,132,344,192,85,375,208,167,40,4
23,57907,DUNCANVILLE ISD,10,english,7,893,276,617,351,134,639,337,302,109,7
23,57909,GARLAND ISD,10,english,7,3705,1048,2657,1694,769,2630,1356,1274,544,125
23,57910,GRAND PRAIRIE I,10,english,7,1826,508,1318,840,381,1637,741,896,419,65
23,57911,HIGHLAND PARK I,10,english,7,504,13,491,445,307,318,24,294,225,91
23,57912,IRVING ISD,10,english,7,2178,778,1400,799,325,1922,1014,908,406,55
23,57913,LANCASTER ISD,10,english,7,499,146,353,204,82,497,273,224,83,9
23,57914,MESQUITE ISD,10,english,7,2833,857,1976,1100,389,1737,1028,709,214,8
23,57916,RICHARDSON ISD,10,english,7,2629,659,1970,1430,812,202,166,36,8,2
23,57919,SUNNYVALE ISD,10,english,7,192,10,182,167,115,98,23,75,43,6
23,57922,COPPELL ISD,10,english,7,1061,58,1003,898,628,1132,69,1063,939,576
23,58902,DAWSON ISD,17,english,7,12,3,9,8,4,12,6,6,3,0
23,58905,KLONDIKE ISD,17,english,7,20,0,20,20,15,20,0,20,17,9
23,58906,LAMESA ISD,17,english,7,116,49,67,28,9,115,73,42,16,5
23,58909,SANDS CISD,17,english,7,25,5,20,16,5,25,6,19,13,3
23,59901,HEREFORD ISD,16,english,7,287,101,186,95,24,285,133,152,86,16
23,60902,COOPER ISD,8,english,7,67,10,57,35,14,67,24,43,22,6
23,60914,FANNINDEL ISD,8,english,7,11,6,5,2,0,11,8,3,0,0
23,61802,NORTH TEXAS COL,11,english,7,41,13,28,21,9,40,15,25,9,3
23,61804,LEADERSHIP PREP,10,english,7,118,7,111,95,54,67,24,43,24,2
23,61805,TRIVIUM ACADEMY,11,english,7,53,1,52,44,27,50,5,45,28,7
23,61901,DENTON ISD,11,english,7,2260,516,1744,1184,598,2246,783,1463,861,267
23,61902,LEWISVILLE ISD,11,english,7,3558,616,2942,2248,1359,2208,921,1287,651,120
23,61903,PILOT POINT ISD,11,english,7,109,33,76,50,31,109,53,56,29,6
23,61905,KRUM ISD,11,english,7,181,40,141,94,40,183,66,117,73,22
23,61906,PONDER ISD,11,english,7,125,27,98,68,20,125,26,99,58,11
23,61907,AUBREY ISD,11,english,7,278,46,232,149,54,231,70,161,97,15
23,61908,SANGER ISD,11,english,7,185,30,155,110,61,144,50,94,36,2
23,61910,ARGYLE ISD,11,english,7,410,16,394,339,199,330,30,300,230,82
23,61911,NORTHWEST ISD,11,english,7,2233,293,1940,1467,762,1615,555,1060,632,234
23,61912,LAKE DALLAS ISD,11,english,7,313,64,249,160,66,220,85,135,60,4
23,61914,LITTLE ELM ISD,11,english,7,644,166,478,301,139,455,216,239,90,9
23,62901,CUERO ISD,3,english,7,169,37,132,92,35,166,53,113,59,14
23,62902,NORDHEIM ISD,3,english,7,11,0,11,9,5,11,2,9,5,3
23,62903,YOAKUM ISD,3,english,7,114,41,73,50,22,112,47,65,41,9
23,62904,YORKTOWN ISD,3,english,7,48,11,37,24,8,47,18,29,16,2
23,62905,WESTHOFF ISD,3,english,7,7,0,7,6,1,7,1,6,4,1
23,62906,MEYERSVILLE ISD,3,english,7,14,1,13,11,6,14,1,13,11,6
23,63903,SPUR ISD,17,english,7,15,2,13,9,1,15,7,8,5,3
23,63906,PATTON SPRINGS,17,english,7,0,,,,,0,,,,
23,64903,CARRIZO SPRINGS,20,english,7,118,41,77,37,9,118,42,76,44,18
23,65901,CLARENDON ISD,16,english,7,31,5,26,22,12,30,6,24,18,6
23,65902,HEDLEY ISD,16,english,7,11,1,10,7,3,11,2,9,7,1
23,66901,BENAVIDES ISD,2,english,7,14,6,8,4,2,14,5,9,2,0
23,66902,SAN DIEGO ISD,2,english,7,101,21,80,46,21,99,32,67,37,8
23,66903,FREER ISD,2,english,7,50,17,33,20,4,51,23,28,9,3
23,67902,CISCO ISD,14,english,7,60,4,56,46,22,60,8,52,36,16
23,67903,EASTLAND ISD,14,english,7,78,11,67,50,17,78,13,65,32,5
23,67904,GORMAN ISD,14,english,7,16,2,14,6,2,16,3,13,6,2
23,67907,RANGER ISD,14,english,7,29,10,19,5,2,29,15,14,3,0
23,67908,RISING STAR ISD,14,english,7,12,2,10,8,3,12,3,9,4,0
23,68802,COMPASS ACADEMY,18,english,7,115,17,98,67,31,115,34,81,49,10
23,68901,ECTOR COUNTY IS,18,english,7,2314,806,1508,889,373,2272,998,1274,767,214
23,69901,ROCKSPRINGS ISD,15,english,7,19,4,15,9,4,19,7,12,3,1
23,69902,NUECES CANYON C,15,english,7,10,2,8,6,3,10,5,5,4,0
23,70801,WAXAHACHIE FAIT,10,english,7,246,101,145,62,14,246,148,98,39,8
23,70901,AVALON ISD,10,english,7,23,10,13,7,2,23,12,11,7,3
23,70903,ENNIS ISD,10,english,7,439,111,328,214,85,446,152,294,176,52
23,70905,FERRIS ISD,10,english,7,191,47,144,86,29,61,46,15,2,0
23,70907,ITALY ISD,10,english,7,60,10,50,36,16,60,25,35,27,7
23,70908,MIDLOTHIAN ISD,10,english,7,871,141,730,511,220,551,175,376,188,15
23,70909,MILFORD ISD,10,english,7,26,12,14,7,1,26,13,13,3,0
23,70910,PALMER ISD,10,english,7,98,11,87,77,42,98,17,81,62,21
23,70911,RED OAK ISD,10,english,7,507,131,376,206,82,380,226,154,40,1
23,70912,WAXAHACHIE ISD,10,english,7,790,157,633,431,187,543,214,329,137,8
23,70915,MAYPEARL ISD,10,english,7,96,12,84,52,31,71,21,50,26,0
23,71801,BURNHAM WOOD CH,19,english,7,139,37,102,64,26,139,20,119,91,32
23,71806,HARMONY PUBLIC,19,english,7,455,79,376,277,150,454,110,344,226,83
23,71809,VISTA DEL FUTUR,19,english,7,27,5,22,13,9,27,8,19,11,3
23,71810,EL PASO LEADERS,19,english,7,138,78,60,24,5,138,82,56,25,4
23,71901,CLINT ISD,19,english,7,731,249,482,268,88,619,367,252,83,10
23,71902,EL PASO ISD,19,english,7,3358,969,2389,1530,685,3335,1455,1880,1055,309
23,71903,FABENS ISD,19,english,7,151,74,77,44,11,152,78,74,35,9
23,71904,SAN ELIZARIO IS,19,english,7,214,77,137,62,13,215,110,105,34,6
23,71905,YSLETA ISD,19,english,7,2635,587,2048,1326,573,1848,863,985,422,42
23,71906,ANTHONY ISD,19,english,7,65,20,45,27,8,51,28,23,8,1
23,71907,CANUTILLO ISD,19,english,7,427,94,333,218,102,297,129,168,82,7
23,71908,TORNILLO ISD,19,english,7,48,14,34,18,1,48,37,11,2,0
23,71909,SOCORRO ISD,19,english,7,3378,627,2751,1858,756,3369,1184,2185,1236,272
23,72801,PREMIER HIGH SC,11,english,7,0,,,,,0,,,,
23,72802,ERATH EXCELS AC,11,english,7,0,,,,,0,,,,
23,72901,THREE WAY ISD,11,english,7,16,0,16,8,3,16,7,9,6,2
23,72902,DUBLIN ISD,11,english,7,77,7,70,49,22,77,18,59,37,12
23,72903,STEPHENVILLE IS,11,english,7,251,43,208,149,86,247,58,189,124,38
23,72904,BLUFF DALE ISD,11,english,7,16,4,12,10,4,16,2,14,6,3
23,72908,HUCKABAY ISD,11,english,7,18,2,16,13,6,18,4,14,14,6
23,72909,LINGLEVILLE ISD,11,english,7,16,1,15,11,4,16,1,15,7,1
23,72910,MORGAN MILL ISD,11,english,7,5,0,5,5,1,5,0,5,4,2
23,73901,CHILTON ISD,12,english,7,39,4,35,18,10,24,19,5,2,0
23,73903,MARLIN ISD,12,english,7,66,28,38,18,6,66,29,37,19,7
23,73904,WESTPHALIA ISD,12,english,7,17,2,15,13,5,17,1,16,13,8
23,73905,ROSEBUD-LOTT IS,12,english,7,56,11,45,33,11,55,21,34,17,6
23,74903,BONHAM ISD,10,english,7,127,34,93,61,28,111,45,66,34,3
23,74904,DODD CITY ISD,10,english,7,27,2,25,15,7,27,3,24,12,2
23,74905,ECTOR ISD,10,english,7,25,14,11,5,1,25,14,11,3,0
23,74907,HONEY GROVE ISD,8,english,7,42,5,37,29,16,42,6,36,25,12
23,74909,LEONARD ISD,10,english,7,69,8,61,41,25,50,24,26,8,0
23,74911,SAVOY ISD,10,english,7,23,5,18,13,7,23,5,18,10,4
23,74912,TRENTON ISD,10,english,7,48,2,46,36,15,48,14,34,21,1
23,74917,SAM RAYBURN ISD,10,english,7,33,3,30,24,16,33,8,25,18,2
23,75901,FLATONIA ISD,13,english,7,47,3,44,35,14,46,4,42,34,13
23,75902,LA GRANGE ISD,13,english,7,147,25,122,90,47,86,37,49,21,2
23,75903,SCHULENBURG ISD,13,english,7,48,15,33,23,8,48,24,24,13,3
23,75906,FAYETTEVILLE IS,13,english,7,28,2,26,23,14,28,6,22,18,10
23,75908,ROUND TOP-CARMI,13,english,7,19,1,18,15,8,19,3,16,14,6
23,76903,ROBY CISD,14,english,7,25,4,21,18,10,25,6,19,11,5
23,76904,ROTAN ISD,14,english,7,21,3,18,13,6,21,8,13,10,3
23,77901,FLOYDADA COLLEG,17,english,7,48,15,33,20,7,46,24,22,8,2
23,77902,LOCKNEY ISD,17,english,7,30,9,21,10,2,30,13,17,5,0
23,78901,CROWELL ISD,9,english,7,17,3,14,7,2,17,5,12,7,0
23,79901,LAMAR CISD,4,english,7,3064,487,2577,1888,1014,1990,802,1188,543,59
23,79906,NEEDVILLE ISD,4,english,7,254,35,219,171,84,252,33,219,169,80
23,79907,FORT BEND ISD,4,english,7,6101,990,5111,3799,2157,6111,1568,4543,3239,1527
23,79910,STAFFORD MSD,4,english,7,288,74,214,135,61,248,108,140,65,16
23,80901,MOUNT VERNON IS,8,english,7,119,30,89,51,23,119,27,92,53,20
23,81902,FAIRFIELD ISD,12,english,7,127,30,97,68,23,127,53,74,44,14
23,81904,TEAGUE ISD,12,english,7,83,10,73,56,23,83,23,60,34,7
23,81905,WORTHAM ISD,12,english,7,39,11,28,20,9,39,12,27,17,7
23,81906,DEW ISD,12,english,7,7,2,5,5,3,7,2,5,3,0
23,82902,DILLEY ISD,20,english,7,47,21,26,14,5,47,30,17,8,0
23,82903,PEARSALL ISD,20,english,7,149,62,87,44,8,145,84,61,26,2
23,83901,SEAGRAVES ISD,17,english,7,44,19,25,13,4,44,20,24,10,2
23,83902,LOOP ISD,17,english,7,14,1,13,12,9,14,3,11,9,2
23,83903,SEMINOLE ISD,17,english,7,204,37,167,105,53,203,59,144,89,32
23,84802,ODYSSEY ACADEMY,4,english,7,104,39,65,31,10,103,64,39,17,2
23,84804,AMBASSADORS PRE,4,english,7,10,0,10,8,4,10,2,8,4,0
23,84901,DICKINSON ISD,4,english,7,948,220,728,474,224,680,361,319,111,4
23,84902,GALVESTON ISD,4,english,7,421,168,253,150,65,331,196,135,36,3
23,84903,HIGH ISLAND ISD,5,english,7,14,3,11,5,2,14,2,12,5,2
23,84906,TEXAS CITY ISD,4,english,7,583,238,345,186,57,517,317,200,70,4
23,84908,HITCHCOCK ISD,4,english,7,133,40,93,49,15,132,71,61,18,4
23,84909,SANTA FE ISD,4,english,7,321,77,244,161,78,319,125,194,114,26
23,84910,CLEAR CREEK ISD,4,english,7,3030,463,2567,1923,1047,3040,752,2288,1556,592
23,84911,FRIENDSWOOD ISD,4,english,7,487,21,466,398,258,462,36,426,337,138
23,85902,POST ISD,17,english,7,50,14,36,15,6,50,17,33,16,3
23,85903,SOUTHLAND ISD,17,english,7,0,,,,,0,,,,
23,86901,FREDERICKSBURG,13,english,7,205,33,172,131,76,145,65,80,46,5
23,86902,HARPER ISD,15,english,7,47,4,43,32,18,47,12,35,24,7
23,87901,GLASSCOCK COUNT,18,english,7,22,0,22,19,10,22,2,20,15,10
23,88902,GOLIAD ISD,3,english,7,97,24,73,37,17,80,40,40,15,1
23,89901,GONZALES ISD,13,english,7,178,47,131,85,36,179,78,101,55,12
23,89903,NIXON-SMILEY CI,13,english,7,65,18,47,34,20,53,36,17,2,0
23,89905,WAELDER ISD,13,english,7,18,9,9,4,2,18,12,6,2,1
23,90902,LEFORS ISD,16,english,7,15,7,8,4,3,15,7,8,4,2
23,90903,MCLEAN ISD,16,english,7,16,2,14,10,4,16,4,12,5,1
23,90904,PAMPA ISD,16,english,7,233,73,160,83,21,233,112,121,61,14
23,91901,BELLS ISD,10,english,7,70,6,64,61,37,60,4,56,44,6
23,91902,COLLINSVILLE IS,10,english,7,36,9,27,15,5,25,13,12,3,0
23,91903,DENISON ISD,10,english,7,365,78,287,183,91,364,131,233,136,33
23,91905,HOWE ISD,10,english,7,89,10,79,55,24,89,13,76,49,10
23,91906,SHERMAN ISD,10,english,7,498,131,367,233,98,421,189,232,129,29
23,91907,TIOGA ISD,10,english,7,53,8,45,28,12,36,20,16,4,0
23,91908,VAN ALSTYNE ISD,10,english,7,179,16,163,139,79,180,30,150,115,41
23,91909,WHITESBORO ISD,10,english,7,140,23,117,71,40,140,38,102,53,11
23,91910,WHITEWRIGHT ISD,10,english,7,54,9,45,28,16,54,5,49,33,13
23,91913,POTTSBORO ISD,10,english,7,98,9,89,68,31,112,33,79,47,5
23,91914,S AND S CISD,10,english,7,65,12,53,32,6,65,17,48,34,10
23,91917,GUNTER ISD,10,english,7,88,6,82,66,28,88,11,77,55,15
23,91918,TOM BEAN ISD,10,english,7,53,4,49,25,9,41,8,33,13,0
23,92901,GLADEWATER ISD,7,english,7,130,28,102,72,33,112,61,51,22,3
23,92902,KILGORE ISD,7,english,7,286,74,212,121,42,287,123,164,83,14
23,92903,LONGVIEW ISD,7,english,7,621,148,473,327,188,575,214,361,225,63
23,92904,PINE TREE ISD,7,english,7,346,58,288,194,99,291,116,175,82,7
23,92906,SABINE ISD,7,english,7,107,12,95,69,48,107,22,85,56,16
23,92907,SPRING HILL ISD,7,english,7,145,23,122,91,66,101,36,65,37,6
23,92908,WHITE OAK ISD,7,english,7,119,12,107,82,41,107,31,76,36,7
23,93901,ANDERSON-SHIRO,6,english,7,60,9,51,33,19,39,9,30,21,8
23,93903,IOLA ISD,6,english,7,46,6,40,32,15,46,11,35,24,4
23,93904,NAVASOTA ISD,6,english,7,188,56,132,75,31,135,83,52,7,0
23,93905,RICHARDS ISD,6,english,7,15,6,9,6,3,15,7,8,4,1
23,94901,SEGUIN ISD,20,english,7,482,184,298,165,68,386,240,146,35,2
23,94902,SCHERTZ-CIBOLO-,20,english,7,1219,246,973,622,259,877,250,627,343,46
23,94903,NAVARRO ISD,20,english,7,170,30,140,91,36,170,39,131,83,20
23,94904,MARION ISD,20,english,7,121,31,90,61,18,121,35,86,49,12
23,95901,ABERNATHY ISD,17,english,7,66,9,57,39,25,66,15,51,40,18
23,95902,COTTON CENTER I,17,english,7,10,2,8,4,2,10,5,5,5,2
23,95903,HALE CENTER ISD,17,english,7,47,15,32,13,5,46,14,32,17,3
23,95904,PETERSBURG ISD,17,english,7,19,1,18,12,6,19,4,15,9,4
23,95905,PLAINVIEW ISD,17,english,7,369,139,230,125,41,370,191,179,84,21
23,96904,MEMPHIS ISD,16,english,7,20,2,18,14,7,20,7,13,10,4
23,96905,TURKEY-QUITAQUE,16,english,7,14,1,13,10,6,14,4,10,8,3
23,97902,HAMILTON ISD,12,english,7,57,11,46,35,16,57,13,44,23,3
23,97903,HICO ISD,12,english,7,47,4,43,36,24,47,15,32,23,6
23,98901,GRUVER ISD,16,english,7,38,3,35,33,24,38,3,35,32,19
23,98903,PRINGLE-MORSE C,16,english,7,10,3,7,5,3,10,3,7,4,1
23,98904,SPEARMAN ISD,16,english,7,45,5,40,31,16,45,7,38,27,10
23,99902,CHILLICOTHE ISD,9,english,7,13,3,10,7,4,13,6,7,5,3
23,99903,QUANAH ISD,9,english,7,35,9,26,16,11,35,16,19,11,6
23,100903,KOUNTZE ISD,5,english,7,77,22,55,30,8,76,26,50,27,7
23,100904,SILSBEE ISD,5,english,7,215,58,157,82,34,215,108,107,58,10
23,100905,HARDIN-JEFFERSO,5,english,7,186,24,162,122,59,140,28,112,70,12
23,100907,LUMBERTON ISD,5,english,7,327,69,258,172,82,327,84,243,158,48
23,100908,WEST HARDIN COU,5,english,7,40,5,35,26,15,40,13,27,13,1
23,101802,SER-NINOS CHART,4,english,7,84,18,66,40,10,84,30,54,34,7
23,101803,ARISTOI CLASSIC,4,english,7,103,5,98,82,43,103,25,78,55,14
23,101804,GEORGE I SANCHE,4,english,7,98,57,41,10,3,98,70,28,3,1
23,101806,RAUL YZAGUIRRE,4,english,7,165,54,111,72,33,165,64,101,59,21
23,101810,ACADEMY OF ACCE,4,english,7,67,12,55,35,11,67,31,36,25,5
23,101811,EXCEL ACADEMY,4,english,7,0,,,,,0,,,,
23,101814,THE VARNETT PUB,4,english,7,70,20,50,28,14,70,33,37,20,6
23,101815,ALIEF MONTESSOR,4,english,7,21,1,20,19,10,21,2,19,17,8
23,101819,AMIGOS POR VIDA,4,english,7,64,3,61,38,14,64,7,57,43,19
23,101828,HOUSTON GATEWAY,4,english,7,162,4,158,137,82,162,10,152,129,66
23,101837,CALVIN NELMS CH,4,english,7,57,3,54,47,30,57,5,52,39,10
23,101838,SOUTHWEST SCHOO,4,english,7,81,41,40,17,6,80,46,34,15,3
23,101842,COMQUEST ACADEM,4,english,7,6,1,5,2,1,5,2,3,2,1
23,101845,YES PREP PUBLIC,4,english,7,2192,530,1662,1075,474,2189,865,1324,765,220
23,101846,HARMONY PUBLIC,4,english,7,341,36,305,226,137,338,78,260,181,70
23,101847,BEATRICE MAYES,4,english,7,44,6,38,29,9,44,19,25,8,0
23,101849,ACCELERATED INT,4,english,7,13,0,13,9,4,13,3,10,5,1
23,101853,BAKERRIPLEY COM,4,english,7,55,17,38,16,6,55,26,29,15,3
23,101856,DRAW ACADEMY,4,english,7,58,20,38,26,12,58,28,30,15,5
23,101858,HARMONY PUBLIC,4,english,7,568,89,479,343,175,574,136,438,301,130
23,101859,STEP CHARTER SC,4,english,7,49,15,34,20,10,49,13,36,22,6
23,101861,THE RHODES SCHO,4,english,7,34,3,31,14,5,34,10,24,12,2
23,101862,HARMONY PUBLIC,4,english,7,447,19,428,367,240,448,29,419,347,203
23,101864,THE LAWSON ACAD,4,english,7,41,11,30,13,6,41,21,20,8,2
23,101868,THE PRO-VISION,4,english,7,41,26,15,1,1,42,37,5,1,0
23,101870,BETA ACADEMY,4,english,7,110,2,108,100,57,108,11,97,72,27
23,101871,A+ UNLIMITED PO,4,english,7,51,8,43,26,9,50,28,22,12,2
23,101872,ETOILE ACADEMY,4,english,7,105,50,55,27,8,105,51,54,28,6
23,101873,YELLOWSTONE COL,4,english,7,62,17,45,17,3,60,25,35,7,2
23,101874,LEGACY SCHOOL O,4,english,7,46,14,32,10,3,46,34,12,5,0
23,101902,ALDINE ISD,4,english,7,4188,1824,2364,1175,377,3688,2427,1261,431,44
23,101903,ALIEF ISD,4,english,7,2675,1026,1649,970,378,2625,1329,1296,689,173
23,101905,CHANNELVIEW ISD,4,english,7,736,233,503,279,91,731,309,422,213,39
23,101906,CROSBY ISD,4,english,7,534,183,351,205,74,535,221,314,189,49
23,101907,CYPRESS-FAIRBAN,4,english,7,8541,1653,6888,5016,2766,8481,2602,5879,3936,1495
23,101908,DEER PARK ISD,4,english,7,920,151,769,540,274,848,227,621,418,99
23,101910,GALENA PARK ISD,4,english,7,1528,363,1165,735,342,1143,536,607,271,22
23,101911,GOOSE CREEK CIS,4,english,7,1793,529,1264,796,312,1787,733,1054,647,184
23,101912,HOUSTON ISD,4,english,7,11959,3858,8101,5323,2618,11351,5552,5799,3245,1056
23,101913,HUMBLE ISD,4,english,7,3706,797,2909,1911,804,2221,1176,1045,390,23
23,101914,KATY ISD,4,english,7,7305,805,6500,5369,3416,3830,1195,2635,1515,246
23,101915,KLEIN ISD,4,english,7,3989,791,3198,2272,1172,3971,1248,2723,1748,588
23,101916,LA PORTE ISD,4,english,7,513,105,408,300,144,313,149,164,59,2
23,101917,PASADENA ISD,4,english,7,3439,903,2536,1564,611,3131,1338,1793,942,220
23,101919,SPRING ISD,4,english,7,2265,765,1500,874,336,2270,1196,1074,504,116
23,101920,SPRING BRANCH I,4,english,7,2449,614,1835,1411,890,1417,743,674,298,44
23,101921,TOMBALL ISD,4,english,7,1657,145,1512,1232,744,1544,196,1348,1002,355
23,101924,SHELDON ISD,4,english,7,792,288,504,255,76,797,456,341,135,13
23,101925,HUFFMAN ISD,4,english,7,309,101,208,107,38,228,118,110,34,6
23,102901,KARNACK ISD,7,english,7,14,3,11,7,1,13,6,7,4,1
23,102902,MARSHALL ISD,7,english,7,397,105,292,188,92,392,117,275,175,50
23,102903,WASKOM ISD,7,english,7,71,17,54,19,8,71,28,43,16,3
23,102904,HALLSVILLE ISD,7,english,7,2182,664,1518,869,340,2185,1154,1031,461,133
23,102905,HARLETON ISD,7,english,7,58,3,55,48,30,58,7,51,35,17
23,102906,ELYSIAN FIELDS,7,english,7,57,4,53,41,18,57,9,48,30,12
23,103901,CHANNING ISD,16,english,7,14,5,9,6,3,14,7,7,7,1
23,103902,HARTLEY ISD,16,english,7,16,2,14,11,5,16,2,14,12,4
23,104901,HASKELL CISD,14,english,7,37,6,31,18,5,37,12,25,11,2
23,104903,RULE ISD,14,english,7,13,3,10,7,2,12,3,9,5,1
23,104907,PAINT CREEK ISD,14,english,7,12,3,9,9,5,12,3,9,6,2
23,105803,KI CHARTER ACAD,13,english,7,34,17,17,9,4,30,21,9,4,0
23,105902,SAN MARCOS CISD,13,english,7,645,226,419,266,109,7,5,2,1,0
23,105904,DRIPPING SPRING,13,english,7,602,40,562,444,227,613,75,538,422,142
23,105905,WIMBERLEY ISD,13,english,7,188,22,166,135,84,127,34,93,56,4
23,105906,HAYS CISD,13,english,7,1616,379,1237,864,439,1078,529,549,231,21
23,106901,CANADIAN ISD,16,english,7,74,12,62,40,15,74,18,56,39,10
23,107901,ATHENS ISD,10,english,7,226,62,164,118,50,230,101,129,61,18
23,107902,BROWNSBORO ISD,7,english,7,192,27,165,117,51,191,53,138,84,23
23,107904,CROSS ROADS ISD,7,english,7,23,1,22,21,12,23,2,21,17,5
23,107905,EUSTACE ISD,7,english,7,120,15,105,74,42,120,19,101,65,8
23,107906,MALAKOFF ISD,7,english,7,117,13,104,80,35,119,30,89,54,7
23,107907,TRINIDAD ISD,7,english,7,9,4,5,1,1,9,4,5,3,0
23,107908,MURCHISON ISD,7,english,7,18,5,13,7,3,18,7,11,5,0
23,107910,LAPOYNOR ISD,7,english,7,30,2,28,19,10,29,7,22,14,3
23,108802,HORIZON MONTESS,1,english,7,71,10,61,44,20,70,24,46,30,7
23,108807,IDEA PUBLIC SCH,1,english,7,6490,1169,5321,3764,1878,6405,2029,4376,2736,918
23,108808,VANGUARD ACADEM,1,english,7,410,43,367,286,156,410,139,271,156,44
23,108809,EXCELLENCE IN L,1,english,7,19,7,12,7,3,19,7,12,4,1
23,108902,DONNA ISD,1,english,7,938,328,610,370,129,932,456,476,246,35
23,108903,EDCOUCH-ELSA IS,1,english,7,284,111,173,80,32,284,175,109,41,6
23,108904,EDINBURG CISD,1,english,7,2288,586,1702,1152,587,2279,1040,1239,694,185
23,108905,HIDALGO ISD,1,english,7,190,68,122,88,49,190,91,99,63,22
23,108906,MCALLEN ISD,1,english,7,1472,268,1204,877,492,1507,520,987,620,243
23,108907,MERCEDES ISD,1,english,7,341,123,218,125,49,338,182,156,65,12
23,108908,MISSION CISD,1,english,7,961,285,676,426,185,946,535,411,191,44
23,108909,PHARR-SAN JUAN-,1,english,7,1985,581,1404,879,386,1828,870,958,498,104
23,108910,PROGRESO ISD,1,english,7,100,33,67,33,17,100,54,46,25,3
23,108911,SHARYLAND ISD,1,english,7,717,114,603,449,243,633,161,472,335,111
23,108912,LA JOYA ISD,1,english,7,1676,509,1167,730,305,1731,660,1071,651,219
23,108913,WESLACO ISD,1,english,7,1148,298,850,537,246,1144,488,656,357,129
23,108914,LA VILLA ISD,1,english,7,39,14,25,12,5,39,21,18,6,2
23,108915,MONTE ALTO ISD,1,english,7,65,12,53,37,14,66,24,42,23,8
23,108916,VALLEY VIEW ISD,1,english,7,242,55,187,132,54,241,87,154,95,28
23,109901,ABBOTT ISD,12,english,7,24,1,23,19,9,24,3,21,19,6
23,109902,BYNUM ISD,12,english,7,13,2,11,6,3,13,1,12,8,1
23,109903,COVINGTON ISD,12,english,7,21,3,18,7,5,20,8,12,4,1
23,109904,HILLSBORO ISD,12,english,7,123,7,116,92,38,123,13,110,89,38
23,109905,HUBBARD ISD,12,english,7,33,9,24,16,3,33,10,23,13,4
23,109907,ITASCA ISD,12,english,7,51,20,31,15,4,51,22,29,10,5
23,109908,MALONE ISD,12,english,7,11,2,9,3,2,11,4,7,3,0
23,109910,MOUNT CALM ISD,12,english,7,7,2,5,1,0,7,1,6,3,1
23,109911,WHITNEY ISD,12,english,7,108,26,82,54,23,106,32,74,48,12
23,109912,AQUILLA ISD,12,english,7,29,8,21,15,6,29,9,20,13,6
23,109913,BLUM ISD,12,english,7,24,8,16,14,3,24,5,19,12,4
23,109914,PENELOPE ISD,12,english,7,13,3,10,9,5,13,3,10,7,3
23,110901,ANTON ISD,17,english,7,15,6,9,3,0,15,11,4,2,0
23,110902,LEVELLAND ISD,17,english,7,192,55,137,72,24,190,93,97,34,6
23,110905,ROPES ISD,17,english,7,30,1,29,24,13,30,5,25,20,7
23,110906,SMYER ISD,17,english,7,28,4,24,13,7,28,6,22,15,4
23,110907,SUNDOWN ISD,17,english,7,41,3,38,27,14,41,3,38,30,7
23,110908,WHITHARRAL ISD,17,english,7,17,2,15,12,5,17,1,16,10,2
23,111801,LAKE GRANBURY A,11,english,7,0,,,,,0,,,,
23,111901,GRANBURY ISD,11,english,7,607,139,468,314,143,597,176,421,274,79
23,111902,LIPAN ISD,11,english,7,30,5,25,16,8,30,7,23,14,3
23,111903,TOLAR ISD,11,english,7,62,8,54,38,14,41,10,31,14,1
23,112901,SULPHUR SPRINGS,8,english,7,317,72,245,182,98,240,88,152,75,7
23,112905,CUMBY COLLEGIAT,8,english,7,24,3,21,12,5,24,11,13,9,0
23,112906,NORTH HOPKINS I,8,english,7,43,14,29,20,6,45,24,21,15,1
23,112907,MILLER GROVE IS,8,english,7,22,5,17,15,9,22,3,19,10,3
23,112908,COMO-PICKTON CI,8,english,7,58,9,49,29,11,58,24,34,16,2
23,112909,SALTILLO ISD,8,english,7,18,2,16,16,9,17,1,16,10,4
23,112910,SULPHUR BLUFF I,8,english,7,24,0,24,16,10,24,6,18,10,2
23,113901,CROCKETT ISD,6,english,7,96,38,58,28,13,97,55,42,19,7
23,113902,GRAPELAND ISD,6,english,7,36,9,27,18,5,36,14,22,11,1
23,113903,LOVELADY ISD,6,english,7,50,6,44,35,22,50,14,36,19,2
23,113905,LATEXO ISD,6,english,7,29,1,28,21,10,19,5,14,11,1
23,113906,KENNARD ISD,6,english,7,20,4,16,6,2,20,6,14,7,1
23,114901,BIG SPRING ISD,18,english,7,246,98,148,73,23,246,120,126,69,11
23,114902,COAHOMA ISD,18,english,7,92,26,66,36,12,91,39,52,22,2
23,114904,FORSAN ISD,18,english,7,48,6,42,31,17,49,7,42,26,9
23,115901,FT HANCOCK ISD,19,english,7,34,11,23,8,1,34,17,17,6,1
23,115902,SIERRA BLANCA I,19,english,7,7,1,6,3,1,7,1,6,4,0
23,115903,DELL CITY ISD,19,english,7,7,2,5,3,1,8,4,4,2,2
23,116901,CADDO MILLS ISD,10,english,7,203,24,179,134,64,203,32,171,114,41
23,116902,CELESTE ISD,10,english,7,30,7,23,17,8,30,10,20,16,2
23,116903,COMMERCE ISD,10,english,7,108,43,65,46,24,75,53,22,11,0
23,116905,GREENVILLE ISD,10,english,7,358,160,198,104,37,292,205,87,23,0
23,116906,LONE OAK ISD,10,english,7,94,29,65,48,22,94,26,68,46,10
23,116908,QUINLAN ISD,10,english,7,182,63,119,69,19,151,76,75,30,0
23,116909,WOLFE CITY ISD,10,english,7,45,10,35,20,12,45,9,36,18,9
23,116910,CAMPBELL ISD,10,english,7,19,8,11,5,1,19,9,10,5,2
23,116915,BLAND ISD,10,english,7,50,11,39,31,12,50,18,32,25,8
23,116916,BOLES ISD,10,english,7,44,11,33,21,7,45,16,29,18,5
23,117901,BORGER ISD,16,english,7,176,30,146,96,50,175,69,106,70,17
23,117903,SANFORD-FRITCH,16,english,7,50,12,38,25,9,40,19,21,6,0
23,117904,PLEMONS-STINNET,16,english,7,36,8,28,19,9,36,10,26,17,8
23,117907,SPRING CREEK IS,16,english,7,9,3,6,5,2,9,4,5,3,0
23,118902,IRION COUNTY IS,15,english,7,20,1,19,16,11,20,2,18,14,8
23,119901,BRYSON ISD,9,english,7,13,2,11,7,3,13,4,9,6,2
23,119902,JACKSBORO ISD,9,english,7,77,20,57,31,7,75,23,52,31,5
23,119903,PERRIN-WHITT CI,9,english,7,22,2,20,13,6,22,6,16,7,1
23,120901,EDNA ISD,3,english,7,124,26,98,77,33,124,42,82,61,18
23,120902,GANADO ISD,3,english,7,54,10,44,26,9,54,18,36,18,4
23,120905,INDUSTRIAL ISD,3,english,7,100,4,96,77,41,100,14,86,61,18
23,121902,BROOKELAND ISD,5,english,7,25,5,20,11,7,25,7,18,8,6
23,121903,BUNA ISD,5,english,7,116,16,100,65,38,115,31,84,45,6
23,121904,JASPER ISD,5,english,7,172,67,105,55,22,178,95,83,46,6
23,121905,KIRBYVILLE CISD,5,english,7,117,20,97,66,28,117,23,94,62,20
23,121906,EVADALE ISD,5,english,7,30,4,26,25,11,30,7,23,13,3
23,122901,FT DAVIS ISD,18,english,7,18,6,12,7,5,18,6,12,9,1
23,122902,VALENTINE ISD,18,english,7,5,1,4,4,3,5,2,3,2,0
23,123803,TEKOA ACADEMY O,5,english,7,15,3,12,9,1,15,5,10,7,0
23,123805,EHRHART SCHOOL,5,english,7,51,7,44,32,21,51,10,41,29,14
23,123807,BOB HOPE SCHOOL,5,english,7,181,35,146,103,41,181,42,139,94,32
23,123905,NEDERLAND ISD,5,english,7,412,54,358,277,155,412,97,315,214,77
23,123907,PORT ARTHUR ISD,5,english,7,510,192,318,159,53,510,298,212,81,19
23,123908,PORT NECHES-GRO,5,english,7,408,56,352,252,114,364,121,243,106,8
23,123910,BEAUMONT ISD,5,english,7,1184,500,684,395,170,1044,711,333,94,5
23,123913,SABINE PASS ISD,5,english,7,29,0,29,24,14,29,5,24,16,3
23,123914,HAMSHIRE-FANNET,5,english,7,159,28,131,100,42,127,47,80,33,2
23,124901,JIM HOGG COUNTY,1,english,7,64,19,45,21,9,64,31,33,12,0
23,125901,ALICE ISD,2,english,7,309,97,212,131,47,311,151,160,77,13
23,125902,BEN BOLT-PALITO,2,english,7,34,6,28,17,4,34,12,22,6,2
23,125903,ORANGE GROVE IS,2,english,7,126,14,112,92,48,129,42,87,44,11
23,125905,PREMONT ISD,2,english,7,50,11,39,24,9,50,19,31,18,6
23,126901,ALVARADO ISD,11,english,7,267,78,189,109,40,194,99,95,36,0
23,126902,BURLESON ISD,11,english,7,974,211,763,528,237,951,261,690,441,149
23,126903,CLEBURNE ISD,11,english,7,531,151,380,244,84,437,207,230,93,6
23,126904,GRANDVIEW ISD,11,english,7,108,10,98,66,36,108,16,92,59,19
23,126905,JOSHUA ISD,11,english,7,433,61,372,262,145,433,96,337,223,76
23,126906,KEENE ISD,11,english,7,72,5,67,52,23,53,13,40,22,3
23,126907,RIO VISTA ISD,11,english,7,56,12,44,18,7,56,28,28,10,1
23,126908,VENUS ISD,11,english,7,168,53,115,59,18,132,88,44,13,2
23,126911,GODLEY ISD,11,english,7,206,36,170,123,60,206,72,134,73,14
23,127901,ANSON ISD,14,english,7,55,19,36,21,13,55,26,29,11,2
23,127903,HAMLIN COLLEGIA,14,english,7,29,11,18,7,2,29,9,20,7,2
23,127904,HAWLEY ISD,14,english,7,80,24,56,30,8,80,26,54,33,6
23,127905,LUEDERS-AVOCA I,14,english,7,10,1,9,6,2,10,1,9,4,0
23,127906,STAMFORD ISD,14,english,7,39,4,35,26,9,39,3,36,24,7
23,128901,KARNES CITY ISD,20,english,7,223,62,161,91,27,222,129,93,34,4
23,128902,KENEDY ISD,3,english,7,41,15,26,17,4,41,15,26,19,4
23,128903,RUNGE ISD,3,english,7,15,4,11,0,0,15,12,3,1,0
23,128904,FALLS CITY ISD,20,english,7,33,0,33,28,19,33,2,31,27,17
23,129901,CRANDALL ISD,10,english,7,521,128,393,244,119,393,209,184,57,3
23,129902,FORNEY ISD,10,english,7,1225,257,968,692,347,905,395,510,250,28
23,129903,KAUFMAN ISD,10,english,7,307,53,254,176,73,307,72,235,169,76
23,129904,KEMP ISD,10,english,7,128,40,88,51,15,129,66,63,29,4
23,129905,MABANK ISD,10,english,7,299,62,237,166,71,213,89,124,53,5
23,129906,TERRELL ISD,10,english,7,372,123,249,139,53,371,200,171,70,17
23,129910,SCURRY-ROSSER I,10,english,7,87,6,81,62,38,87,15,72,60,23
23,130801,MEADOWLAND CHAR,20,english,7,6,3,3,1,0,6,5,1,1,0
23,130901,BOERNE ISD,20,english,7,824,76,748,617,368,818,110,708,584,234
23,130902,COMFORT ISD,13,english,7,89,19,70,33,14,89,38,51,27,3
23,132902,JAYTON-GIRARD I,17,english,7,12,0,12,11,7,12,2,10,9,5
23,133901,CENTER POINT IS,20,english,7,47,12,35,26,15,47,9,38,23,15
23,133902,HUNT ISD,20,english,7,19,1,18,16,10,19,4,15,13,5
23,133903,KERRVILLE ISD,20,english,7,360,70,290,198,103,358,131,227,134,34
23,133904,INGRAM ISD,20,english,7,103,17,86,54,28,103,28,75,44,7
23,134901,JUNCTION ISD,15,english,7,36,13,23,13,5,35,15,20,7,2
23,135001,GUTHRIE CSD,17,english,7,5,0,5,4,0,5,1,4,1,0
23,136901,BRACKETT ISD,20,english,7,39,6,33,19,9,27,14,13,7,0
23,137901,KINGSVILLE ISD,2,english,7,157,76,81,44,20,157,97,60,33,6
23,137902,RICARDO ISD,2,english,7,75,9,66,55,26,75,21,54,34,12
23,137903,RIVIERA ISD,2,english,7,43,2,41,32,15,43,14,29,13,4
23,137904,SANTA GERTRUDIS,2,english,7,51,7,44,37,24,51,15,36,23,8
23,138902,KNOX CITY-O'BRI,9,english,7,9,3,6,6,1,9,3,6,5,3
23,138903,MUNDAY CISD,9,english,7,45,9,36,25,12,45,15,30,13,1
23,138904,BENJAMIN ISD,9,english,7,8,0,8,8,3,8,2,6,3,2
23,139905,CHISUM ISD,8,english,7,86,12,74,54,26,85,17,68,51,12
23,139909,PARIS ISD,8,english,7,241,52,189,125,51,239,97,142,87,23
23,139911,NORTH LAMAR ISD,8,english,7,183,49,134,92,42,184,65,119,74,17
23,139912,PRAIRILAND ISD,8,english,7,88,13,75,58,32,88,29,59,40,13
23,140901,AMHERST ISD,17,english,7,9,4,5,4,0,9,6,3,0,0
23,140904,LITTLEFIELD ISD,17,english,7,102,12,90,61,21,103,31,72,39,8
23,140905,OLTON ISD,17,english,7,46,10,36,24,9,46,11,35,16,6
23,140907,SPRINGLAKE-EART,17,english,7,19,8,11,7,3,19,7,12,11,2
23,140908,SUDAN ISD,17,english,7,36,2,34,30,19,36,11,25,18,4
23,141901,LAMPASAS ISD,12,english,7,256,44,212,157,79,186,68,118,59,6
23,141902,LOMETA ISD,12,english,7,22,1,21,14,7,22,6,16,7,1
23,142901,COTULLA ISD,20,english,7,89,25,64,46,16,89,34,55,29,6
23,143901,HALLETTSVILLE I,3,english,7,78,14,64,44,21,77,15,62,45,15
23,143902,MOULTON ISD,3,english,7,17,5,12,10,5,17,4,13,10,3
23,143903,SHINER ISD,3,english,7,60,5,55,45,23,60,7,53,41,18
23,143904,VYSEHRAD ISD,3,english,7,8,1,7,4,3,8,1,7,4,4
23,143905,SWEET HOME ISD,3,english,7,11,0,11,9,6,11,1,10,10,2
23,143906,EZZELL ISD,3,english,7,13,1,12,8,5,13,1,12,6,4
23,144901,GIDDINGS ISD,13,english,7,159,34,125,76,32,146,50,96,53,6
23,144902,LEXINGTON ISD,13,english,7,80,9,71,48,22,78,12,66,44,7
23,144903,DIME BOX ISD,13,english,7,14,5,9,4,1,14,5,9,4,1
23,145901,BUFFALO ISD,6,english,7,79,13,66,44,17,79,19,60,28,7
23,145902,CENTERVILLE ISD,6,english,7,59,9,50,38,20,60,17,43,22,1
23,145906,NORMANGEE ISD,6,english,7,51,6,45,26,11,51,16,35,22,5
23,145907,OAKWOOD ISD,6,english,7,17,6,11,3,0,17,6,11,1,1
23,145911,LEON ISD,6,english,7,62,12,50,26,8,46,19,27,13,1
23,146901,CLEVELAND ISD,4,english,7,900,487,413,182,41,898,595,303,124,24
23,146902,DAYTON ISD,4,english,7,451,149,302,145,46,448,202,246,115,25
23,146903,DEVERS ISD,4,english,7,20,0,20,17,12,20,1,19,16,8
23,146904,HARDIN ISD,5,english,7,88,19,69,57,23,88,30,58,28,6
23,146905,HULL-DAISETTA I,5,english,7,26,7,19,10,4,25,10,15,9,2
23,146906,LIBERTY ISD,5,english,7,191,55,136,79,26,190,76,114,58,12
23,146907,TARKINGTON ISD,4,english,7,134,35,99,55,28,116,38,78,40,5
23,147901,COOLIDGE ISD,12,english,7,19,4,15,11,4,19,5,14,6,0
23,147902,GROESBECK ISD,12,english,7,128,30,98,65,26,127,54,73,36,9
23,147903,MEXIA ISD,12,english,7,135,56,79,39,14,134,67,67,29,8
23,148901,BOOKER ISD,16,english,7,21,0,21,17,7,22,6,16,10,0
23,148902,FOLLETT ISD,16,english,7,24,3,21,15,9,24,5,19,10,6
23,148905,DARROUZETT ISD,16,english,7,14,2,12,8,6,14,2,12,6,2
23,149901,GEORGE WEST ISD,2,english,7,79,5,74,61,36,70,14,56,36,10
23,149902,THREE RIVERS IS,2,english,7,47,8,39,27,4,47,17,30,19,3
23,150901,LLANO ISD,13,english,7,131,28,103,73,33,101,23,78,44,7
23,152504,TEXAS TECH UNIV,17,english,7,36,1,35,31,17,34,3,31,21,6
23,152802,RISE ACADEMY,17,english,7,15,0,15,14,13,15,1,14,14,9
23,152901,LUBBOCK ISD,17,english,7,1742,487,1255,779,390,1738,725,1013,589,180
23,152902,NEW DEAL ISD,17,english,7,68,11,57,36,11,68,21,47,31,9
23,152903,SLATON ISD,17,english,7,90,31,59,32,11,90,50,40,22,0
23,152906,LUBBOCK-COOPER,17,english,7,628,110,518,369,181,497,153,344,193,27
23,152907,FRENSHIP ISD,17,english,7,834,117,717,534,291,835,224,611,400,123
23,152908,ROOSEVELT ISD,17,english,7,90,19,71,38,18,91,43,48,21,3
23,152909,SHALLOWATER ISD,17,english,7,132,19,113,78,36,132,28,104,71,20
23,152910,IDALOU ISD,17,english,7,76,12,64,44,20,75,17,58,39,16
23,153903,O'DONNELL ISD,17,english,7,23,6,17,13,1,23,4,19,6,0
23,153904,TAHOKA ISD,17,english,7,41,11,30,18,9,41,9,32,26,5
23,153905,NEW HOME ISD,17,english,7,50,4,46,38,20,50,13,37,27,2
23,153907,WILSON ISD,17,english,7,6,2,4,1,0,6,3,3,1,0
23,154901,MADISONVILLE CI,6,english,7,186,31,155,98,42,186,52,134,85,23
23,154903,NORTH ZULCH ISD,6,english,7,23,1,22,17,7,23,2,21,14,7
23,155901,JEFFERSON ISD,8,english,7,92,28,64,43,18,98,37,61,35,7
23,156902,STANTON ISD,18,english,7,82,16,66,43,21,72,18,54,31,7
23,156905,GRADY ISD,18,english,7,18,0,18,17,9,18,2,16,11,3
23,157901,MASON ISD,15,english,7,43,7,36,29,14,43,10,33,25,7
23,158901,BAY CITY ISD,3,english,7,261,67,194,123,53,261,115,146,78,26
23,158902,TIDEHAVEN ISD,3,english,7,84,3,81,59,39,67,15,52,32,3
23,158904,MATAGORDA ISD,3,english,7,11,4,7,7,2,10,5,5,3,1
23,158905,PALACIOS ISD,3,english,7,88,22,66,40,20,88,32,56,28,5
23,158906,VAN VLECK ISD,3,english,7,80,26,54,31,13,79,25,54,24,5
23,159901,EAGLE PASS ISD,20,english,7,1000,282,718,430,158,998,429,569,305,88
23,160901,BRADY ISD,15,english,7,57,12,45,26,9,50,16,34,17,1
23,160904,ROCHELLE ISD,15,english,7,11,1,10,7,6,11,0,11,10,7
23,160905,LOHN ISD,15,english,7,14,7,7,4,0,14,7,7,2,0
23,161802,RAPOPORT ACADEM,12,english,7,53,10,43,28,9,52,20,32,9,1
23,161807,HARMONY PUBLIC,12,english,7,888,153,735,506,283,870,246,624,401,157
23,161901,CRAWFORD ISD,12,english,7,46,1,45,36,21,46,2,44,39,18
23,161903,MIDWAY ISD,12,english,7,653,67,586,443,259,652,116,536,408,192
23,161906,LA VEGA ISD,12,english,7,228,78,150,71,17,231,134,97,43,4
23,161907,LORENA ISD,12,english,7,162,17,145,114,59,162,31,131,90,30
23,161908,MART ISD,12,english,7,50,16,34,21,6,38,21,17,7,0
23,161909,MCGREGOR ISD,12,english,7,111,28,83,41,16,109,28,81,46,12
23,161910,MOODY ISD,12,english,7,49,9,40,21,8,49,21,28,12,2
23,161912,RIESEL ISD,12,english,7,61,9,52,37,19,38,10,28,14,2
23,161914,WACO ISD,12,english,7,900,388,512,252,85,905,528,377,169,21
23,161916,WEST ISD,12,english,7,87,12,75,58,25,51,11,40,28,2
23,161918,AXTELL ISD,12,english,7,64,12,52,37,17,47,21,26,14,3
23,161919,BRUCEVILLE-EDDY,12,english,7,55,14,41,24,4,55,21,34,13,0
23,161920,CHINA SPRING IS,12,english,7,240,16,224,174,92,172,49,123,55,5
23,161921,CONNALLY ISD,12,english,7,172,82,90,42,12,140,101,39,10,0
23,161922,ROBINSON ISD,12,english,7,197,29,168,124,61,152,50,102,58,9
23,161923,BOSQUEVILLE ISD,12,english,7,50,13,37,28,12,37,10,27,11,0
23,161925,GHOLSON ISD,12,english,7,19,2,17,12,7,19,7,12,9,3
23,162904,MCMULLEN COUNTY,2,english,7,19,2,17,15,7,19,1,18,16,4
23,163901,DEVINE ISD,20,english,7,143,35,108,61,26,120,47,73,33,1
23,163902,D'HANIS ISD,20,english,7,23,1,22,16,10,23,3,20,16,6
23,163903,NATALIA ISD,20,english,7,76,30,46,25,9,75,39,36,16,4
23,163904,HONDO ISD,20,english,7,135,41,94,50,16,136,60,76,48,11
23,163908,MEDINA VALLEY I,20,english,7,573,91,482,344,160,576,161,415,278,104
23,164901,MENARD ISD,15,english,7,19,5,14,10,6,18,4,14,8,3
23,165802,MIDLAND ACADEMY,18,english,7,30,1,29,28,14,24,3,21,15,5
23,165901,MIDLAND ISD,18,english,7,2037,702,1335,793,336,1507,829,678,273,27
23,165902,GREENWOOD ISD,18,english,7,239,50,189,139,64,174,67,107,46,4
23,166901,CAMERON ISD,6,english,7,121,33,88,59,22,126,40,86,54,11
23,166902,GAUSE ISD,6,english,7,13,3,10,9,4,13,3,10,7,3
23,166903,MILANO ISD,6,english,7,22,2,20,14,6,19,6,13,7,0
23,166904,ROCKDALE ISD,6,english,7,106,17,89,54,26,106,40,66,37,7
23,166905,THORNDALE ISD,13,english,7,51,4,47,35,18,29,6,23,6,1
23,166907,BUCKHOLTS ISD,12,english,7,11,2,9,6,4,11,6,5,4,2
23,167901,GOLDTHWAITE ISD,12,english,7,36,3,33,27,16,36,4,32,22,8
23,167902,MULLIN ISD,12,english,7,20,11,9,4,3,20,13,7,5,1
23,167904,PRIDDY ISD,12,english,7,6,0,6,4,1,6,0,6,4,1
23,168901,COLORADO ISD,14,english,7,55,17,38,21,8,55,25,30,12,1
23,168902,LORAINE ISD,14,english,7,9,4,5,2,0,9,5,4,0,0
23,168903,WESTBROOK ISD,14,english,7,21,1,20,16,7,21,1,20,11,2
23,169901,BOWIE ISD,9,english,7,121,28,93,59,29,109,55,54,21,1
23,169902,NOCONA ISD,9,english,7,57,14,43,22,10,51,19,32,18,1
23,169906,GOLD BURG ISD,9,english,7,14,2,12,11,7,14,5,9,7,0
23,169908,MONTAGUE ISD,9,english,7,11,1,10,8,4,11,2,9,8,5
23,169909,PRAIRIE VALLEY,9,english,7,6,0,6,5,1,6,1,5,2,0
23,169910,FORESTBURG ISD,9,english,7,10,1,9,4,3,10,1,9,4,1
23,169911,SAINT JO ISD,9,english,7,23,5,18,10,5,23,8,15,8,2
23,170801,TEXAS SERENITY,4,english,7,25,11,14,6,1,25,21,4,1,0
23,170902,CONROE ISD,6,english,7,5373,872,4501,3411,1999,3333,1250,2083,1137,208
23,170903,MONTGOMERY ISD,6,english,7,722,92,630,490,243,489,99,390,246,43
23,170904,WILLIS ISD,6,english,7,728,224,504,303,115,572,317,255,84,6
23,170906,MAGNOLIA ISD,6,english,7,1032,186,846,593,293,1028,290,738,463,152
23,170907,SPLENDORA ISD,6,english,7,371,127,244,114,42,258,171,87,26,1
23,170908,NEW CANEY ISD,6,english,7,1377,418,959,600,271,1370,575,795,450,112
23,171901,DUMAS ISD,16,english,7,304,78,226,134,43,302,77,225,144,34
23,171902,SUNRAY COLLEGIA,16,english,7,52,7,45,29,14,52,9,43,22,4
23,172902,DAINGERFIELD-LO,8,english,7,74,29,45,27,7,75,45,30,10,3
23,172905,PEWITT CISD,8,english,7,60,7,53,40,16,60,12,48,32,7
23,173901,MOTLEY COUNTY I,17,english,7,10,2,8,5,2,10,2,8,7,1
23,174901,CHIRENO ISD,7,english,7,26,7,19,11,8,26,10,16,11,4
23,174902,CUSHING ISD,7,english,7,42,9,33,20,9,42,18,24,12,4
23,174903,GARRISON ISD,7,english,7,58,8,50,30,16,40,9,31,20,0
23,174904,NACOGDOCHES ISD,7,english,7,454,161,293,170,67,453,240,213,101,31
23,174906,WODEN ISD,7,english,7,52,7,45,37,23,50,15,35,24,5
23,174908,CENTRAL HEIGHTS,7,english,7,87,9,78,70,39,87,11,76,61,26
23,174909,MARTINSVILLE IS,7,english,7,27,2,25,17,10,27,9,18,10,6
23,174911,DOUGLASS ISD,7,english,7,35,4,31,18,8,35,12,23,19,7
23,175902,BLOOMING GROVE,12,english,7,77,17,60,34,9,77,27,50,22,2
23,175903,CORSICANA ISD,12,english,7,430,149,281,164,67,432,173,259,145,40
23,175904,DAWSON ISD,12,english,7,45,11,34,21,5,44,17,27,17,2
23,175905,FROST ISD,12,english,7,41,12,29,15,3,41,17,24,12,0
23,175907,KERENS ISD,12,english,7,49,9,40,28,8,48,14,34,17,1
23,175910,MILDRED ISD,12,english,7,62,11,51,33,17,62,21,41,28,5
23,175911,RICE ISD,12,english,7,75,17,58,40,15,75,19,56,36,10
23,176901,BURKEVILLE ISD,5,english,7,13,3,10,2,0,13,9,4,1,0
23,176902,NEWTON ISD,5,english,7,71,19,52,34,18,71,28,43,24,5
23,176903,DEWEYVILLE ISD,5,english,7,34,5,29,18,8,34,16,18,6,0
23,177901,ROSCOE COLLEGIA,14,english,7,444,126,318,171,48,444,253,191,79,9
23,177902,SWEETWATER ISD,14,english,7,156,58,98,49,14,148,84,64,20,4
23,177903,BLACKWELL CISD,14,english,7,15,2,13,7,1,15,5,10,4,0
23,177905,HIGHLAND ISD,14,english,7,17,2,15,13,5,17,1,16,16,5
23,178801,DR M L GARZA-GO,2,english,7,20,5,15,8,1,20,15,5,2,0
23,178807,CORPUS CHRISTI,2,english,7,16,3,13,10,1,15,8,7,4,0
23,178808,SEASHORE CHARTE,2,english,7,42,2,40,36,19,40,8,32,20,4
23,178901,AGUA DULCE ISD,2,english,7,35,6,29,20,11,34,14,20,10,1
23,178902,BISHOP CISD,2,english,7,96,12,84,61,27,98,16,82,58,22
23,178903,CALALLEN ISD,2,english,7,309,46,263,192,98,311,69,242,166,45
23,178904,CORPUS CHRISTI,2,english,7,2313,678,1635,1001,455,1731,1079,652,232,51
23,178905,DRISCOLL ISD,2,english,7,28,6,22,15,8,28,5,23,12,5
23,178906,LONDON ISD,2,english,7,131,1,130,115,77,119,11,108,92,26
23,178908,PORT ARANSAS IS,2,english,7,44,1,43,32,14,44,4,40,26,5
23,178909,ROBSTOWN ISD,2,english,7,156,75,81,37,13,156,99,57,19,5
23,178912,TULOSO-MIDWAY I,2,english,7,264,43,221,156,80,267,94,173,114,39
23,178913,BANQUETE ISD,2,english,7,66,10,56,44,14,66,7,59,39,13
23,178914,FLOUR BLUFF ISD,2,english,7,423,64,359,265,143,430,79,351,262,85
23,178915,WEST OSO ISD,2,english,7,149,53,96,49,16,147,77,70,36,7
23,179901,PERRYTON ISD,16,english,7,135,28,107,73,27,106,27,79,48,7
23,180901,BOYS RANCH ISD,16,english,7,12,1,11,6,2,12,1,11,10,1
23,180902,VEGA ISD,16,english,7,26,2,24,22,12,26,2,24,21,10
23,180903,ADRIAN ISD,16,english,7,11,1,10,9,5,11,3,8,5,0
23,180904,WILDORADO ISD,16,english,7,17,3,14,11,5,16,7,9,7,2
23,181901,BRIDGE CITY ISD,5,english,7,230,41,189,124,52,186,67,119,74,9
23,181905,ORANGEFIELD ISD,5,english,7,149,20,129,91,39,149,32,117,54,18
23,181906,WEST ORANGE-COV,5,english,7,185,57,128,61,18,185,110,75,29,4
23,181907,VIDOR ISD,5,english,7,296,67,229,164,77,296,89,207,126,37
23,181908,LITTLE CYPRESS-,5,english,7,241,43,198,130,55,189,74,115,47,1
23,182901,GORDON ISD,11,english,7,22,3,19,10,4,22,10,12,7,3
23,182902,GRAFORD ISD,11,english,7,19,3,16,11,6,19,4,15,6,1
23,182903,MINERAL WELLS I,11,english,7,233,71,162,92,38,180,107,73,34,0
23,182904,SANTO ISD,11,english,7,42,3,39,31,18,42,4,38,26,13
23,182905,STRAWN ISD,11,english,7,16,5,11,7,1,16,8,8,3,0
23,183901,BECKVILLE ISD,7,english,7,48,5,43,34,14,48,10,38,33,12
23,183902,CARTHAGE ISD,7,english,7,188,33,155,107,52,187,48,139,91,15
23,183904,GARY ISD,7,english,7,26,4,22,17,7,26,10,16,9,1
23,184901,POOLVILLE ISD,11,english,7,52,6,46,24,7,36,13,23,10,0
23,184902,SPRINGTOWN ISD,11,english,7,319,76,243,146,40,320,110,210,111,12
23,184903,WEATHERFORD ISD,11,english,7,652,130,522,366,172,653,199,454,277,84
23,184904,MILLSAP ISD,11,english,7,77,16,61,41,14,77,9,68,52,29
23,184907,ALEDO ISD,11,english,7,592,47,545,458,298,263,86,177,103,12
23,184908,PEASTER ISD,11,english,7,123,25,98,69,25,90,33,57,23,2
23,184909,BROCK ISD,11,english,7,156,6,150,128,80,156,11,145,117,36
23,184911,GARNER ISD,11,english,7,31,9,22,11,2,31,7,24,15,1
23,185901,BOVINA ISD,16,english,7,27,8,19,8,3,27,11,16,7,1
23,185902,FARWELL ISD,16,english,7,56,4,52,43,20,56,7,49,33,12
23,185903,FRIONA ISD,16,english,7,64,10,54,31,4,64,29,35,17,3
23,185904,LAZBUDDIE ISD,16,english,7,11,0,11,10,6,11,1,10,7,4
23,186901,BUENA VISTA ISD,18,english,7,17,2,15,11,5,17,4,13,8,3
23,186902,FORT STOCKTON I,18,english,7,142,38,104,66,33,143,66,77,45,10
23,186903,IRAAN-SHEFFIELD,18,english,7,27,6,21,11,4,26,11,15,3,0
23,187901,BIG SANDY ISD,6,english,7,42,6,36,29,14,42,15,27,15,1
23,187903,GOODRICH ISD,6,english,7,15,5,10,4,1,15,6,9,2,1
23,187904,CORRIGAN-CAMDEN,6,english,7,59,13,46,25,12,60,25,35,19,5
23,187906,LEGGETT ISD,6,english,7,9,5,4,2,1,9,7,2,1,0
23,187907,LIVINGSTON ISD,6,english,7,289,79,210,110,45,235,129,106,33,1
23,187910,ONALASKA ISD,6,english,7,92,22,70,48,24,92,29,63,38,13
23,188901,AMARILLO ISD,16,english,7,2166,523,1643,1038,483,1475,759,716,263,25
23,188902,RIVER ROAD ISD,16,english,7,111,27,84,62,30,87,33,54,19,0
23,188903,HIGHLAND PARK I,16,english,7,59,12,47,28,10,51,20,31,14,0
23,188904,BUSHLAND ISD,16,english,7,127,11,116,90,53,127,22,105,83,29
23,189901,MARFA ISD,18,english,7,15,0,15,6,2,15,6,9,4,1
23,189902,PRESIDIO ISD,18,english,7,91,26,65,42,17,90,48,42,22,5
23,190903,RAINS ISD,7,english,7,142,45,97,43,16,143,71,72,33,5
23,191901,CANYON ISD,16,english,7,829,129,700,463,172,831,156,675,456,140
23,192901,REAGAN COUNTY I,18,english,7,53,10,43,40,21,53,13,40,23,6
23,193801,BIG SPRINGS CHA,20,english,7,18,6,12,3,1,18,9,9,1,0
23,193902,LEAKEY ISD,20,english,7,27,3,24,15,6,27,5,22,15,0
23,194902,AVERY ISD,8,english,7,28,6,22,17,7,28,9,19,13,3
23,194903,RIVERCREST ISD,8,english,7,52,8,44,35,13,53,10,43,37,15
23,194904,CLARKSVILLE ISD,8,english,7,27,16,11,3,0,27,18,9,5,1
23,194905,DETROIT ISD,8,english,7,44,17,27,14,3,44,16,28,19,9
23,195901,PECOS-BARSTOW-T,18,english,7,213,73,140,76,19,213,103,110,53,4
23,195902,BALMORHEA ISD,18,english,7,7,2,5,2,1,7,4,3,2,0
23,196901,AUSTWELL-TIVOLI,3,english,7,13,3,10,6,2,13,1,12,5,1
23,196902,WOODSBORO ISD,3,english,7,25,3,22,15,3,25,9,16,9,2
23,196903,REFUGIO ISD,3,english,7,49,7,42,26,8,50,13,37,8,1
23,197902,MIAMI ISD,16,english,7,15,2,13,11,2,15,4,11,7,1
23,198901,BREMOND ISD,6,english,7,38,5,33,25,12,38,13,25,10,4
23,198902,CALVERT ISD,6,english,7,0,,,,,0,,,,
23,198903,FRANKLIN ISD,6,english,7,99,6,93,73,46,99,8,91,64,26
23,198905,HEARNE ISD,6,english,7,54,16,38,20,8,54,29,25,11,3
23,198906,MUMFORD ISD,6,english,7,35,0,35,33,23,35,2,33,28,11
23,199901,ROCKWALL ISD,10,english,7,1431,161,1270,1012,616,604,196,408,206,21
23,199902,ROYSE CITY ISD,10,english,7,635,133,502,316,141,437,197,240,97,9
23,200901,BALLINGER ISD,15,english,7,65,19,46,22,6,65,30,35,21,4
23,200902,MILES ISD,15,english,7,39,7,32,25,12,39,6,33,23,7
23,200904,WINTERS ISD,15,english,7,37,7,30,21,10,37,9,28,18,5
23,200906,OLFEN ISD,15,english,7,10,0,10,7,2,10,5,5,4,0
23,201902,HENDERSON ISD,7,english,7,275,109,166,81,22,276,130,146,81,22
23,201903,LANEVILLE ISD,7,english,7,12,4,8,2,0,12,6,6,5,1
23,201904,LEVERETTS CHAPE,7,english,7,16,5,11,9,2,16,7,9,7,1
23,201907,MOUNT ENTERPRIS,7,english,7,30,8,22,18,7,29,16,13,8,1
23,201908,OVERTON ISD,7,english,7,29,8,21,13,6,29,12,17,7,1
23,201910,TATUM ISD,7,english,7,106,20,86,53,30,107,30,77,38,6
23,201913,CARLISLE ISD,7,english,7,39,8,31,18,3,39,17,22,14,3
23,201914,WEST RUSK COUNT,7,english,7,73,12,61,46,26,73,27,46,28,8
23,202903,HEMPHILL ISD,7,english,7,64,9,55,33,16,63,10,53,32,6
23,202905,WEST SABINE ISD,7,english,7,48,10,38,25,9,48,15,33,18,3
23,203901,SAN AUGUSTINE I,7,english,7,50,22,28,12,5,50,34,16,5,1
23,203902,BROADDUS ISD,7,english,7,20,3,17,12,2,20,2,18,14,1
23,204901,COLDSPRING-OAKH,6,english,7,109,60,49,26,5,108,56,52,19,4
23,204904,SHEPHERD ISD,6,english,7,140,64,76,39,12,139,73,66,36,12
23,205901,ARANSAS PASS IS,2,english,7,117,33,84,56,15,115,64,51,20,1
23,205902,GREGORY-PORTLAN,2,english,7,352,60,292,199,97,353,96,257,186,79
23,205903,INGLESIDE ISD,2,english,7,145,22,123,68,25,117,50,67,26,0
23,205904,MATHIS ISD,2,english,7,108,17,91,63,22,110,42,68,35,10
23,205905,ODEM-EDROY ISD,2,english,7,51,9,42,24,5,50,20,30,16,4
23,205906,SINTON ISD,2,english,7,123,26,97,64,29,94,54,40,7,0
23,205907,TAFT ISD,2,english,7,73,24,49,26,6,74,44,30,8,1
23,206901,SAN SABA ISD,15,english,7,45,11,34,25,10,45,14,31,14,4
23,206902,RICHLAND SPRING,15,english,7,9,1,8,5,1,9,2,7,1,0
23,206903,CHEROKEE ISD,15,english,7,11,0,11,10,6,11,1,10,7,1
23,207901,SCHLEICHER ISD,15,english,7,26,5,21,15,8,26,9,17,12,3
23,208901,HERMLEIGH ISD,14,english,7,23,7,16,10,3,23,12,11,7,2
23,208902,SNYDER ISD,14,english,7,212,64,148,80,26,210,98,112,60,14
23,208903,IRA ISD,14,english,7,23,0,23,20,11,23,1,22,17,7
23,209901,ALBANY ISD,14,english,7,32,2,30,16,8,31,7,24,11,3
23,209902,MORAN ISD,14,english,7,12,4,8,4,2,12,7,5,4,0
23,210901,CENTER ISD,7,english,7,170,45,125,76,27,170,67,103,59,9
23,210902,JOAQUIN ISD,7,english,7,45,1,44,33,19,45,6,39,28,6
23,210903,SHELBYVILLE ISD,7,english,7,63,13,50,34,13,63,15,48,27,4
23,210904,TENAHA ISD,7,english,7,40,12,28,15,4,40,15,25,12,1
23,210905,TIMPSON ISD,7,english,7,44,11,33,24,10,44,17,27,16,4
23,210906,EXCELSIOR ISD,7,english,7,0,,,,,0,,,,
23,211902,STRATFORD ISD,16,english,7,35,9,26,21,11,35,10,25,14,6
23,212801,CUMBERLAND ACAD,7,english,7,138,21,117,82,38,108,52,56,30,4
23,212804,UT TYLER UNIVER,7,english,7,69,3,66,52,39,69,10,59,45,19
23,212901,ARP ISD,7,english,7,77,17,60,36,11,65,30,35,11,0
23,212902,BULLARD ISD,7,english,7,227,21,206,156,86,226,40,186,142,46
23,212903,LINDALE ISD,7,english,7,349,41,308,245,157,349,51,298,225,114
23,212904,TROUP ISD,7,english,7,79,13,66,46,26,58,20,38,13,0
23,212905,TYLER ISD,7,english,7,1288,335,953,643,324,1248,504,744,441,143
23,212906,WHITEHOUSE ISD,7,english,7,357,53,304,246,145,245,55,190,126,36
23,212909,CHAPEL HILL ISD,7,english,7,249,88,161,87,36,216,129,87,33,2
23,212910,WINONA ISD,7,english,7,81,13,68,47,21,81,26,55,31,10
23,213801,BRAZOS RIVER CH,11,english,7,0,,,,,0,,,,
23,213901,GLEN ROSE ISD,11,english,7,150,22,128,109,49,140,32,108,69,8
23,214901,RIO GRANDE CITY,1,english,7,685,234,451,251,98,684,323,361,173,45
23,214902,SAN ISIDRO ISD,1,english,7,15,0,15,14,6,15,1,14,8,1
23,214903,ROMA ISD,1,english,7,441,138,303,181,66,438,156,282,172,54
23,215901,BRECKENRIDGE IS,14,english,7,94,15,79,61,28,94,26,68,50,23
23,216901,STERLING CITY I,15,english,7,28,10,18,11,9,28,6,22,15,8
23,217901,ASPERMONT ISD,14,english,7,18,4,14,9,5,18,8,10,7,5
23,218901,SONORA ISD,15,english,7,42,9,33,20,8,41,13,28,18,2
23,219901,HAPPY ISD,16,english,7,20,2,18,14,5,20,2,18,14,5
23,219903,TULIA ISD,16,english,7,80,38,42,17,3,80,42,38,16,4
23,219905,KRESS ISD,16,english,7,24,3,21,17,8,24,11,13,7,0
23,220801,TREETOPS SCHOOL,11,english,7,23,1,22,19,15,23,2,21,17,3
23,220802,ARLINGTON CLASS,11,english,7,153,2,151,140,87,155,15,140,97,31
23,220809,FORT WORTH ACAD,11,english,7,86,3,83,65,40,63,19,44,13,1
23,220810,WESTLAKE ACADEM,11,english,7,74,2,72,68,50,0,,,,
23,220815,CHAPEL HILL ACA,11,english,7,58,11,47,28,5,60,28,32,19,2
23,220817,NEWMAN INTERNAT,11,english,7,194,31,163,113,53,150,60,90,47,10
23,220819,HIGH POINT ACAD,11,english,7,103,21,82,60,30,84,34,50,19,0
23,220901,ARLINGTON ISD,11,english,7,3868,1251,2617,1594,661,3825,1652,2173,1282,344
23,220902,BIRDVILLE ISD,11,english,7,1650,343,1307,924,442,1646,494,1152,737,273
23,220904,EVERMAN ISD,11,english,7,348,157,191,93,33,346,207,139,49,4
23,220905,FORT WORTH ISD,11,english,7,4933,2092,2841,1560,608,3603,2553,1050,234,7
23,220906,GRAPEVINE-COLLE,11,english,7,1064,103,961,800,530,535,175,360,217,42
23,220907,KELLER ISD,11,english,7,2519,342,2177,1687,994,1763,539,1224,682,118
23,220908,MANSFIELD ISD,11,english,7,2722,503,2219,1587,752,2722,714,2008,1366,503
23,220910,LAKE WORTH ISD,11,english,7,256,98,158,78,24,248,153,95,36,6
23,220912,CROWLEY ISD,11,english,7,1168,380,788,469,202,909,585,324,108,8
23,220914,KENNEDALE ISD,11,english,7,193,42,151,109,44,151,53,98,38,4
23,220915,AZLE ISD,11,english,7,530,101,429,286,134,441,141,300,176,29
23,220916,HURST-EULESS-BE,11,english,7,1697,253,1444,1105,644,1698,310,1388,1014,466
23,220917,CASTLEBERRY ISD,11,english,7,268,99,169,98,34,193,127,66,13,0
23,220918,EAGLE MT-SAGINA,11,english,7,1749,362,1387,952,457,1182,548,634,258,18
23,220919,CARROLL ISD,11,english,7,643,11,632,589,441,494,18,476,434,257
23,220920,WHITE SETTLEMEN,11,english,7,502,132,370,229,98,499,184,315,178,45
23,221801,TEXAS COLLEGE P,14,english,7,1262,170,1092,807,403,1183,325,858,534,155
23,221901,ABILENE ISD,14,english,7,1002,319,683,396,160,1004,482,522,249,71
23,221904,MERKEL ISD,14,english,7,91,20,71,41,11,91,35,56,28,4
23,221905,TRENT ISD,14,english,7,8,3,5,2,0,8,3,5,2,1
23,221911,JIM NED CISD,14,english,7,109,11,98,79,60,109,16,93,70,23
23,221912,WYLIE ISD,14,english,7,401,48,353,267,140,401,83,318,209,59
23,222901,TERRELL COUNTY,18,english,7,14,1,13,9,6,14,2,12,7,2
23,223901,BROWNFIELD ISD,17,english,7,111,35,76,39,13,111,49,62,24,5
23,223902,MEADOW ISD,17,english,7,18,6,12,3,1,18,10,8,4,0
23,223904,WELLMAN-UNION C,17,english,7,16,2,14,7,3,16,3,13,7,0
23,224901,THROCKMORTON CO,9,english,7,0,,,,,0,,,,
23,224902,WOODSON ISD,9,english,7,17,4,13,10,5,17,5,12,9,4
23,225902,MOUNT PLEASANT,8,english,7,351,65,286,201,92,350,112,238,143,26
23,225906,CHAPEL HILL ISD,8,english,7,68,3,65,55,28,68,13,55,41,7
23,225907,HARTS BLUFF ISD,8,english,7,73,10,63,51,27,73,14,59,36,13
23,226801,TEXAS LEADERSHI,15,english,7,331,95,236,136,33,332,140,192,102,18
23,226901,CHRISTOVAL ISD,15,english,7,54,4,50,42,17,56,10,46,29,5
23,226903,SAN ANGELO ISD,15,english,7,960,315,645,386,175,948,429,519,261,61
23,226905,WATER VALLEY IS,15,english,7,28,4,24,15,2,28,10,18,16,1
23,226906,WALL ISD,15,english,7,113,3,110,95,62,113,5,108,89,44
23,226907,GRAPE CREEK ISD,15,english,7,94,34,60,36,15,94,42,52,20,5
23,226908,VERIBEST ISD,15,english,7,19,3,16,13,5,19,5,14,9,0
23,227803,WAYSIDE SCHOOLS,13,english,7,122,60,62,26,11,111,80,31,6,0
23,227804,NYOS CHARTER SC,13,english,7,150,15,135,115,71,86,37,49,24,1
23,227805,TEXAS EMPOWERME,13,english,7,23,2,21,11,3,21,3,18,12,5
23,227806,UNIVERSITY OF T,13,english,7,65,33,32,16,4,66,45,21,9,1
23,227814,CHAPARRAL STAR,13,english,7,38,1,37,34,23,36,5,31,28,12
23,227816,HARMONY PUBLIC,13,english,7,365,88,277,214,128,364,122,242,162,63
23,227817,CEDARS INTERNAT,13,english,7,31,6,25,21,11,14,6,8,4,0
23,227820,KIPP TEXAS PUBL,4,english,7,2623,719,1904,1207,562,2625,1246,1379,683,139
23,227824,VALERE PUBLIC S,13,english,7,57,21,36,19,7,57,34,23,8,1
23,227825,AUSTIN ACHIEVE,13,english,7,199,79,120,51,22,202,120,82,37,5
23,227829,VALOR PUBLIC SC,13,english,7,172,13,159,119,68,118,31,87,46,13
23,227901,AUSTIN ISD,13,english,7,4718,1333,3385,2494,1489,2861,1486,1375,746,195
23,227904,PFLUGERVILLE IS,13,english,7,1897,431,1466,1044,512,1076,601,475,210,27
23,227905,TEXAS SCH FOR T,13,english,7,0,,,,,0,,,,
23,227906,TEXAS SCH FOR T,13,english,7,30,20,10,6,3,30,25,5,5,2
23,227907,MANOR ISD,13,english,7,465,214,251,103,21,461,306,155,44,5
23,227909,EANES ISD,13,english,7,628,14,614,572,437,582,17,565,517,267
23,227910,DEL VALLE ISD,13,english,7,794,365,429,234,86,531,438,93,13,1
23,227912,LAGO VISTA ISD,13,english,7,128,26,102,67,25,96,36,60,24,0
23,227913,LAKE TRAVIS ISD,13,english,7,822,73,749,635,388,458,73,385,268,49
23,228901,GROVETON ISD,6,english,7,70,15,55,42,18,70,27,43,25,7
23,228903,TRINITY ISD,6,english,7,92,27,65,32,4,92,43,49,21,3
23,228904,CENTERVILLE ISD,6,english,7,13,2,11,9,5,13,2,11,10,1
23,228905,APPLE SPRINGS I,6,english,7,15,5,10,6,4,15,3,12,6,1
23,229901,COLMESNEIL ISD,5,english,7,38,7,31,20,8,38,11,27,17,4
23,229903,WOODVILLE ISD,5,english,7,103,45,58,25,11,103,60,43,19,5
23,229904,WARREN ISD,5,english,7,84,16,68,46,10,85,17,68,40,8
23,229905,SPURGER ISD,5,english,7,34,3,31,23,9,34,8,26,15,3
23,229906,CHESTER ISD,5,english,7,16,5,11,7,1,16,7,9,4,0
23,230901,BIG SANDY ISD,7,english,7,52,16,36,23,7,45,17,28,21,1
23,230902,GILMER ISD,7,english,7,218,49,169,103,46,216,62,154,95,31
23,230903,ORE CITY ISD,7,english,7,64,13,51,31,7,66,21,45,18,3
23,230904,UNION HILL ISD,7,english,7,15,3,12,5,4,15,5,10,3,0
23,230905,HARMONY ISD,7,english,7,85,11,74,58,33,85,24,61,39,8
23,230906,NEW DIANA ISD,7,english,7,101,6,95,66,40,101,23,78,52,16
23,230908,UNION GROVE ISD,7,english,7,63,4,59,44,23,64,10,54,40,8
23,231901,MCCAMEY ISD,18,english,7,43,13,30,15,6,40,21,19,5,0
23,231902,RANKIN ISD,18,english,7,29,3,26,19,6,29,7,22,11,4
23,232901,KNIPPA ISD,20,english,7,31,1,30,19,7,31,4,27,24,10
23,232902,SABINAL ISD,20,english,7,31,12,19,8,3,31,15,16,5,2
23,232903,UVALDE CISD,20,english,7,276,107,169,92,32,216,153,63,16,1
23,232904,UTOPIA ISD,20,english,7,18,7,11,7,5,18,9,9,7,1
23,233901,SAN FELIPE-DEL,15,english,7,724,290,434,246,88,719,341,378,224,59
23,233903,COMSTOCK ISD,15,english,7,15,4,11,8,6,14,6,8,4,0
23,234801,RANCH ACADEMY,7,english,7,6,2,4,2,1,6,3,3,2,0
23,234902,CANTON ISD,10,english,7,177,19,158,115,59,177,42,135,73,17
23,234903,EDGEWOOD ISD,7,english,7,77,9,68,51,24,59,10,49,26,4
23,234904,GRAND SALINE IS,7,english,7,101,30,71,48,12,100,34,66,39,8
23,234905,MARTINS MILL IS,7,english,7,33,5,28,20,12,34,4,30,20,9
23,234906,VAN ISD,7,english,7,190,47,143,94,34,189,60,129,82,26
23,234907,WILLS POINT ISD,10,english,7,170,55,115,73,22,170,71,99,55,10
23,234909,FRUITVALE ISD,7,english,7,30,5,25,19,10,30,5,25,19,6
23,235901,BLOOMINGTON ISD,3,english,7,63,35,28,16,5,61,40,21,4,0
23,235902,VICTORIA ISD,3,english,7,892,344,548,309,118,746,481,265,88,8
23,236901,NEW WAVERLY ISD,6,english,7,85,8,77,60,27,66,21,45,28,3
23,236902,HUNTSVILLE ISD,6,english,7,982,198,784,517,211,848,361,487,228,23
23,237902,HEMPSTEAD ISD,4,english,7,119,72,47,20,6,101,87,14,1,0
23,237904,WALLER ISD,4,english,7,639,170,469,304,131,640,254,386,215,57
23,237905,ROYAL ISD,4,english,7,198,59,139,76,21,197,87,110,64,13
23,238902,MONAHANS-WICKET,18,english,7,163,48,115,68,29,163,53,110,63,17
23,238904,GRANDFALLS-ROYA,18,english,7,11,1,10,7,2,11,4,7,4,0
23,239901,BRENHAM ISD,6,english,7,357,98,259,166,66,358,122,236,163,81
23,239903,BURTON ISD,6,english,7,27,1,26,24,12,27,1,26,21,6
23,240901,LAREDO ISD,1,english,7,1366,395,971,611,296,1367,666,701,373,100
23,240903,UNITED ISD,1,english,7,3031,628,2403,1755,935,3032,1090,1942,1140,336
23,240904,WEBB CISD,1,english,7,21,5,16,15,8,21,5,16,13,3
23,241901,BOLING ISD,3,english,7,89,21,68,37,13,89,40,49,20,4
23,241902,EAST BERNARD IS,3,english,7,82,9,73,60,34,82,12,70,52,22
23,241903,EL CAMPO ISD,3,english,7,228,44,184,120,55,225,63,162,94,22
23,241904,WHARTON ISD,3,english,7,130,50,80,36,10,108,77,31,6,0
23,241906,LOUISE ISD,3,english,7,42,8,34,18,8,33,13,20,8,0
23,242902,SHAMROCK ISD,16,english,7,22,6,16,9,4,22,7,15,10,3
23,242903,WHEELER ISD,16,english,7,23,1,22,16,10,23,6,17,12,1
23,242905,KELTON ISD,16,english,7,9,5,4,2,2,9,2,7,3,0
23,242906,FORT ELLIOTT CI,16,english,7,12,1,11,9,4,12,2,10,7,0
23,243901,BURKBURNETT ISD,9,english,7,245,43,202,138,54,173,55,118,49,2
23,243902,ELECTRA ISD,9,english,7,38,9,29,16,5,38,10,28,18,3
23,243903,IOWA PARK CISD,9,english,7,138,18,120,92,45,139,27,112,87,37
23,243905,WICHITA FALLS I,9,english,7,863,291,572,325,144,854,328,526,337,119
23,243906,CITY VIEW ISD,9,english,7,92,10,82,58,22,93,24,69,39,6
23,244901,HARROLD ISD,9,english,7,13,0,13,7,5,13,5,8,5,1
23,244903,VERNON ISD,9,english,7,113,36,77,41,15,112,49,63,30,10
23,244905,NORTHSIDE ISD,9,english,7,20,2,18,10,4,20,3,17,9,1
23,245901,LASARA ISD,1,english,7,20,4,16,6,3,22,16,6,2,0
23,245902,LYFORD CISD,1,english,7,95,41,54,28,7,96,55,41,16,2
23,245903,RAYMONDVILLE IS,1,english,7,128,17,111,83,46,126,38,88,47,19
23,245904,SAN PERLITA ISD,1,english,7,18,4,14,4,3,18,8,10,6,0
23,246801,MERIDIAN WORLD,13,english,7,148,3,145,130,98,12,10,2,0,0
23,246802,GOODWATER MONTE,13,english,7,14,1,13,10,4,15,2,13,7,1
23,246902,FLORENCE ISD,13,english,7,79,22,57,36,23,56,30,26,12,1
23,246904,GEORGETOWN ISD,13,english,7,939,230,709,460,212,847,351,496,249,56
23,246905,GRANGER ISD,13,english,7,44,12,32,25,11,43,16,27,18,7
23,246906,HUTTO ISD,13,english,7,718,160,558,355,162,491,231,260,91,5
23,246907,JARRELL ISD,13,english,7,245,83,162,64,25,177,111,66,12,0
23,246908,LIBERTY HILL IS,13,english,7,586,73,513,377,197,362,125,237,110,5
23,246909,ROUND ROCK ISD,13,english,7,3456,502,2954,2430,1623,1449,607,842,469,75
23,246911,TAYLOR ISD,13,english,7,224,81,143,79,22,221,98,123,49,5
23,246912,THRALL ISD,13,english,7,56,5,51,36,16,38,8,30,23,7
23,246913,LEANDER ISD,13,english,7,3259,381,2878,2252,1367,1613,539,1074,556,52
23,246914,COUPLAND ISD,13,english,7,25,4,21,12,7,25,5,20,8,4
23,247901,FLORESVILLE ISD,20,english,7,312,81,231,151,69,311,95,216,126,34
23,247903,LA VERNIA ISD,20,english,7,264,21,243,175,94,262,50,212,151,55
23,247904,POTH ISD,20,english,7,58,3,55,44,20,58,2,56,47,21
23,247906,STOCKDALE ISD,20,english,7,58,9,49,30,18,59,20,39,21,5
23,248901,KERMIT ISD,18,english,7,99,31,68,42,13,99,38,61,31,3
23,248902,WINK-LOVING ISD,18,english,7,34,11,23,15,7,34,8,26,14,2
23,249901,ALVORD ISD,11,english,7,56,8,48,25,11,56,11,45,31,6
23,249902,BOYD ISD,11,english,7,111,33,78,46,12,111,37,74,27,7
23,249903,BRIDGEPORT ISD,11,english,7,153,29,124,72,35,151,41,110,62,9
23,249904,CHICO ISD,11,english,7,48,9,39,28,8,30,13,17,5,0
23,249905,DECATUR ISD,11,english,7,264,39,225,160,77,184,80,104,62,6
23,249906,PARADISE ISD,11,english,7,75,10,65,42,13,55,19,36,12,0
23,249908,SLIDELL ISD,11,english,7,29,8,21,10,5,30,13,17,8,2
23,250902,HAWKINS ISD,7,english,7,62,12,50,36,17,61,10,51,42,12
23,250903,MINEOLA ISD,7,english,7,105,11,94,64,32,105,25,80,50,16
23,250904,QUITMAN ISD,7,english,7,89,9,80,63,27,88,15,73,58,18
23,250905,YANTIS ISD,7,english,7,30,3,27,20,9,30,6,24,18,2
23,250906,ALBA-GOLDEN ISD,7,english,7,66,4,62,46,19,66,12,54,34,7
23,250907,WINNSBORO ISD,7,english,7,135,21,114,80,33,135,40,95,46,10
23,251901,DENVER CITY ISD,17,english,7,123,40,83,38,12,123,55,68,37,4
23,251902,PLAINS ISD,17,english,7,35,19,16,7,2,35,19,16,8,4
23,252901,GRAHAM ISD,9,english,7,167,37,130,68,31,168,51,117,80,26
23,252902,NEWCASTLE ISD,9,english,7,17,3,14,10,5,17,3,14,9,3
23,252903,OLNEY ISD,9,english,7,52,15,37,26,12,52,13,39,29,13
23,253901,ZAPATA COUNTY I,1,english,7,247,97,150,84,26,246,142,104,49,12
23,254901,CRYSTAL CITY IS,20,english,7,125,46,79,36,8,124,59,65,28,3
23,254902,LA PRYOR ISD,20,english,7,45,10,35,16,4,35,25,10,0,0
23,1902,CAYUGA ISD,7,english,8,61,8,53,42,17,61,7,54,36,12
23,1903,ELKHART ISD,7,english,8,89,7,82,56,32,59,12,47,21,2
23,1904,FRANKSTON ISD,7,english,8,65,8,57,33,11,48,13,35,16,2
23,1906,NECHES ISD,7,english,8,18,2,16,12,4,17,0,17,14,5
23,1907,PALESTINE ISD,7,english,8,259,77,182,105,41,258,58,200,122,41
23,1908,WESTWOOD ISD,7,english,8,110,26,84,49,21,99,12,87,57,20
23,1909,SLOCUM ISD,7,english,8,22,1,21,20,15,22,1,21,18,10
23,2901,ANDREWS ISD,18,english,8,329,52,277,180,68,327,43,284,211,83
23,3801,PINEYWOODS COMM,7,english,8,70,4,66,51,27,70,8,62,44,20
23,3902,HUDSON ISD,7,english,8,226,26,200,153,76,186,25,161,127,65
23,3903,LUFKIN ISD,7,english,8,512,110,402,247,103,438,147,291,106,17
23,3904,HUNTINGTON ISD,7,english,8,116,20,96,64,32,116,17,99,60,27
23,3905,DIBOLL ISD,7,english,8,116,22,94,56,29,88,14,74,51,6
23,3906,ZAVALLA ISD,7,english,8,22,3,19,11,3,22,5,17,5,0
23,3907,CENTRAL ISD,7,english,8,104,26,78,36,10,88,23,65,38,8
23,4901,ARANSAS COUNTY,2,english,8,208,36,172,107,52,253,57,196,145,75
23,5901,ARCHER CITY ISD,9,english,8,30,4,26,21,12,30,8,22,17,12
23,5902,HOLLIDAY ISD,9,english,8,99,6,93,84,60,73,14,59,45,12
23,5904,WINDTHORST ISD,9,english,8,39,2,37,32,16,39,1,38,28,14
23,6902,CLAUDE ISD,16,english,8,26,2,24,15,6,26,5,21,14,6
23,7901,CHARLOTTE ISD,20,english,8,35,8,27,13,1,35,11,24,11,2
23,7902,JOURDANTON ISD,20,english,8,133,26,107,73,37,81,34,47,25,7
23,7904,LYTLE ISD,20,english,8,134,35,99,45,12,119,24,95,46,5
23,7905,PLEASANTON ISD,20,english,8,238,33,205,128,57,171,62,109,43,6
23,7906,POTEET ISD,20,english,8,113,10,103,66,25,119,28,91,36,6
23,8901,BELLVILLE ISD,6,english,8,173,24,149,95,36,136,26,110,68,12
23,8902,SEALY ISD,6,english,8,232,34,198,129,61,243,46,197,125,36
23,8903,BRAZOS ISD,6,english,8,76,8,68,43,14,56,3,53,42,11
23,9901,MULESHOE ISD,17,english,8,105,30,75,42,16,105,39,66,36,8
23,10901,MEDINA ISD,20,english,8,10,1,9,7,2,10,0,10,7,1
23,10902,BANDERA ISD,20,english,8,174,30,144,96,36,144,46,98,46,8
23,11901,BASTROP ISD,13,english,8,992,369,623,336,128,946,396,550,304,105
23,11902,ELGIN ISD,13,english,8,393,112,281,149,59,397,192,205,55,9
23,11904,SMITHVILLE ISD,13,english,8,150,39,111,65,27,139,40,99,54,25
23,11905,MCDADE ISD,13,english,8,38,4,34,18,8,33,12,21,11,5
23,12901,SEYMOUR ISD,9,english,8,47,1,46,35,24,42,3,39,34,19
23,13901,BEEVILLE ISD,2,english,8,245,53,192,105,49,210,87,123,56,17
23,13902,PAWNEE ISD,2,english,8,9,1,8,6,4,8,2,6,6,4
23,13903,PETTUS ISD,2,english,8,28,3,25,17,8,27,2,25,16,5
23,13905,SKIDMORE-TYNAN,2,english,8,53,6,47,28,10,51,16,35,14,6
23,14803,PRIORITY CHARTE,12,english,8,59,8,51,32,16,57,24,33,15,6
23,14804,ORENDA CHARTER,12,english,8,169,14,155,129,76,64,29,35,15,1
23,14901,ACADEMY ISD,12,english,8,145,20,125,93,47,136,25,111,76,38
23,14902,BARTLETT ISD,13,english,8,34,14,20,6,1,30,10,20,6,1
23,14903,BELTON ISD,12,english,8,1015,154,861,601,308,1035,251,784,433,143
23,14905,HOLLAND ISD,12,english,8,39,3,36,25,9,30,4,26,16,6
23,14906,KILLEEN ISD,12,english,8,2998,689,2309,1351,524,2534,869,1665,744,141
23,14907,ROGERS ISD,12,english,8,50,5,45,31,12,49,12,37,19,7
23,14908,SALADO ISD,12,english,8,173,23,150,101,41,87,22,65,24,4
23,14909,TEMPLE ISD,12,english,8,597,135,462,294,145,595,128,467,304,107
23,14910,TROY ISD,12,english,8,127,8,119,96,52,120,14,106,75,31
23,15802,GEORGE GERVIN A,20,english,8,16,3,13,7,2,16,5,11,5,2
23,15806,LEGACY TRADITIO,20,english,8,37,8,29,14,6,37,16,21,6,1
23,15807,SOUTHWEST PREPA,20,english,8,57,15,42,11,4,56,29,27,9,1
23,15808,INSPIRE ACADEMI,20,english,8,55,13,42,23,9,55,32,23,14,6
23,15809,BEXAR COUNTY AC,20,english,8,16,4,12,7,1,15,7,8,2,0
23,15815,HERITAGE ACADEM,20,english,8,81,7,74,52,30,78,13,65,38,14
23,15822,JUBILEE ACADEMI,20,english,8,483,129,354,170,50,283,178,105,22,0
23,15825,LIGHTHOUSE PUBL,20,english,8,26,12,14,5,2,24,15,9,3,0
23,15827,SCHOOL OF SCIEN,20,english,8,282,16,266,205,99,175,33,142,86,32
23,15828,HARMONY PUBLIC,20,english,8,454,66,388,292,143,231,47,184,104,38
23,15830,BROOKS ACADEMIE,20,english,8,238,59,179,101,27,213,107,106,34,4
23,15831,SCHOOL OF SCIEN,20,english,8,298,20,278,226,113,170,18,152,81,14
23,15834,BASIS TEXAS,20,english,8,244,0,244,239,194,244,2,242,225,176
23,15835,GREAT HEARTS TE,20,english,8,690,34,656,557,325,86,40,46,13,1
23,15836,ELEANOR KOLITZ,20,english,8,34,2,32,30,19,37,1,36,26,13
23,15838,COMPASS ROSE PU,20,english,8,147,36,111,65,25,134,67,67,19,1
23,15840,SAN ANTONIO PRE,20,english,8,41,10,31,16,3,5,3,2,1,0
23,15901,ALAMO HEIGHTS I,20,english,8,343,34,309,240,125,373,33,340,259,81
23,15904,HARLANDALE ISD,20,english,8,921,247,674,354,102,971,250,721,360,60
23,15905,EDGEWOOD ISD,20,english,8,578,231,347,136,43,369,204,165,36,4
23,15906,RANDOLPH FIELD,20,english,8,122,13,109,88,39,97,18,79,53,31
23,15907,SAN ANTONIO ISD,20,english,8,2824,984,1840,921,311,2288,1299,989,263,19
23,15908,SOUTH SAN ANTON,20,english,8,576,188,388,200,61,565,229,336,118,17
23,15909,SOMERSET ISD,20,english,8,301,29,272,197,70,0,,,,
23,15910,NORTH EAST ISD,20,english,8,4455,812,3643,2580,1364,4659,885,3774,2493,1080
23,15911,EAST CENTRAL IS,20,english,8,770,215,555,299,89,802,362,440,162,22
23,15912,SOUTHWEST ISD,20,english,8,1100,247,853,470,182,861,337,524,201,32
23,15913,LACKLAND ISD,20,english,8,62,6,56,38,22,57,6,51,32,15
23,15914,FT SAM HOUSTON,20,english,8,112,3,109,91,48,93,6,87,63,28
23,15915,NORTHSIDE ISD,20,english,8,7609,1379,6230,4226,1866,7378,1919,5459,3028,915
23,15916,JUDSON ISD,20,english,8,1718,437,1281,745,258,1698,609,1089,459,103
23,15917,SOUTHSIDE ISD,20,english,8,447,116,331,180,67,11,6,5,2,1
23,16901,JOHNSON CITY IS,13,english,8,52,8,44,34,12,52,4,48,35,13
23,16902,BLANCO ISD,13,english,8,94,12,82,57,26,95,9,86,58,17
23,17901,BORDEN COUNTY I,17,english,8,27,2,25,19,3,27,0,27,22,13
23,18901,CLIFTON ISD,12,english,8,76,6,70,51,26,70,11,59,40,14
23,18902,MERIDIAN ISD,12,english,8,39,6,33,22,13,37,17,20,6,0
23,18903,MORGAN ISD,12,english,8,10,4,6,2,1,10,4,6,1,1
23,18904,VALLEY MILLS IS,12,english,8,48,11,37,19,5,48,13,35,19,3
23,18905,WALNUT SPRINGS,12,english,8,12,4,8,2,1,12,8,4,2,1
23,18906,IREDELL ISD,12,english,8,9,1,8,7,3,9,2,7,4,2
23,18907,KOPPERL ISD,12,english,8,19,4,15,5,0,19,10,9,2,0
23,18908,CRANFILLS GAP I,12,english,8,15,2,13,10,3,15,1,14,12,7
23,19901,DEKALB ISD,8,english,8,63,17,46,22,8,48,8,40,21,3
23,19902,HOOKS ISD,8,english,8,67,4,63,53,29,56,7,49,31,10
23,19903,MAUD ISD,8,english,8,49,5,44,30,5,49,6,43,26,8
23,19905,NEW BOSTON ISD,8,english,8,83,15,68,46,23,60,11,49,34,10
23,19906,REDWATER ISD,8,english,8,88,5,83,67,42,89,3,86,66,31
23,19907,TEXARKANA ISD,8,english,8,547,121,426,276,133,465,153,312,149,42
23,19908,LIBERTY-EYLAU I,8,english,8,140,39,101,45,16,125,71,54,8,1
23,19909,SIMMS ISD,8,english,8,48,7,41,31,18,35,6,29,21,2
23,19911,RED LICK ISD,8,english,8,50,0,50,49,40,54,3,51,41,16
23,19912,PLEASANT GROVE,8,english,8,164,13,151,124,73,92,11,81,50,11
23,19913,HUBBARD ISD,8,english,8,0,,,,,0,,,,
23,19914,LEARY ISD,8,english,8,12,2,10,7,2,12,5,7,3,0
23,20901,ALVIN ISD,4,english,8,2251,288,1963,1397,723,2458,376,2082,1466,773
23,20902,ANGLETON ISD,4,english,8,463,94,369,211,66,456,134,322,176,70
23,20904,DANBURY ISD,4,english,8,58,8,50,40,20,44,8,36,21,4
23,20905,BRAZOSPORT ISD,4,english,8,843,178,665,417,176,883,185,698,469,165
23,20906,SWEENY ISD,4,english,8,155,29,126,76,27,157,27,130,88,27
23,20907,COLUMBIA-BRAZOR,4,english,8,230,54,176,121,58,173,55,118,70,20
23,20908,PEARLAND ISD,4,english,8,1759,129,1630,1341,849,1903,197,1706,1309,686
23,20910,DAMON ISD,4,english,8,9,2,7,5,2,9,3,6,4,1
23,21901,COLLEGE STATION,6,english,8,1101,185,916,650,374,1290,207,1083,799,411
23,21902,BRYAN ISD,6,english,8,1143,330,813,449,204,793,421,372,107,10
23,22004,TERLINGUA CSD,18,english,8,8,4,4,2,1,8,4,4,1,0
23,22901,ALPINE ISD,18,english,8,68,7,61,43,14,69,5,64,38,18
23,22902,MARATHON ISD,18,english,8,8,0,8,6,2,8,1,7,7,5
23,22903,SAN VICENTE ISD,18,english,8,0,,,,,0,,,,
23,23902,SILVERTON ISD,16,english,8,19,0,19,15,9,19,2,17,14,5
23,24901,BROOKS COUNTY I,1,english,8,86,17,69,41,13,84,18,66,41,10
23,25901,BANGS ISD,15,english,8,65,12,53,36,19,51,21,30,8,1
23,25902,BROWNWOOD ISD,15,english,8,234,57,177,118,44,201,61,140,69,8
23,25904,BLANKET ISD,15,english,8,14,2,12,6,4,14,6,8,3,2
23,25905,MAY ISD,15,english,8,15,3,12,7,2,15,6,9,5,1
23,25906,ZEPHYR ISD,15,english,8,21,0,21,14,11,21,0,21,14,4
23,25908,BROOKESMITH ISD,15,english,8,16,8,8,2,1,15,5,10,6,1
23,25909,EARLY ISD,15,english,8,96,6,90,72,30,96,5,91,63,34
23,26901,CALDWELL ISD,6,english,8,146,18,128,94,47,103,26,77,25,4
23,26902,SOMERVILLE ISD,6,english,8,45,14,31,16,3,35,11,24,10,0
23,26903,SNOOK ISD,6,english,8,36,7,29,23,10,21,10,11,6,0
23,27903,BURNET CISD,13,english,8,249,58,191,114,45,204,82,122,52,10
23,27904,MARBLE FALLS IS,13,english,8,277,54,223,138,65,293,56,237,138,58
23,28902,LOCKHART ISD,13,english,8,494,167,327,172,52,539,184,355,215,97
23,28903,LULING ISD,13,english,8,108,18,90,62,26,104,22,82,44,11
23,28906,PRAIRIE LEA ISD,13,english,8,24,8,16,1,0,24,20,4,0,0
23,29901,CALHOUN COUNTY,3,english,8,240,45,195,120,43,251,64,187,110,36
23,30901,CROSS PLAINS IS,14,english,8,33,5,28,17,8,33,9,24,15,7
23,30902,CLYDE CISD,14,english,8,104,12,92,70,38,86,14,72,43,7
23,30903,BAIRD ISD,14,english,8,15,4,11,7,2,15,7,8,5,1
23,30906,EULA ISD,14,english,8,36,4,32,27,20,35,5,30,22,12
23,31901,BROWNSVILLE ISD,1,english,8,2260,464,1796,1146,384,2792,654,2138,1297,389
23,31903,HARLINGEN CISD,1,english,8,1236,155,1081,782,359,685,248,437,188,26
23,31905,LA FERIA ISD,1,english,8,235,60,175,103,28,172,77,95,35,4
23,31906,LOS FRESNOS CIS,1,english,8,797,103,694,466,217,673,146,527,330,92
23,31909,POINT ISABEL IS,1,english,8,144,10,134,105,46,130,48,82,24,9
23,31911,RIO HONDO ISD,1,english,8,115,27,88,63,22,71,35,36,6,2
23,31912,SAN BENITO CISD,1,english,8,734,183,551,296,81,634,191,443,182,19
23,31913,SANTA MARIA ISD,1,english,8,51,14,37,19,7,50,21,29,15,4
23,31914,SANTA ROSA ISD,1,english,8,86,11,75,45,20,69,25,44,16,0
23,31916,SOUTH TEXAS ISD,1,english,8,569,16,553,474,286,391,24,367,309,177
23,32902,PITTSBURG ISD,8,english,8,164,24,140,83,33,137,12,125,95,38
23,33901,GROOM ISD,16,english,8,13,2,11,7,2,13,0,13,8,2
23,33902,PANHANDLE ISD,16,english,8,60,3,57,50,22,60,5,55,30,11
23,33904,WHITE DEER ISD,16,english,8,21,3,18,11,8,21,3,18,12,6
23,34901,ATLANTA ISD,8,english,8,122,21,101,66,36,101,44,57,21,2
23,34902,AVINGER ISD,8,english,8,13,0,13,10,5,13,2,11,8,4
23,34903,HUGHES SPRINGS,8,english,8,87,5,82,65,45,79,12,67,50,20
23,34905,LINDEN-KILDARE,8,english,8,46,6,40,26,11,46,3,43,27,18
23,34906,MCLEOD ISD,8,english,8,34,7,27,19,2,31,6,25,13,3
23,34907,QUEEN CITY ISD,8,english,8,73,19,54,35,18,55,13,42,16,3
23,34909,BLOOMBURG ISD,8,english,8,14,0,14,8,3,14,5,9,3,0
23,35901,DIMMITT ISD,16,english,8,93,28,65,32,10,87,22,65,41,16
23,35902,HART ISD,16,english,8,15,1,14,12,4,15,0,15,10,6
23,35903,NAZARETH ISD,16,english,8,19,0,19,18,11,10,0,10,10,3
23,36901,ANAHUAC ISD,4,english,8,110,26,84,46,21,125,21,104,68,19
23,36902,BARBERS HILL IS,4,english,8,554,33,521,422,238,381,27,354,259,99
23,36903,EAST CHAMBERS I,5,english,8,112,12,100,72,41,84,28,56,17,3
23,37901,ALTO ISD,7,english,8,47,5,42,27,11,42,6,36,27,10
23,37904,JACKSONVILLE IS,7,english,8,361,88,273,174,68,319,112,207,90,11
23,37907,RUSK ISD,7,english,8,172,20,152,108,50,139,19,120,76,19
23,37908,NEW SUMMERFIELD,7,english,8,37,8,29,14,2,37,16,21,5,1
23,37909,WELLS ISD,7,english,8,19,2,17,14,5,19,7,12,6,0
23,38901,CHILDRESS ISD,16,english,8,91,8,83,51,18,92,14,78,61,34
23,39902,HENRIETTA ISD,9,english,8,80,11,69,41,11,70,15,55,24,4
23,39903,PETROLIA CISD,9,english,8,36,2,34,25,14,35,3,32,21,5
23,39904,BELLEVUE ISD,9,english,8,17,2,15,14,5,16,2,14,8,2
23,39905,MIDWAY ISD,9,english,8,9,0,9,5,1,9,0,9,8,3
23,40901,MORTON ISD,17,english,8,28,17,11,0,0,28,16,12,2,0
23,40902,WHITEFACE CISD,17,english,8,31,4,27,14,5,31,6,25,16,8
23,41901,BRONTE ISD,15,english,8,13,2,11,8,4,13,4,9,6,2
23,41902,ROBERT LEE ISD,15,english,8,17,3,14,4,2,17,3,14,9,2
23,42901,COLEMAN ISD,15,english,8,72,11,61,45,21,70,13,57,44,22
23,42903,SANTA ANNA ISD,15,english,8,13,0,13,8,4,13,1,12,8,3
23,42905,PANTHER CREEK C,15,english,8,13,0,13,9,5,10,2,8,3,0
23,43801,IMAGINE INTERNA,10,english,8,126,0,126,123,92,32,0,32,32,21
23,43901,ALLEN ISD,10,english,8,1685,117,1568,1324,904,977,135,842,587,184
23,43902,ANNA ISD,10,english,8,361,50,311,230,96,293,97,196,76,9
23,43903,CELINA ISD,10,english,8,267,14,253,195,100,251,25,226,168,68
23,43904,FARMERSVILLE IS,10,english,8,153,9,144,118,56,84,19,65,25,1
23,43905,FRISCO ISD,10,english,8,5359,213,5146,4583,3235,2932,354,2578,1845,891
23,43907,MCKINNEY ISD,10,english,8,1880,200,1680,1282,698,1176,265,911,510,166
23,43908,MELISSA ISD,10,english,8,424,11,413,331,204,429,18,411,330,165
23,43910,PLANO ISD,10,english,8,3745,482,3263,2621,1682,4033,530,3503,2677,1416
23,43911,PRINCETON ISD,10,english,8,593,111,482,314,143,424,73,351,237,84
23,43912,PROSPER ISD,10,english,8,1884,75,1809,1576,1031,869,193,676,356,99
23,43914,WYLIE ISD,10,english,8,1471,108,1363,1140,724,1035,134,901,661,272
23,43917,BLUE RIDGE ISD,10,english,8,69,8,61,35,15,49,31,18,4,0
23,43918,COMMUNITY ISD,10,english,8,287,72,215,143,59,198,85,113,45,7
23,43919,LOVEJOY ISD,10,english,8,391,6,385,368,274,483,3,480,444,283
23,44902,WELLINGTON ISD,16,english,8,43,8,35,24,14,43,9,34,25,14
23,45902,COLUMBUS ISD,4,english,8,124,27,97,57,22,124,33,91,50,14
23,45903,RICE CISD,3,english,8,80,11,69,50,14,79,28,51,18,6
23,45905,WEIMAR ISD,3,english,8,59,11,48,30,12,50,10,40,28,4
23,46802,TRINITY CHARTER,20,english,8,51,24,27,10,3,51,32,19,3,1
23,46901,NEW BRAUNFELS I,20,english,8,742,79,663,488,233,500,133,367,187,23
23,46902,COMAL ISD,20,english,8,2238,269,1969,1459,742,1459,357,1102,699,219
23,47901,COMANCHE ISD,14,english,8,85,13,72,41,18,85,14,71,40,11
23,47902,DE LEON ISD,14,english,8,52,6,46,34,10,51,3,48,40,15
23,47903,GUSTINE ISD,14,english,8,9,2,7,4,2,9,2,7,5,3
23,47905,SIDNEY ISD,14,english,8,12,1,11,6,1,12,2,10,8,2
23,48901,EDEN CISD,15,english,8,14,4,10,7,3,14,4,10,6,2
23,48903,PAINT ROCK ISD,15,english,8,20,5,15,7,2,20,7,13,5,1
23,49901,GAINESVILLE ISD,11,english,8,138,51,87,35,6,127,27,100,29,4
23,49902,MUENSTER ISD,11,english,8,48,3,45,39,21,48,3,45,34,16
23,49903,VALLEY VIEW ISD,11,english,8,81,19,62,28,5,81,37,44,18,4
23,49905,CALLISBURG ISD,11,english,8,72,10,62,29,12,63,8,55,27,7
23,49906,ERA ISD,11,english,8,48,7,41,25,7,48,1,47,35,14
23,49907,LINDSAY ISD,11,english,8,35,0,35,33,16,13,1,12,10,1
23,49908,WALNUT BEND ISD,11,english,8,0,,,,,0,,,,
23,49909,SIVELLS BEND IS,11,english,8,0,,,,,0,,,,
23,50901,EVANT ISD,12,english,8,12,4,8,7,2,12,5,7,2,0
23,50902,GATESVILLE ISD,12,english,8,194,26,168,115,48,212,40,172,113,27
23,50904,OGLESBY ISD,12,english,8,18,2,16,9,3,18,3,15,8,1
23,50909,JONESBORO ISD,12,english,8,25,11,14,7,3,25,14,11,2,0
23,50910,COPPERAS COVE I,12,english,8,608,105,503,340,147,610,164,446,235,57
23,51901,PADUCAH ISD,17,english,8,19,1,18,9,5,20,7,13,3,2
23,52901,CRANE ISD,15,english,8,83,15,68,42,18,82,25,57,22,5
23,53001,CROCKETT COUNTY,15,english,8,49,5,44,31,12,49,1,48,35,14
23,54901,CROSBYTON CISD,17,english,8,26,3,23,17,4,26,4,22,14,3
23,54902,LORENZO ISD,17,english,8,19,5,14,6,2,19,7,12,6,0
23,54903,RALLS ISD,17,english,8,34,10,24,10,3,34,11,23,12,2
23,55901,CULBERSON COUNT,18,english,8,46,7,39,21,10,0,,,,
23,56901,DALHART ISD,16,english,8,126,27,99,71,31,125,21,104,73,30
23,56902,TEXLINE ISD,16,english,8,12,1,11,9,5,7,0,7,4,1
23,57802,PEGASUS SCHOOL,10,english,8,37,10,27,15,3,37,20,17,3,0
23,57803,UPLIFT EDUCATIO,10,english,8,1903,330,1573,1004,409,1235,472,763,385,158
23,57806,ADVANTAGE ACADE,10,english,8,94,38,56,19,3,94,49,45,18,5
23,57807,LIFE SCHOOL,10,english,8,416,103,313,198,78,316,138,178,54,3
23,57808,UNIVERSAL ACADE,10,english,8,90,7,83,63,36,89,11,78,57,24
23,57810,ACADEMY OF DALL,10,english,8,24,7,17,7,1,25,19,6,4,0
23,57813,TRINITY BASIN P,10,english,8,394,59,335,230,90,370,66,304,178,68
23,57814,ACADEMY FOR ACA,10,english,8,30,20,10,1,0,28,26,2,1,0
23,57816,A W BROWN LEADE,10,english,8,27,9,18,2,0,27,10,17,3,0
23,57819,JEAN MASSIEU AC,10,english,8,10,3,7,4,1,10,1,9,5,1
23,57827,NOVA ACADEMY SO,10,english,8,45,2,43,30,8,45,8,37,18,3
23,57829,A+ ACADEMY,10,english,8,146,44,102,51,15,125,28,97,35,1
23,57830,INSPIRED VISION,10,english,8,111,30,81,41,10,99,27,72,30,2
23,57831,GATEWAY CHARTER,10,english,8,28,6,22,8,2,28,6,22,9,0
23,57835,GOLDEN RULE CHA,10,english,8,93,11,82,64,28,93,14,79,41,15
23,57836,ST ANTHONY SCHO,10,english,8,28,0,28,24,20,28,6,22,21,11
23,57839,LA ACADEMIA DE,10,english,8,92,16,76,43,20,92,20,72,44,21
23,57841,CITYSCAPE SCHOO,10,english,8,64,7,57,28,10,63,13,50,26,10
23,57844,MANARA ACADEMY,10,english,8,40,5,35,20,9,40,10,30,17,11
23,57845,UME PREPARATORY,10,english,8,111,1,110,87,47,117,15,102,61,18
23,57846,LEGACY PREPARAT,10,english,8,138,42,96,44,16,138,67,71,27,6
23,57847,VILLAGE TECH SC,10,english,8,0,,,,,0,,,,
23,57848,INTERNATIONAL L,10,english,8,1483,400,1083,566,172,3234,1475,1759,686,141
23,57850,PIONEER TECHNOL,10,english,8,251,18,233,158,77,235,45,190,98,29
23,57903,CARROLLTON-FARM,10,english,8,1735,404,1331,865,413,1872,461,1411,827,294
23,57904,CEDAR HILL ISD,10,english,8,552,96,456,289,113,483,147,336,153,35
23,57905,DALLAS ISD,10,english,8,9211,2165,7046,4440,2069,12205,3333,8872,4916,1547
23,57906,DESOTO ISD,10,english,8,519,76,443,286,102,527,107,420,250,53
23,57907,DUNCANVILLE ISD,10,english,8,1002,246,756,389,135,1038,335,703,328,90
23,57909,GARLAND ISD,10,english,8,3803,835,2968,1892,900,3881,1017,2864,1604,509
23,57910,GRAND PRAIRIE I,10,english,8,1788,463,1325,756,263,1854,553,1301,694,203
23,57911,HIGHLAND PARK I,10,english,8,513,11,502,468,328,481,13,468,411,211
23,57912,IRVING ISD,10,english,8,2035,656,1379,723,206,2107,712,1395,685,171
23,57913,LANCASTER ISD,10,english,8,486,119,367,196,61,418,155,263,92,11
23,57914,MESQUITE ISD,10,english,8,3126,798,2328,1300,467,3269,719,2550,1560,442
23,57916,RICHARDSON ISD,10,english,8,2708,546,2162,1563,891,3356,1196,2160,1181,465
23,57919,SUNNYVALE ISD,10,english,8,184,10,174,155,106,202,17,185,159,57
23,57922,COPPELL ISD,10,english,8,1101,43,1058,965,703,1056,43,1013,898,629
23,58902,DAWSON ISD,17,english,8,8,1,7,5,1,8,2,6,1,0
23,58905,KLONDIKE ISD,17,english,8,16,0,16,15,9,16,1,15,15,9
23,58906,LAMESA ISD,17,english,8,105,26,79,49,11,106,35,71,38,18
23,58909,SANDS CISD,17,english,8,9,1,8,6,3,9,2,7,4,1
23,59901,HEREFORD ISD,16,english,8,284,56,228,105,27,261,45,216,111,18
23,60902,COOPER ISD,8,english,8,58,6,52,32,14,58,11,47,22,7
23,60914,FANNINDEL ISD,8,english,8,9,2,7,4,1,9,5,4,1,0
23,61802,NORTH TEXAS COL,11,english,8,46,6,40,19,7,46,15,31,17,8
23,61804,LEADERSHIP PREP,10,english,8,101,3,98,85,57,103,22,81,50,20
23,61805,TRIVIUM ACADEMY,11,english,8,40,2,38,28,19,37,2,35,23,8
23,61901,DENTON ISD,11,english,8,2407,398,2009,1397,717,1939,684,1255,602,176
23,61902,LEWISVILLE ISD,11,english,8,3718,513,3205,2494,1470,3846,731,3115,2151,1055
23,61903,PILOT POINT ISD,11,english,8,112,13,99,72,40,95,38,57,19,3
23,61905,KRUM ISD,11,english,8,196,21,175,131,74,151,37,114,67,17
23,61906,PONDER ISD,11,english,8,135,18,117,87,37,105,8,97,79,32
23,61907,AUBREY ISD,11,english,8,254,23,231,151,72,253,47,206,107,16
23,61908,SANGER ISD,11,english,8,196,24,172,124,80,192,49,143,85,23
23,61910,ARGYLE ISD,11,english,8,372,15,357,303,162,367,22,345,281,159
23,61911,NORTHWEST ISD,11,english,8,2229,277,1952,1448,720,2388,453,1935,1267,472
23,61912,LAKE DALLAS ISD,11,english,8,313,43,270,191,93,314,82,232,156,56
23,61914,LITTLE ELM ISD,11,english,8,672,151,521,344,154,735,164,571,344,126
23,62901,CUERO ISD,3,english,8,155,30,125,79,30,130,17,113,83,20
23,62902,NORDHEIM ISD,3,english,8,11,0,11,9,5,11,0,11,6,4
23,62903,YOAKUM ISD,3,english,8,114,19,95,67,21,91,4,87,55,13
23,62904,YORKTOWN ISD,3,english,8,42,4,38,27,15,30,19,11,3,0
23,62905,WESTHOFF ISD,3,english,8,0,,,,,0,,,,
23,62906,MEYERSVILLE ISD,3,english,8,13,0,13,7,4,13,0,13,9,4
23,63903,SPUR ISD,17,english,8,17,3,14,8,2,16,8,8,4,2
23,63906,PATTON SPRINGS,17,english,8,11,4,7,4,2,11,1,10,8,4
23,64903,CARRIZO SPRINGS,20,english,8,137,39,98,53,15,94,12,82,35,3
23,65901,CLARENDON ISD,16,english,8,35,3,32,24,11,34,6,28,17,12
23,65902,HEDLEY ISD,16,english,8,7,0,7,5,4,7,0,7,7,2
23,66901,BENAVIDES ISD,2,english,8,15,6,9,3,1,15,8,7,2,0
23,66902,SAN DIEGO ISD,2,english,8,114,23,91,60,27,113,23,90,51,19
23,66903,FREER ISD,2,english,8,75,16,59,38,14,73,19,54,23,8
23,67902,CISCO ISD,14,english,8,56,4,52,38,22,56,3,53,34,18
23,67903,EASTLAND ISD,14,english,8,92,14,78,44,16,83,25,58,33,2
23,67904,GORMAN ISD,14,english,8,32,12,20,13,3,32,8,24,4,1
23,67907,RANGER ISD,14,english,8,11,6,5,3,2,10,7,3,0,0
23,67908,RISING STAR ISD,14,english,8,16,3,13,7,3,15,6,9,4,1
23,68802,COMPASS ACADEMY,18,english,8,115,11,104,72,33,116,13,103,66,35
23,68901,ECTOR COUNTY IS,18,english,8,2483,621,1862,1104,428,1948,708,1240,502,85
23,69901,ROCKSPRINGS ISD,15,english,8,12,2,10,3,1,12,5,7,1,0
23,69902,NUECES CANYON C,15,english,8,25,4,21,14,4,25,6,19,8,3
23,70801,WAXAHACHIE FAIT,10,english,8,231,102,129,40,8,184,72,112,32,4
23,70901,AVALON ISD,10,english,8,22,5,17,11,4,22,6,16,7,1
23,70903,ENNIS ISD,10,english,8,421,67,354,237,105,349,93,256,132,37
23,70905,FERRIS ISD,10,english,8,202,38,164,103,30,208,62,146,66,11
23,70907,ITALY ISD,10,english,8,38,7,31,20,9,38,11,27,13,1
23,70908,MIDLOTHIAN ISD,10,english,8,883,120,763,544,276,917,146,771,536,196
23,70909,MILFORD ISD,10,english,8,21,7,14,5,0,21,8,13,2,1
23,70910,PALMER ISD,10,english,8,112,15,97,71,38,112,22,90,62,20
23,70911,RED OAK ISD,10,english,8,540,124,416,238,98,590,167,423,197,48
23,70912,WAXAHACHIE ISD,10,english,8,845,135,710,464,212,884,164,720,472,174
23,70915,MAYPEARL ISD,10,english,8,114,17,97,61,23,115,12,103,68,6
23,71801,BURNHAM WOOD CH,19,english,8,137,22,115,74,39,94,40,54,19,2
23,71806,HARMONY PUBLIC,19,english,8,429,34,395,290,154,291,32,259,176,70
23,71809,VISTA DEL FUTUR,19,english,8,10,2,8,8,3,10,0,10,6,3
23,71810,EL PASO LEADERS,19,english,8,129,61,68,32,7,115,55,60,26,5
23,71901,CLINT ISD,19,english,8,802,175,627,404,151,779,257,522,222,36
23,71902,EL PASO ISD,19,english,8,3440,709,2731,1784,766,2395,821,1574,696,127
23,71903,FABENS ISD,19,english,8,141,38,103,56,18,116,41,75,31,6
23,71904,SAN ELIZARIO IS,19,english,8,263,63,200,110,33,212,51,161,65,5
23,71905,YSLETA ISD,19,english,8,2774,440,2334,1555,678,2694,465,2229,1360,385
23,71906,ANTHONY ISD,19,english,8,69,4,65,47,17,61,2,59,40,9
23,71907,CANUTILLO ISD,19,english,8,357,66,291,174,54,509,107,402,250,73
23,71908,TORNILLO ISD,19,english,8,70,24,46,20,8,0,,,,
23,71909,SOCORRO ISD,19,english,8,3665,496,3169,2270,1028,220,100,120,40,6
23,72801,PREMIER HIGH SC,11,english,8,0,,,,,0,,,,
23,72802,ERATH EXCELS AC,11,english,8,9,6,3,1,0,7,6,1,0,0
23,72901,THREE WAY ISD,11,english,8,14,3,11,8,3,12,4,8,2,0
23,72902,DUBLIN ISD,11,english,8,69,5,64,41,23,68,14,54,35,15
23,72903,STEPHENVILLE IS,11,english,8,274,29,245,178,93,196,30,166,80,18
23,72904,BLUFF DALE ISD,11,english,8,13,2,11,7,2,14,2,12,7,0
23,72908,HUCKABAY ISD,11,english,8,22,0,22,18,7,13,0,13,7,0
23,72909,LINGLEVILLE ISD,11,english,8,22,1,21,16,4,22,1,21,13,3
23,72910,MORGAN MILL ISD,11,english,8,10,0,10,5,1,8,0,8,5,0
23,73901,CHILTON ISD,12,english,8,37,3,34,25,11,37,2,35,17,5
23,73903,MARLIN ISD,12,english,8,66,28,38,15,3,65,32,33,15,3
23,73904,WESTPHALIA ISD,12,english,8,16,0,16,13,7,6,0,6,4,1
23,73905,ROSEBUD-LOTT IS,12,english,8,50,7,43,20,6,50,7,43,31,12
23,74903,BONHAM ISD,10,english,8,138,35,103,53,13,134,45,89,39,11
23,74904,DODD CITY ISD,10,english,8,20,0,20,18,15,20,3,17,16,8
23,74905,ECTOR ISD,10,english,8,22,7,15,11,2,22,5,17,9,0
23,74907,HONEY GROVE ISD,8,english,8,45,9,36,26,15,45,10,35,25,9
23,74909,LEONARD ISD,10,english,8,58,5,53,43,26,60,3,57,42,11
23,74911,SAVOY ISD,10,english,8,15,5,10,6,3,8,3,5,2,0
23,74912,TRENTON ISD,10,english,8,38,4,34,23,11,38,13,25,12,6
23,74917,SAM RAYBURN ISD,10,english,8,36,4,32,23,8,31,13,18,4,0
23,75901,FLATONIA ISD,13,english,8,52,1,51,40,30,30,1,29,24,16
23,75902,LA GRANGE ISD,13,english,8,147,20,127,95,55,158,15,143,107,32
23,75903,SCHULENBURG ISD,13,english,8,65,14,51,37,19,42,16,26,11,2
23,75906,FAYETTEVILLE IS,13,english,8,22,0,22,20,10,22,0,22,15,6
23,75908,ROUND TOP-CARMI,13,english,8,18,1,17,16,9,7,1,6,6,2
23,76903,ROBY CISD,14,english,8,26,3,23,10,1,26,6,20,8,2
23,76904,ROTAN ISD,14,english,8,19,2,17,10,4,18,1,17,13,6
23,77901,FLOYDADA COLLEG,17,english,8,49,17,32,15,6,49,11,38,25,10
23,77902,LOCKNEY ISD,17,english,8,34,11,23,12,5,34,7,27,13,3
23,78901,CROWELL ISD,9,english,8,14,2,12,6,0,14,2,12,6,2
23,79901,LAMAR CISD,4,english,8,3217,478,2739,2006,1109,3450,723,2727,1803,811
23,79906,NEEDVILLE ISD,4,english,8,283,19,264,197,102,220,40,180,104,22
23,79907,FORT BEND ISD,4,english,8,6251,882,5369,3893,2144,4173,1164,3009,1546,460
23,79910,STAFFORD MSD,4,english,8,287,63,224,116,44,153,57,96,28,3
23,80901,MOUNT VERNON IS,8,english,8,112,14,98,65,29,84,26,58,18,0
23,81902,FAIRFIELD ISD,12,english,8,135,28,107,72,32,108,24,84,49,8
23,81904,TEAGUE ISD,12,english,8,96,18,78,62,22,95,27,68,24,2
23,81905,WORTHAM ISD,12,english,8,42,8,34,15,6,42,9,33,17,5
23,81906,DEW ISD,12,english,8,8,1,7,6,2,8,1,7,6,3
23,82902,DILLEY ISD,20,english,8,67,20,47,20,3,48,20,28,10,1
23,82903,PEARSALL ISD,20,english,8,147,48,99,52,18,147,67,80,29,11
23,83901,SEAGRAVES ISD,17,english,8,43,12,31,11,0,44,9,35,18,4
23,83902,LOOP ISD,17,english,8,11,1,10,10,3,11,1,10,7,2
23,83903,SEMINOLE ISD,17,english,8,226,39,187,134,57,228,37,191,118,58
23,84802,ODYSSEY ACADEMY,4,english,8,103,18,85,39,15,74,35,39,6,2
23,84804,AMBASSADORS PRE,4,english,8,10,0,10,8,3,10,1,9,5,2
23,84901,DICKINSON ISD,4,english,8,953,140,813,540,209,984,208,776,414,129
23,84902,GALVESTON ISD,4,english,8,472,137,335,211,104,415,161,254,112,30
23,84903,HIGH ISLAND ISD,5,english,8,11,1,10,4,2,9,2,7,3,1
23,84906,TEXAS CITY ISD,4,english,8,604,181,423,204,75,599,235,364,159,53
23,84908,HITCHCOCK ISD,4,english,8,139,37,102,62,20,112,46,66,24,3
23,84909,SANTA FE ISD,4,english,8,329,64,265,182,66,225,92,133,54,8
23,84910,CLEAR CREEK ISD,4,english,8,3195,365,2830,2090,1124,2174,426,1748,1029,262
23,84911,FRIENDSWOOD ISD,4,english,8,476,34,442,363,207,499,22,477,395,188
23,85902,POST ISD,17,english,8,72,24,48,20,6,71,30,41,18,4
23,85903,SOUTHLAND ISD,17,english,8,12,3,9,4,2,12,3,9,5,1
23,86901,FREDERICKSBURG,13,english,8,244,41,203,140,60,251,56,195,125,45
23,86902,HARPER ISD,15,english,8,41,2,39,35,21,40,3,37,29,10
23,87901,GLASSCOCK COUNT,18,english,8,26,0,26,21,12,26,0,26,21,13
23,88902,GOLIAD ISD,3,english,8,104,15,89,63,34,86,16,70,47,8
23,89901,GONZALES ISD,13,english,8,179,41,138,77,30,148,57,91,37,3
23,89903,NIXON-SMILEY CI,13,english,8,87,13,74,47,27,85,20,65,35,6
23,89905,WAELDER ISD,13,english,8,18,4,14,7,0,10,3,7,0,0
23,90902,LEFORS ISD,16,english,8,12,4,8,4,1,11,6,5,1,0
23,90903,MCLEAN ISD,16,english,8,19,0,19,16,6,19,1,18,12,6
23,90904,PAMPA ISD,16,english,8,263,74,189,121,54,262,118,144,71,26
23,91901,BELLS ISD,10,english,8,72,3,69,51,22,69,6,63,48,23
23,91902,COLLINSVILLE IS,10,english,8,41,9,32,17,2,44,9,35,13,3
23,91903,DENISON ISD,10,english,8,360,79,281,176,83,303,109,194,80,12
23,91905,HOWE ISD,10,english,8,108,14,94,81,41,89,17,72,45,13
23,91906,SHERMAN ISD,10,english,8,555,135,420,255,109,552,179,373,188,41
23,91907,TIOGA ISD,10,english,8,50,2,48,34,20,52,6,46,31,9
23,91908,VAN ALSTYNE ISD,10,english,8,187,10,177,144,71,144,17,127,96,30
23,91909,WHITESBORO ISD,10,english,8,151,22,129,93,54,122,31,91,51,13
23,91910,WHITEWRIGHT ISD,10,english,8,70,6,64,48,21,52,8,44,24,6
23,91913,POTTSBORO ISD,10,english,8,121,9,112,87,43,110,17,93,56,10
23,91914,S AND S CISD,10,english,8,80,15,65,41,16,70,14,56,36,9
23,91917,GUNTER ISD,10,english,8,91,9,82,62,42,61,23,38,13,3
23,91918,TOM BEAN ISD,10,english,8,35,6,29,18,6,43,7,36,26,17
23,92901,GLADEWATER ISD,7,english,8,115,8,107,68,31,116,23,93,63,14
23,92902,KILGORE ISD,7,english,8,298,60,238,149,82,279,78,201,116,43
23,92903,LONGVIEW ISD,7,english,8,602,59,543,371,177,401,97,304,171,57
23,92904,PINE TREE ISD,7,english,8,335,56,279,202,98,340,73,267,169,48
23,92906,SABINE ISD,7,english,8,105,12,93,71,30,75,15,60,36,9
23,92907,SPRING HILL ISD,7,english,8,162,13,149,115,68,165,13,152,108,44
23,92908,WHITE OAK ISD,7,english,8,104,10,94,75,28,97,10,87,69,24
23,93901,ANDERSON-SHIRO,6,english,8,65,3,62,50,24,63,2,61,48,18
23,93903,IOLA ISD,6,english,8,51,4,47,33,18,43,8,35,15,1
23,93904,NAVASOTA ISD,6,english,8,239,56,183,110,31,254,73,181,94,15
23,93905,RICHARDS ISD,6,english,8,22,3,19,10,3,16,6,10,0,0
23,94901,SEGUIN ISD,20,english,8,555,120,435,255,93,487,218,269,108,30
23,94902,SCHERTZ-CIBOLO-,20,english,8,1275,189,1086,704,255,1198,146,1052,744,289
23,94903,NAVARRO ISD,20,english,8,177,27,150,102,40,131,31,100,56,11
23,94904,MARION ISD,20,english,8,136,26,110,56,15,91,17,74,33,2
23,95901,ABERNATHY ISD,17,english,8,58,6,52,33,17,48,10,38,25,4
23,95902,COTTON CENTER I,17,english,8,5,1,4,3,1,5,3,2,1,1
23,95903,HALE CENTER ISD,17,english,8,43,9,34,11,3,43,7,36,18,5
23,95904,PETERSBURG ISD,17,english,8,28,1,27,12,4,23,2,21,11,3
23,95905,PLAINVIEW ISD,17,english,8,368,94,274,129,35,279,130,149,31,3
23,96904,MEMPHIS ISD,16,english,8,34,2,32,26,8,32,3,29,23,11
23,96905,TURKEY-QUITAQUE,16,english,8,13,0,13,10,4,13,1,12,7,2
23,97902,HAMILTON ISD,12,english,8,73,8,65,46,26,67,12,55,32,13
23,97903,HICO ISD,12,english,8,57,6,51,38,19,44,12,32,11,0
23,98901,GRUVER ISD,16,english,8,29,0,29,27,20,19,0,19,17,13
23,98903,PRINGLE-MORSE C,16,english,8,9,0,9,7,2,8,0,8,7,4
23,98904,SPEARMAN ISD,16,english,8,51,3,48,36,17,41,1,40,30,10
23,99902,CHILLICOTHE ISD,9,english,8,15,3,12,7,3,15,5,10,5,2
23,99903,QUANAH ISD,9,english,8,30,4,26,15,4,25,5,20,9,0
23,100903,KOUNTZE ISD,5,english,8,95,20,75,45,18,84,17,67,35,5
23,100904,SILSBEE ISD,5,english,8,197,34,163,90,25,145,62,83,16,1
23,100905,HARDIN-JEFFERSO,5,english,8,211,26,185,131,67,217,14,203,157,64
23,100907,LUMBERTON ISD,5,english,8,334,35,299,214,108,262,38,224,128,28
23,100908,WEST HARDIN COU,5,english,8,41,4,37,24,10,40,20,20,6,1
23,101802,SER-NINOS CHART,4,english,8,79,10,69,40,12,52,5,47,21,1
23,101803,ARISTOI CLASSIC,4,english,8,82,3,79,62,28,50,11,39,15,2
23,101804,GEORGE I SANCHE,4,english,8,131,66,65,23,5,112,69,43,7,1
23,101806,RAUL YZAGUIRRE,4,english,8,142,30,112,66,17,93,27,66,27,3
23,101810,ACADEMY OF ACCE,4,english,8,47,6,41,22,11,37,13,24,8,3
23,101811,EXCEL ACADEMY,4,english,8,25,16,9,1,1,26,23,3,1,0
23,101814,THE VARNETT PUB,4,english,8,84,15,69,41,17,84,15,69,45,18
23,101815,ALIEF MONTESSOR,4,english,8,16,1,15,11,4,0,,,,
23,101819,AMIGOS POR VIDA,4,english,8,32,0,32,26,11,28,1,27,22,12
23,101828,HOUSTON GATEWAY,4,english,8,149,6,143,131,89,107,4,103,89,51
23,101837,CALVIN NELMS CH,4,english,8,54,1,53,44,27,33,2,31,19,7
23,101838,SOUTHWEST SCHOO,4,english,8,81,29,52,24,7,63,31,32,9,0
23,101842,COMQUEST ACADEM,4,english,8,8,2,6,3,1,8,3,5,3,1
23,101845,YES PREP PUBLIC,4,english,8,2243,305,1938,1361,544,1529,485,1044,429,87
23,101846,HARMONY PUBLIC,4,english,8,337,30,307,229,127,254,33,221,146,54
23,101847,BEATRICE MAYES,4,english,8,41,4,37,24,13,41,5,36,23,9
23,101853,BAKERRIPLEY COM,4,english,8,49,15,34,21,6,32,18,14,2,0
23,101856,DRAW ACADEMY,4,english,8,55,8,47,30,14,55,17,38,20,7
23,101858,HARMONY PUBLIC,4,english,8,528,50,478,350,186,373,44,329,231,99
23,101859,STEP CHARTER SC,4,english,8,36,6,30,20,8,0,,,,
23,101861,THE RHODES SCHO,4,english,8,31,2,29,23,7,31,2,29,19,5
23,101862,HARMONY PUBLIC,4,english,8,448,22,426,365,229,314,33,281,210,98
23,101864,THE LAWSON ACAD,4,english,8,40,8,32,20,7,40,9,31,16,3
23,101868,THE PRO-VISION,4,english,8,41,16,25,8,1,41,25,16,5,1
23,101870,BETA ACADEMY,4,english,8,84,0,84,77,49,84,7,77,63,19
23,101871,A+ UNLIMITED PO,4,english,8,50,3,47,28,13,30,11,19,3,0
23,101872,ETOILE ACADEMY,4,english,8,98,29,69,39,14,100,33,67,35,8
23,101873,YELLOWSTONE COL,4,english,8,48,13,35,12,2,49,23,26,11,1
23,101874,LEGACY SCHOOL O,4,english,8,54,17,37,17,2,57,36,21,5,2
23,101902,ALDINE ISD,4,english,8,4579,1555,3024,1430,430,4444,2048,2396,942,215
23,101903,ALIEF ISD,4,english,8,2939,893,2046,1269,503,2592,862,1730,836,241
23,101905,CHANNELVIEW ISD,4,english,8,740,156,584,331,109,538,155,383,167,14
23,101906,CROSBY ISD,4,english,8,537,116,421,281,110,392,99,293,152,21
23,101907,CYPRESS-FAIRBAN,4,english,8,9154,1235,7919,5826,3188,5321,1557,3764,1931,453
23,101908,DEER PARK ISD,4,english,8,1004,105,899,660,291,1040,81,959,763,377
23,101910,GALENA PARK ISD,4,english,8,1670,297,1373,898,383,1738,361,1377,912,352
23,101911,GOOSE CREEK CIS,4,english,8,1894,447,1447,855,326,1588,387,1201,748,249
23,101912,HOUSTON ISD,4,english,8,12921,3428,9493,6041,2875,10258,4116,6142,2889,879
23,101913,HUMBLE ISD,4,english,8,3952,726,3226,2042,961,4027,967,3060,1646,523
23,101914,KATY ISD,4,english,8,7545,672,6873,5560,3497,8173,802,7371,5906,3423
23,101915,KLEIN ISD,4,english,8,4274,651,3623,2625,1345,3041,794,2247,1169,416
23,101916,LA PORTE ISD,4,english,8,560,97,463,300,122,624,121,503,260,66
23,101917,PASADENA ISD,4,english,8,3811,913,2898,1727,630,3937,1111,2826,1581,496
23,101919,SPRING ISD,4,english,8,2429,549,1880,1146,495,2215,794,1421,696,162
23,101920,SPRING BRANCH I,4,english,8,2507,507,2000,1469,847,2572,480,2092,1533,770
23,101921,TOMBALL ISD,4,english,8,1703,106,1597,1311,787,1219,130,1089,836,344
23,101924,SHELDON ISD,4,english,8,875,254,621,292,77,719,316,403,125,10
23,101925,HUFFMAN ISD,4,english,8,298,78,220,127,48,306,71,235,153,58
23,102901,KARNACK ISD,7,english,8,9,1,8,4,0,9,2,7,3,1
23,102902,MARSHALL ISD,7,english,8,379,71,308,213,101,312,63,249,147,31
23,102903,WASKOM ISD,7,english,8,63,13,50,28,5,52,16,36,11,0
23,102904,HALLSVILLE ISD,7,english,8,2566,714,1852,884,297,2528,1391,1137,384,106
23,102905,HARLETON ISD,7,english,8,54,1,53,37,17,54,1,53,39,8
23,102906,ELYSIAN FIELDS,7,english,8,56,2,54,45,24,40,0,40,31,11
23,103901,CHANNING ISD,16,english,8,20,4,16,9,4,20,7,13,10,6
23,103902,HARTLEY ISD,16,english,8,18,2,16,11,5,18,0,18,17,11
23,104901,HASKELL CISD,14,english,8,49,4,45,31,14,40,9,31,16,4
23,104903,RULE ISD,14,english,8,10,1,9,5,3,11,4,7,5,2
23,104907,PAINT CREEK ISD,14,english,8,7,0,7,6,1,7,0,7,5,3
23,105801,KATHERINE ANNE,13,english,8,11,0,11,8,3,11,3,8,0,0
23,105803,KI CHARTER ACAD,13,english,8,27,7,20,6,2,21,16,5,2,0
23,105902,SAN MARCOS CISD,13,english,8,566,165,401,233,92,678,295,383,140,43
23,105904,DRIPPING SPRING,13,english,8,640,20,620,523,306,660,34,626,523,251
23,105905,WIMBERLEY ISD,13,english,8,225,12,213,164,97,210,19,191,143,71
23,105906,HAYS CISD,13,english,8,1699,264,1435,1006,477,1714,376,1338,875,315
23,106901,CANADIAN ISD,16,english,8,63,6,57,45,22,44,6,38,19,3
23,107901,ATHENS ISD,10,english,8,221,43,178,110,43,221,40,181,111,44
23,107902,BROWNSBORO ISD,7,english,8,204,21,183,122,53,178,22,156,117,42
23,107904,CROSS ROADS ISD,7,english,8,39,1,38,32,10,39,4,35,30,13
23,107905,EUSTACE ISD,7,english,8,115,7,108,84,47,81,5,76,53,11
23,107906,MALAKOFF ISD,7,english,8,95,6,89,66,27,95,7,88,52,12
23,107907,TRINIDAD ISD,7,english,8,11,1,10,8,6,11,2,9,7,5
23,107908,MURCHISON ISD,7,english,8,19,3,16,11,4,19,4,15,5,1
23,107910,LAPOYNOR ISD,7,english,8,36,2,34,30,13,36,8,28,16,6
23,108802,HORIZON MONTESS,1,english,8,38,2,36,24,7,37,8,29,19,6
23,108807,IDEA PUBLIC SCH,1,english,8,5858,730,5128,3625,1618,54,27,27,23,14
23,108808,VANGUARD ACADEM,1,english,8,351,18,333,249,126,262,51,211,102,9
23,108809,EXCELLENCE IN L,1,english,8,23,9,14,8,3,17,3,14,5,0
23,108902,DONNA ISD,1,english,8,1041,260,781,493,177,920,219,701,393,73
23,108903,EDCOUCH-ELSA IS,1,english,8,319,103,216,100,37,302,117,185,77,17
23,108904,EDINBURG CISD,1,english,8,1938,404,1534,965,266,2036,574,1462,745,130
23,108905,HIDALGO ISD,1,english,8,211,59,152,105,46,136,72,64,19,0
23,108906,MCALLEN ISD,1,english,8,1544,207,1337,972,526,1428,272,1156,777,350
23,108907,MERCEDES ISD,1,english,8,283,95,188,71,11,278,110,168,61,7
23,108908,MISSION CISD,1,english,8,973,184,789,518,211,926,304,622,325,69
23,108909,PHARR-SAN JUAN-,1,english,8,2160,434,1726,1101,458,1955,479,1476,881,328
23,108910,PROGRESO ISD,1,english,8,114,27,87,45,14,99,37,62,21,2
23,108911,SHARYLAND ISD,1,english,8,805,113,692,505,266,785,75,710,544,281
23,108912,LA JOYA ISD,1,english,8,1883,411,1472,905,329,1848,312,1536,1004,387
23,108913,WESLACO ISD,1,english,8,1026,213,813,471,146,1011,227,784,441,144
23,108914,LA VILLA ISD,1,english,8,55,16,39,20,6,56,27,29,9,2
23,108915,MONTE ALTO ISD,1,english,8,73,11,62,42,20,72,21,51,28,12
23,108916,VALLEY VIEW ISD,1,english,8,210,50,160,77,19,274,53,221,126,23
23,109901,ABBOTT ISD,12,english,8,20,1,19,14,6,20,1,19,16,8
23,109902,BYNUM ISD,12,english,8,12,1,11,8,3,11,1,10,8,3
23,109903,COVINGTON ISD,12,english,8,23,8,15,9,4,21,9,12,2,0
23,109904,HILLSBORO ISD,12,english,8,137,7,130,89,40,118,14,104,59,21
23,109905,HUBBARD ISD,12,english,8,32,3,29,24,10,23,4,19,12,0
23,109907,ITASCA ISD,12,english,8,55,15,40,16,2,55,14,41,19,5
23,109908,MALONE ISD,12,english,8,13,2,11,8,4,11,5,6,3,0
23,109910,MOUNT CALM ISD,12,english,8,9,3,6,3,0,6,0,6,3,1
23,109911,WHITNEY ISD,12,english,8,115,12,103,77,33,115,19,96,65,25
23,109912,AQUILLA ISD,12,english,8,21,2,19,9,3,21,6,15,8,3
23,109913,BLUM ISD,12,english,8,17,0,17,9,5,16,2,14,8,2
23,109914,PENELOPE ISD,12,english,8,11,2,9,8,1,11,2,9,6,3
23,110901,ANTON ISD,17,english,8,9,2,7,5,2,9,3,6,3,0
23,110902,LEVELLAND ISD,17,english,8,201,37,164,103,30,181,47,134,61,2
23,110905,ROPES ISD,17,english,8,40,4,36,26,9,24,3,21,10,3
23,110906,SMYER ISD,17,english,8,28,3,25,19,8,15,3,12,8,0
23,110907,SUNDOWN ISD,17,english,8,54,2,52,40,20,54,4,50,42,15
23,110908,WHITHARRAL ISD,17,english,8,18,0,18,11,5,18,1,17,10,4
23,111801,LAKE GRANBURY A,11,english,8,0,,,,,0,,,,
23,111901,GRANBURY ISD,11,english,8,595,70,525,401,205,452,99,353,197,40
23,111902,LIPAN ISD,11,english,8,41,4,37,26,10,41,8,33,24,9
23,111903,TOLAR ISD,11,english,8,68,4,64,48,26,70,5,65,44,20
23,112901,SULPHUR SPRINGS,8,english,8,326,43,283,209,98,322,29,293,236,135
23,112905,CUMBY COLLEGIAT,8,english,8,35,7,28,12,6,18,12,6,1,0
23,112906,NORTH HOPKINS I,8,english,8,43,7,36,27,14,43,8,35,22,11
23,112907,MILLER GROVE IS,8,english,8,22,1,21,14,10,13,3,10,5,0
23,112908,COMO-PICKTON CI,8,english,8,63,15,48,28,9,62,14,48,18,5
23,112909,SALTILLO ISD,8,english,8,16,0,16,12,5,16,1,15,8,5
23,112910,SULPHUR BLUFF I,8,english,8,22,3,19,14,7,22,4,18,10,4
23,113901,CROCKETT ISD,6,english,8,95,32,63,31,8,86,35,51,12,0
23,113902,GRAPELAND ISD,6,english,8,50,8,42,22,7,36,14,22,4,0
23,113903,LOVELADY ISD,6,english,8,44,0,44,38,20,37,3,34,17,3
23,113905,LATEXO ISD,6,english,8,40,2,38,24,8,41,8,33,22,9
23,113906,KENNARD ISD,6,english,8,19,0,19,9,0,14,3,11,4,1
23,114901,BIG SPRING ISD,18,english,8,239,59,180,84,32,236,82,154,68,17
23,114902,COAHOMA ISD,18,english,8,86,14,72,53,19,86,15,71,39,10
23,114904,FORSAN ISD,18,english,8,61,3,58,47,24,60,5,55,36,13
23,115901,FT HANCOCK ISD,19,english,8,31,7,24,18,6,21,9,12,3,0
23,115902,SIERRA BLANCA I,19,english,8,5,0,5,2,0,5,0,5,3,0
23,115903,DELL CITY ISD,19,english,8,5,1,4,2,2,0,,,,
23,116901,CADDO MILLS ISD,10,english,8,204,24,180,135,69,160,32,128,69,15
23,116902,CELESTE ISD,10,english,8,31,1,30,25,12,31,2,29,28,21
23,116903,COMMERCE ISD,10,english,8,106,30,76,41,16,117,39,78,44,19
23,116905,GREENVILLE ISD,10,english,8,379,135,244,110,42,373,159,214,85,12
23,116906,LONE OAK ISD,10,english,8,91,16,75,57,26,92,23,69,39,12
23,116908,QUINLAN ISD,10,english,8,220,46,174,104,38,211,55,156,85,26
23,116909,WOLFE CITY ISD,10,english,8,57,3,54,47,21,57,4,53,38,19
23,116910,CAMPBELL ISD,10,english,8,18,7,11,6,2,18,6,12,6,2
23,116915,BLAND ISD,10,english,8,77,8,69,48,21,77,8,69,55,27
23,116916,BOLES ISD,10,english,8,50,10,40,19,7,48,11,37,19,5
23,117901,BORGER ISD,16,english,8,184,30,154,106,52,113,32,81,41,4
23,117903,SANFORD-FRITCH,16,english,8,64,12,52,35,22,66,16,50,26,8
23,117904,PLEMONS-STINNET,16,english,8,36,2,34,24,11,34,6,28,20,9
23,117907,SPRING CREEK IS,16,english,8,9,1,8,5,0,9,2,7,0,0
23,118902,IRION COUNTY IS,15,english,8,20,1,19,16,7,19,2,17,12,5
23,119901,BRYSON ISD,9,english,8,18,3,15,13,8,19,0,19,12,7
23,119902,JACKSBORO ISD,9,english,8,88,18,70,44,15,66,22,44,20,1
23,119903,PERRIN-WHITT CI,9,english,8,24,3,21,16,8,23,3,20,14,6
23,120901,EDNA ISD,3,english,8,107,9,98,78,32,108,21,87,50,25
23,120902,GANADO ISD,3,english,8,62,5,57,34,15,43,10,33,15,2
23,120905,INDUSTRIAL ISD,3,english,8,77,3,74,66,39,56,4,52,38,15
23,121902,BROOKELAND ISD,5,english,8,37,3,34,29,16,11,1,10,7,1
23,121903,BUNA ISD,5,english,8,113,15,98,70,23,87,17,70,38,3
23,121904,JASPER ISD,5,english,8,160,53,107,50,13,139,47,92,46,4
23,121905,KIRBYVILLE CISD,5,english,8,118,26,92,60,26,96,15,81,53,10
23,121906,EVADALE ISD,5,english,8,20,1,19,17,12,19,1,18,11,3
23,122901,FT DAVIS ISD,18,english,8,13,1,12,7,2,13,3,10,7,2
23,122902,VALENTINE ISD,18,english,8,0,,,,,0,,,,
23,123803,TEKOA ACADEMY O,5,english,8,16,3,13,5,1,16,2,14,14,1
23,123805,EHRHART SCHOOL,5,english,8,58,7,51,29,9,58,9,49,23,5
23,123807,BOB HOPE SCHOOL,5,english,8,187,22,165,108,48,0,,,,
23,123905,NEDERLAND ISD,5,english,8,364,25,339,266,143,285,47,238,164,52
23,123907,PORT ARTHUR ISD,5,english,8,508,172,336,169,53,442,218,224,89,11
23,123908,PORT NECHES-GRO,5,english,8,414,76,338,219,90,415,78,337,209,76
23,123910,BEAUMONT ISD,5,english,8,1208,411,797,424,155,1235,584,651,295,103
23,123913,SABINE PASS ISD,5,english,8,43,3,40,39,21,42,8,34,29,12
23,123914,HAMSHIRE-FANNET,5,english,8,159,17,142,100,56,166,41,125,64,11
23,124901,JIM HOGG COUNTY,1,english,8,92,29,63,37,14,92,16,76,46,16
23,125901,ALICE ISD,2,english,8,354,113,241,129,41,314,128,186,65,3
23,125902,BEN BOLT-PALITO,2,english,8,32,2,30,16,10,32,11,21,7,2
23,125903,ORANGE GROVE IS,2,english,8,123,5,118,98,55,123,25,98,67,25
23,125905,PREMONT ISD,2,english,8,41,8,33,21,3,41,10,31,12,3
23,126901,ALVARADO ISD,11,english,8,303,46,257,137,48,305,117,188,81,22
23,126902,BURLESON ISD,11,english,8,1053,167,886,556,236,769,202,567,294,83
23,126903,CLEBURNE ISD,11,english,8,529,143,386,199,88,536,194,342,157,52
23,126904,GRANDVIEW ISD,11,english,8,97,7,90,62,24,81,9,72,53,18
23,126905,JOSHUA ISD,11,english,8,455,59,396,297,113,264,75,189,68,9
23,126906,KEENE ISD,11,english,8,84,9,75,50,17,83,8,75,46,12
23,126907,RIO VISTA ISD,11,english,8,72,7,65,49,19,71,18,53,33,8
23,126908,VENUS ISD,11,english,8,169,36,133,65,19,176,57,119,43,11
23,126911,GODLEY ISD,11,english,8,207,33,174,118,51,185,58,127,50,4
23,127901,ANSON ISD,14,english,8,58,8,50,32,13,57,12,45,24,7
23,127903,HAMLIN COLLEGIA,14,english,8,29,3,26,13,7,29,12,17,8,1
23,127904,HAWLEY ISD,14,english,8,60,6,54,33,15,59,8,51,33,3
23,127905,LUEDERS-AVOCA I,14,english,8,7,3,4,1,0,7,6,1,1,0
23,127906,STAMFORD ISD,14,english,8,46,13,33,15,1,47,8,39,23,12
23,128901,KARNES CITY ISD,20,english,8,293,69,224,120,41,270,130,140,41,4
23,128902,KENEDY ISD,3,english,8,53,10,43,24,7,50,13,37,18,3
23,128903,RUNGE ISD,3,english,8,16,12,4,2,0,16,12,4,2,0
23,128904,FALLS CITY ISD,20,english,8,31,0,31,24,11,31,3,28,25,15
23,129901,CRANDALL ISD,10,english,8,489,104,385,232,92,530,158,372,172,43
23,129902,FORNEY ISD,10,english,8,1291,205,1086,790,378,1283,307,976,596,241
23,129903,KAUFMAN ISD,10,english,8,366,68,298,202,81,298,102,196,94,12
23,129904,KEMP ISD,10,english,8,143,51,92,40,7,119,63,56,13,0
23,129905,MABANK ISD,10,english,8,282,28,254,184,89,274,32,242,183,90
23,129906,TERRELL ISD,10,english,8,364,116,248,129,45,299,107,192,56,3
23,129910,SCURRY-ROSSER I,10,english,8,81,3,78,57,29,61,4,57,33,4
23,130801,MEADOWLAND CHAR,20,english,8,9,2,7,5,1,7,3,4,2,1
23,130901,BOERNE ISD,20,english,8,901,54,847,710,425,566,62,504,366,117
23,130902,COMFORT ISD,13,english,8,88,6,82,64,28,54,20,34,11,1
23,132902,JAYTON-GIRARD I,17,english,8,11,0,11,10,6,11,1,10,6,3
23,133901,CENTER POINT IS,20,english,8,23,2,21,12,2,18,5,13,4,0
23,133902,HUNT ISD,20,english,8,22,1,21,16,6,12,4,8,4,0
23,133903,KERRVILLE ISD,20,english,8,359,55,304,198,109,219,65,154,81,16
23,133904,INGRAM ISD,20,english,8,84,10,74,50,25,54,4,50,28,3
23,134901,JUNCTION ISD,15,english,8,50,12,38,24,13,50,17,33,20,4
23,135001,GUTHRIE CSD,17,english,8,8,0,8,7,3,8,0,8,5,1
23,136901,BRACKETT ISD,20,english,8,42,6,36,20,10,45,6,39,17,1
23,137901,KINGSVILLE ISD,2,english,8,190,89,101,47,16,147,84,63,20,3
23,137902,RICARDO ISD,2,english,8,68,6,62,49,26,52,2,50,46,31
23,137903,RIVIERA ISD,2,english,8,43,1,42,36,21,44,9,35,15,3
23,137904,SANTA GERTRUDIS,2,english,8,54,1,53,45,31,39,3,36,27,6
23,138902,KNOX CITY-O'BRI,9,english,8,19,1,18,12,6,19,5,14,9,4
23,138903,MUNDAY CISD,9,english,8,24,2,22,11,3,24,5,19,11,1
23,138904,BENJAMIN ISD,9,english,8,14,1,13,7,3,14,4,10,8,3
23,139905,CHISUM ISD,8,english,8,82,10,72,52,34,51,7,44,22,4
23,139909,PARIS ISD,8,english,8,268,47,221,138,58,246,58,188,103,20
23,139911,NORTH LAMAR ISD,8,english,8,157,21,136,90,36,133,41,92,52,22
23,139912,PRAIRILAND ISD,8,english,8,71,3,68,58,35,70,7,63,39,14
23,140901,AMHERST ISD,17,english,8,8,0,8,4,1,8,4,4,0,0
23,140904,LITTLEFIELD ISD,17,english,8,82,23,59,34,9,82,19,63,37,8
23,140905,OLTON ISD,17,english,8,58,7,51,30,8,58,15,43,16,4
23,140907,SPRINGLAKE-EART,17,english,8,26,7,19,9,2,26,5,21,10,3
23,140908,SUDAN ISD,17,english,8,35,1,34,26,13,35,6,29,19,3
23,141901,LAMPASAS ISD,12,english,8,264,35,229,149,74,265,43,222,151,42
23,141902,LOMETA ISD,12,english,8,17,3,14,7,2,17,4,13,6,1
23,142901,COTULLA ISD,20,english,8,94,15,79,51,28,63,14,49,25,6
23,143901,HALLETTSVILLE I,3,english,8,87,14,73,42,18,62,12,50,23,8
23,143902,MOULTON ISD,3,english,8,21,1,20,19,10,10,1,9,8,1
23,143903,SHINER ISD,3,english,8,41,1,40,33,17,41,0,41,32,14
23,143904,VYSEHRAD ISD,3,english,8,12,0,12,8,2,10,0,10,7,0
23,143905,SWEET HOME ISD,3,english,8,13,1,12,10,7,0,,,,
23,143906,EZZELL ISD,3,english,8,10,4,6,5,3,10,3,7,5,4
23,144901,GIDDINGS ISD,13,english,8,147,21,126,96,45,136,18,118,84,36
23,144902,LEXINGTON ISD,13,english,8,97,15,82,49,20,100,9,91,68,28
23,144903,DIME BOX ISD,13,english,8,11,3,8,3,1,11,1,10,7,2
23,145901,BUFFALO ISD,6,english,8,75,14,61,37,7,75,7,68,47,16
23,145902,CENTERVILLE ISD,6,english,8,52,3,49,36,22,51,5,46,24,7
23,145906,NORMANGEE ISD,6,english,8,44,8,36,20,5,44,10,34,17,6
23,145907,OAKWOOD ISD,6,english,8,14,5,9,2,0,14,4,10,4,1
23,145911,LEON ISD,6,english,8,57,14,43,23,8,59,7,52,28,9
23,146901,CLEVELAND ISD,4,english,8,931,325,606,300,90,716,328,388,120,20
23,146902,DAYTON ISD,4,english,8,461,147,314,160,62,359,170,189,73,10
23,146903,DEVERS ISD,4,english,8,19,0,19,18,12,10,0,10,9,1
23,146904,HARDIN ISD,5,english,8,107,8,99,63,22,91,42,49,16,1
23,146905,HULL-DAISETTA I,5,english,8,33,9,24,15,6,33,13,20,8,0
23,146906,LIBERTY ISD,5,english,8,181,35,146,89,32,155,41,114,46,8
23,146907,TARKINGTON ISD,4,english,8,146,35,111,78,30,154,33,121,80,30
23,147901,COOLIDGE ISD,12,english,8,19,1,18,8,1,19,1,18,7,2
23,147902,GROESBECK ISD,12,english,8,141,31,110,68,30,140,32,108,60,15
23,147903,MEXIA ISD,12,english,8,122,30,92,48,17,124,25,99,60,10
23,148901,BOOKER ISD,16,english,8,28,5,23,16,7,28,4,24,16,5
23,148902,FOLLETT ISD,16,english,8,17,0,17,11,7,16,2,14,8,4
23,148905,DARROUZETT ISD,16,english,8,5,2,3,0,0,5,3,2,0,0
23,149901,GEORGE WEST ISD,2,english,8,75,5,70,60,33,77,14,63,39,18
23,149902,THREE RIVERS IS,2,english,8,49,8,41,32,8,49,7,42,33,12
23,150901,LLANO ISD,13,english,8,136,18,118,82,29,133,12,121,74,19
23,152504,TEXAS TECH UNIV,17,english,8,52,3,49,43,26,41,5,36,24,5
23,152802,RISE ACADEMY,17,english,8,15,0,15,14,10,11,1,10,10,4
23,152901,LUBBOCK ISD,17,english,8,1875,394,1481,900,402,1178,504,674,244,31
23,152902,NEW DEAL ISD,17,english,8,61,14,47,24,4,63,13,50,23,6
23,152903,SLATON ISD,17,english,8,102,25,77,41,16,77,28,49,16,0
23,152906,LUBBOCK-COOPER,17,english,8,618,67,551,410,217,654,92,562,411,165
23,152907,FRENSHIP ISD,17,english,8,805,106,699,460,201,517,165,352,137,13
23,152908,ROOSEVELT ISD,17,english,8,91,10,81,47,15,92,23,69,32,6
23,152909,SHALLOWATER ISD,17,english,8,116,11,105,83,45,76,12,64,45,8
23,152910,IDALOU ISD,17,english,8,89,7,82,57,36,89,4,85,75,36
23,153903,O'DONNELL ISD,17,english,8,27,4,23,12,4,27,6,21,11,4
23,153904,TAHOKA ISD,17,english,8,44,8,36,23,6,44,4,40,22,5
23,153905,NEW HOME ISD,17,english,8,46,1,45,39,26,25,2,23,8,0
23,153907,WILSON ISD,17,english,8,10,3,7,4,2,10,1,9,3,1
23,154901,MADISONVILLE CI,6,english,8,191,38,153,97,36,158,24,134,82,7
23,154903,NORTH ZULCH ISD,6,english,8,25,4,21,18,10,18,4,14,13,1
23,155901,JEFFERSON ISD,8,english,8,89,19,70,41,17,75,40,35,17,1
23,156902,STANTON ISD,18,english,8,91,23,68,39,17,87,18,69,48,19
23,156905,GRADY ISD,18,english,8,23,1,22,20,11,23,2,21,19,11
23,157901,MASON ISD,15,english,8,54,7,47,39,25,31,7,24,15,5
23,158901,BAY CITY ISD,3,english,8,268,52,216,147,70,159,23,136,84,6
23,158902,TIDEHAVEN ISD,3,english,8,82,9,73,61,33,79,8,71,47,19
23,158904,MATAGORDA ISD,3,english,8,7,1,6,4,2,7,3,4,3,1
23,158905,PALACIOS ISD,3,english,8,103,22,81,49,22,84,22,62,33,7
23,158906,VAN VLECK ISD,3,english,8,81,8,73,56,25,81,4,77,66,38
23,159901,EAGLE PASS ISD,20,english,8,1010,217,793,461,187,1009,273,736,395,140
23,160901,BRADY ISD,15,english,8,62,5,57,39,25,66,2,64,51,26
23,160904,ROCHELLE ISD,15,english,8,16,1,15,12,10,16,0,16,16,14
23,160905,LOHN ISD,15,english,8,13,5,8,7,0,13,8,5,1,1
23,161802,RAPOPORT ACADEM,12,english,8,52,3,49,35,19,41,11,30,11,2
23,161807,HARMONY PUBLIC,12,english,8,908,98,810,577,275,648,139,509,276,78
23,161901,CRAWFORD ISD,12,english,8,51,1,50,47,30,25,3,22,17,4
23,161903,MIDWAY ISD,12,english,8,652,71,581,452,241,512,69,443,280,76
23,161906,LA VEGA ISD,12,english,8,209,47,162,71,22,205,76,129,51,12
23,161907,LORENA ISD,12,english,8,149,21,128,91,40,119,22,97,70,21
23,161908,MART ISD,12,english,8,46,3,43,29,9,46,8,38,18,6
23,161909,MCGREGOR ISD,12,english,8,96,16,80,43,15,80,9,71,44,10
23,161910,MOODY ISD,12,english,8,57,9,48,31,9,59,12,47,27,9
23,161912,RIESEL ISD,12,english,8,61,7,54,38,19,65,13,52,31,12
23,161914,WACO ISD,12,english,8,915,286,629,349,127,809,381,428,141,23
23,161916,WEST ISD,12,english,8,100,10,90,58,25,116,10,106,91,45
23,161918,AXTELL ISD,12,english,8,86,15,71,47,20,83,36,47,18,4
23,161919,BRUCEVILLE-EDDY,12,english,8,59,17,42,18,5,47,20,27,11,2
23,161920,CHINA SPRING IS,12,english,8,231,23,208,161,82,237,21,216,154,45
23,161921,CONNALLY ISD,12,english,8,174,46,128,55,19,173,73,100,30,5
23,161922,ROBINSON ISD,12,english,8,213,21,192,138,64,225,30,195,128,44
23,161923,BOSQUEVILLE ISD,12,english,8,53,2,51,40,17,55,3,52,43,14
23,161925,GHOLSON ISD,12,english,8,25,4,21,15,3,26,16,10,7,2
23,162904,MCMULLEN COUNTY,2,english,8,19,2,17,13,6,15,0,15,5,0
23,163901,DEVINE ISD,20,english,8,156,30,126,79,33,161,36,125,67,29
23,163902,D'HANIS ISD,20,english,8,24,4,20,16,9,13,5,8,5,1
23,163903,NATALIA ISD,20,english,8,92,21,71,37,10,76,33,43,12,1
23,163904,HONDO ISD,20,english,8,145,35,110,62,18,127,38,89,41,5
23,163908,MEDINA VALLEY I,20,english,8,613,66,547,386,168,534,105,429,270,72
23,164901,MENARD ISD,15,english,8,22,3,19,10,3,23,8,15,9,5
23,165802,MIDLAND ACADEMY,18,english,8,17,0,17,14,8,20,0,20,20,10
23,165901,MIDLAND ISD,18,english,8,2017,625,1392,825,360,2024,716,1308,706,269
23,165902,GREENWOOD ISD,18,english,8,246,41,205,126,55,217,33,184,131,27
23,166901,CAMERON ISD,6,english,8,124,20,104,61,19,131,22,109,63,18
23,166902,GAUSE ISD,6,english,8,15,1,14,8,4,15,4,11,6,4
23,166903,MILANO ISD,6,english,8,19,5,14,8,3,20,4,16,8,2
23,166904,ROCKDALE ISD,6,english,8,111,13,98,77,36,75,27,48,11,0
23,166905,THORNDALE ISD,13,english,8,63,4,59,45,17,64,9,55,22,4
23,166907,BUCKHOLTS ISD,12,english,8,7,5,2,0,0,7,5,2,0,0
23,167901,GOLDTHWAITE ISD,12,english,8,39,2,37,27,15,27,4,23,13,7
23,167902,MULLIN ISD,12,english,8,12,8,4,3,0,12,8,4,1,0
23,167904,PRIDDY ISD,12,english,8,9,0,9,5,3,9,0,9,7,3
23,168901,COLORADO ISD,14,english,8,66,5,61,38,15,66,7,59,41,13
23,168902,LORAINE ISD,14,english,8,13,5,8,2,2,12,3,9,4,1
23,168903,WESTBROOK ISD,14,english,8,22,6,16,9,4,22,6,16,7,1
23,169901,BOWIE ISD,9,english,8,126,14,112,80,43,125,18,107,74,31
23,169902,NOCONA ISD,9,english,8,72,12,60,41,20,71,14,57,32,9
23,169906,GOLD BURG ISD,9,english,8,10,2,8,5,2,10,4,6,4,1
23,169908,MONTAGUE ISD,9,english,8,10,1,9,9,5,10,1,9,7,6
23,169909,PRAIRIE VALLEY,9,english,8,8,0,8,5,3,8,0,8,5,3
23,169910,FORESTBURG ISD,9,english,8,14,2,12,9,5,14,4,10,6,1
23,169911,SAINT JO ISD,9,english,8,20,1,19,15,5,13,3,10,3,0
23,170801,TEXAS SERENITY,4,english,8,24,3,21,8,1,24,6,18,5,0
23,170902,CONROE ISD,6,english,8,5552,651,4901,3768,2138,5631,670,4961,3676,1847
23,170903,MONTGOMERY ISD,6,english,8,775,73,702,518,232,789,47,742,657,418
23,170904,WILLIS ISD,6,english,8,705,176,529,302,116,716,272,444,190,52
23,170906,MAGNOLIA ISD,6,english,8,1104,160,944,694,359,763,222,541,246,47
23,170907,SPLENDORA ISD,6,english,8,414,101,313,185,68,433,167,266,101,20
23,170908,NEW CANEY ISD,6,english,8,1417,340,1077,662,254,1075,353,722,367,102
23,171901,DUMAS ISD,16,english,8,331,70,261,163,53,272,76,196,92,15
23,171902,SUNRAY COLLEGIA,16,english,8,52,4,48,37,16,52,8,44,26,6
23,172902,DAINGERFIELD-LO,8,english,8,79,25,54,26,6,70,41,29,4,0
23,172905,PEWITT CISD,8,english,8,73,9,64,28,11,63,5,58,38,10
23,173901,MOTLEY COUNTY I,17,english,8,13,2,11,5,3,13,2,11,8,3
23,174901,CHIRENO ISD,7,english,8,23,2,21,14,4,15,1,14,4,0
23,174902,CUSHING ISD,7,english,8,50,7,43,24,9,51,15,36,19,6
23,174903,GARRISON ISD,7,english,8,49,6,43,31,18,52,9,43,31,12
23,174904,NACOGDOCHES ISD,7,english,8,439,122,317,175,77,315,169,146,42,7
23,174906,WODEN ISD,7,english,8,49,1,48,38,17,49,2,47,39,17
23,174908,CENTRAL HEIGHTS,7,english,8,88,2,86,77,52,61,2,59,55,29
23,174909,MARTINSVILLE IS,7,english,8,24,0,24,20,10,24,6,18,10,6
23,174911,DOUGLASS ISD,7,english,8,32,4,28,22,13,18,5,13,7,1
23,175902,BLOOMING GROVE,12,english,8,82,18,64,36,12,82,20,62,30,6
23,175903,CORSICANA ISD,12,english,8,450,101,349,206,78,370,143,227,85,18
23,175904,DAWSON ISD,12,english,8,51,9,42,29,11,51,11,40,22,9
23,175905,FROST ISD,12,english,8,37,6,31,24,10,35,6,29,18,6
23,175907,KERENS ISD,12,english,8,44,7,37,27,11,36,9,27,13,0
23,175910,MILDRED ISD,12,english,8,67,7,60,42,15,67,10,57,43,17
23,175911,RICE ISD,12,english,8,92,12,80,41,16,92,24,68,41,13
23,176901,BURKEVILLE ISD,5,english,8,18,2,16,9,7,18,3,15,5,0
23,176902,NEWTON ISD,5,english,8,85,13,72,37,12,70,26,44,7,2
23,176903,DEWEYVILLE ISD,5,english,8,42,5,37,26,12,33,12,21,9,1
23,177901,ROSCOE COLLEGIA,14,english,8,41,7,34,25,11,17,9,8,3,0
23,177902,SWEETWATER ISD,14,english,8,134,35,99,68,32,128,41,87,45,13
23,177903,BLACKWELL CISD,14,english,8,12,0,12,9,5,12,0,12,9,2
23,177905,HIGHLAND ISD,14,english,8,18,0,18,14,6,18,0,18,16,10
23,178801,DR M L GARZA-GO,2,english,8,20,2,18,13,5,20,5,15,7,4
23,178807,CORPUS CHRISTI,2,english,8,14,2,12,8,4,14,5,9,3,1
23,178808,SEASHORE CHARTE,2,english,8,38,0,38,34,19,37,2,35,20,2
23,178901,AGUA DULCE ISD,2,english,8,31,1,30,24,14,19,2,17,8,0
23,178902,BISHOP CISD,2,english,8,126,15,111,81,38,99,26,73,39,10
23,178903,CALALLEN ISD,2,english,8,336,36,300,231,123,319,40,279,213,80
23,178904,CORPUS CHRISTI,2,english,8,2451,466,1985,1299,569,2638,829,1809,969,331
23,178905,DRISCOLL ISD,2,english,8,17,1,16,12,5,11,2,9,7,0
23,178906,LONDON ISD,2,english,8,120,2,118,113,76,96,2,94,79,46
23,178908,PORT ARANSAS IS,2,english,8,39,2,37,28,19,19,3,16,6,1
23,178909,ROBSTOWN ISD,2,english,8,182,73,109,58,20,164,73,91,41,4
23,178912,TULOSO-MIDWAY I,2,english,8,269,28,241,172,81,230,41,189,113,34
23,178913,BANQUETE ISD,2,english,8,68,8,60,40,9,54,22,32,13,1
23,178914,FLOUR BLUFF ISD,2,english,8,461,35,426,347,222,334,54,280,193,89
23,178915,WEST OSO ISD,2,english,8,141,25,116,72,18,128,33,95,56,5
23,179901,PERRYTON ISD,16,english,8,151,23,128,102,46,141,28,113,72,23
23,180901,BOYS RANCH ISD,16,english,8,13,4,9,5,1,13,3,10,3,1
23,180902,VEGA ISD,16,english,8,29,1,28,26,11,29,0,29,23,11
23,180903,ADRIAN ISD,16,english,8,15,0,15,10,3,15,4,11,5,0
23,180904,WILDORADO ISD,16,english,8,10,0,10,3,1,10,2,8,8,1
23,181901,BRIDGE CITY ISD,5,english,8,236,31,205,148,76,232,46,186,100,21
23,181905,ORANGEFIELD ISD,5,english,8,137,5,132,112,63,112,18,94,51,6
23,181906,WEST ORANGE-COV,5,english,8,154,29,125,59,11,127,29,98,37,3
23,181907,VIDOR ISD,5,english,8,313,60,253,162,62,267,56,211,112,15
23,181908,LITTLE CYPRESS-,5,english,8,276,49,227,134,51,273,69,204,108,37
23,182901,GORDON ISD,11,english,8,19,2,17,15,6,19,0,19,14,5
23,182902,GRAFORD ISD,11,english,8,22,2,20,13,4,14,3,11,5,0
23,182903,MINERAL WELLS I,11,english,8,216,61,155,55,15,260,60,200,117,30
23,182904,SANTO ISD,11,english,8,43,5,38,25,10,33,6,27,10,1
23,182905,STRAWN ISD,11,english,8,14,5,9,5,0,14,4,10,5,0
23,183801,PANOLA CHARTER,7,english,8,23,3,20,14,5,23,5,18,11,2
23,183901,BECKVILLE ISD,7,english,8,59,7,52,38,20,38,5,33,23,7
23,183902,CARTHAGE ISD,7,english,8,209,27,182,106,40,207,36,171,120,57
23,183904,GARY ISD,7,english,8,41,8,33,21,10,29,9,20,9,1
23,184901,POOLVILLE ISD,11,english,8,62,10,52,32,13,68,9,59,39,14
23,184902,SPRINGTOWN ISD,11,english,8,301,59,242,153,52,257,72,185,81,12
23,184903,WEATHERFORD ISD,11,english,8,581,98,483,335,161,410,131,279,130,22
23,184904,MILLSAP ISD,11,english,8,74,5,69,53,23,65,6,59,48,20
23,184907,ALEDO ISD,11,english,8,591,40,551,458,275,636,55,581,446,209
23,184908,PEASTER ISD,11,english,8,130,27,103,69,35,121,33,88,52,20
23,184909,BROCK ISD,11,english,8,146,11,135,105,55,91,20,71,44,4
23,184911,GARNER ISD,11,english,8,25,7,18,10,5,13,3,10,5,0
23,185901,BOVINA ISD,16,english,8,40,11,29,18,4,40,11,29,7,3
23,185902,FARWELL ISD,16,english,8,48,2,46,37,20,33,6,27,18,7
23,185903,FRIONA ISD,16,english,8,81,18,63,35,8,69,26,43,14,4
23,185904,LAZBUDDIE ISD,16,english,8,8,2,6,1,0,8,1,7,6,0
23,186901,BUENA VISTA ISD,18,english,8,19,3,16,11,5,19,3,16,13,7
23,186902,FORT STOCKTON I,18,english,8,197,43,154,81,36,197,84,113,54,9
23,186903,IRAAN-SHEFFIELD,18,english,8,21,2,19,11,5,21,4,17,9,1
23,187901,BIG SANDY ISD,6,english,8,35,2,33,26,14,35,8,27,17,6
23,187903,GOODRICH ISD,6,english,8,21,3,18,11,5,21,5,16,9,3
23,187904,CORRIGAN-CAMDEN,6,english,8,73,9,64,47,17,73,13,60,37,11
23,187906,LEGGETT ISD,6,english,8,17,7,10,7,4,17,7,10,6,2
23,187907,LIVINGSTON ISD,6,english,8,294,71,223,120,59,307,58,249,169,45
23,187910,ONALASKA ISD,6,english,8,96,18,78,48,23,76,18,58,23,4
23,188901,AMARILLO ISD,16,english,8,2235,413,1822,1160,455,2383,385,1998,1339,479
23,188902,RIVER ROAD ISD,16,english,8,116,17,99,64,30,113,20,93,60,14
23,188903,HIGHLAND PARK I,16,english,8,61,3,58,37,22,52,9,43,26,7
23,188904,BUSHLAND ISD,16,english,8,119,9,110,89,50,79,17,62,36,9
23,189901,MARFA ISD,18,english,8,15,0,15,13,9,10,1,9,5,2
23,189902,PRESIDIO ISD,18,english,8,61,6,55,40,20,43,6,37,25,2
23,190903,RAINS ISD,7,english,8,140,43,97,48,14,140,34,106,57,14
23,191901,CANYON ISD,16,english,8,888,97,791,565,268,624,96,528,365,121
23,192901,REAGAN COUNTY I,18,english,8,49,4,45,32,22,49,10,39,30,8
23,193801,BIG SPRINGS CHA,20,english,8,24,9,15,4,0,25,15,10,1,0
23,193902,LEAKEY ISD,20,english,8,23,6,17,12,5,13,5,8,0,0
23,194902,AVERY ISD,8,english,8,24,2,22,20,7,12,2,10,6,0
23,194903,RIVERCREST ISD,8,english,8,52,5,47,32,14,52,2,50,42,21
23,194904,CLARKSVILLE ISD,8,english,8,53,26,27,9,0,53,29,24,6,2
23,194905,DETROIT ISD,8,english,8,33,9,24,10,6,33,2,31,21,9
23,195901,PECOS-BARSTOW-T,18,english,8,234,68,166,80,22,208,25,183,127,31
23,195902,BALMORHEA ISD,18,english,8,13,5,8,3,1,13,6,7,1,0
23,196901,AUSTWELL-TIVOLI,3,english,8,9,1,8,5,3,9,2,7,6,0
23,196902,WOODSBORO ISD,3,english,8,29,4,25,16,7,29,9,20,11,2
23,196903,REFUGIO ISD,3,english,8,43,4,39,29,12,35,11,24,12,3
23,197902,MIAMI ISD,16,english,8,14,2,12,10,6,8,1,7,6,3
23,198901,BREMOND ISD,6,english,8,34,2,32,23,7,34,9,25,13,1
23,198902,CALVERT ISD,6,english,8,13,3,10,2,0,13,9,4,0,0
23,198903,FRANKLIN ISD,6,english,8,96,2,94,79,51,67,0,67,63,36
23,198905,HEARNE ISD,6,english,8,58,30,28,8,0,50,33,17,1,0
23,198906,MUMFORD ISD,6,english,8,40,0,40,38,29,18,0,18,17,10
23,199901,ROCKWALL ISD,10,english,8,1422,107,1315,1064,629,1651,166,1485,1167,623
23,199902,ROYSE CITY ISD,10,english,8,657,103,554,381,161,695,138,557,369,128
23,200901,BALLINGER ISD,15,english,8,57,6,51,33,7,57,11,46,23,11
23,200902,MILES ISD,15,english,8,41,6,35,24,6,41,3,38,22,8
23,200904,WINTERS ISD,15,english,8,31,9,22,13,4,31,9,22,13,4
23,200906,OLFEN ISD,15,english,8,14,2,12,10,5,13,2,11,8,3
23,201902,HENDERSON ISD,7,english,8,239,46,193,104,33,178,55,123,40,1
23,201903,LANEVILLE ISD,7,english,8,10,4,6,4,0,10,5,5,5,1
23,201904,LEVERETTS CHAPE,7,english,8,16,4,12,6,1,16,9,7,2,1
23,201907,MOUNT ENTERPRIS,7,english,8,36,5,31,22,6,33,11,22,10,1
23,201908,OVERTON ISD,7,english,8,53,10,43,32,14,38,17,21,5,1
23,201910,TATUM ISD,7,english,8,114,16,98,67,36,114,21,93,58,20
23,201913,CARLISLE ISD,7,english,8,53,13,40,23,8,44,9,35,18,5
23,201914,WEST RUSK COUNT,7,english,8,85,8,77,58,33,65,8,57,48,12
23,202903,HEMPHILL ISD,7,english,8,63,4,59,36,17,64,6,58,51,19
23,202905,WEST SABINE ISD,7,english,8,35,8,27,18,10,31,9,22,11,0
23,203901,SAN AUGUSTINE I,7,english,8,50,24,26,11,3,48,33,15,3,1
23,203902,BROADDUS ISD,7,english,8,36,4,32,23,10,28,3,25,23,8
23,204901,COLDSPRING-OAKH,6,english,8,118,42,76,31,10,99,35,64,18,2
23,204904,SHEPHERD ISD,6,english,8,174,49,125,68,19,137,47,90,27,2
23,205901,ARANSAS PASS IS,2,english,8,125,25,100,53,15,102,44,58,12,0
23,205902,GREGORY-PORTLAN,2,english,8,396,67,329,240,114,301,75,226,125,29
23,205903,INGLESIDE ISD,2,english,8,145,11,134,102,48,173,11,162,125,65
23,205904,MATHIS ISD,2,english,8,91,15,76,56,28,80,8,72,47,18
23,205905,ODEM-EDROY ISD,2,english,8,65,16,49,24,8,55,21,34,13,0
23,205906,SINTON ISD,2,english,8,151,19,132,94,39,153,45,108,63,16
23,205907,TAFT ISD,2,english,8,65,12,53,36,14,39,23,16,5,0
23,206901,SAN SABA ISD,15,english,8,58,13,45,22,8,58,11,47,31,11
23,206902,RICHLAND SPRING,15,english,8,13,2,11,5,2,13,2,11,7,2
23,206903,CHEROKEE ISD,15,english,8,14,2,12,8,3,11,2,9,2,1
23,207901,SCHLEICHER ISD,15,english,8,39,6,33,22,15,29,9,20,14,3
23,208901,HERMLEIGH ISD,14,english,8,20,4,16,5,1,20,8,12,4,1
23,208902,SNYDER ISD,14,english,8,184,56,128,61,19,184,77,107,55,18
23,208903,IRA ISD,14,english,8,25,1,24,20,14,25,5,20,12,5
23,209901,ALBANY ISD,14,english,8,38,6,32,9,3,38,18,20,7,2
23,209902,MORAN ISD,14,english,8,7,3,4,2,0,6,3,3,2,0
23,210901,CENTER ISD,7,english,8,186,30,156,78,30,186,18,168,117,34
23,210902,JOAQUIN ISD,7,english,8,55,4,51,35,10,56,5,51,32,9
23,210903,SHELBYVILLE ISD,7,english,8,61,5,56,34,14,62,3,59,36,10
23,210904,TENAHA ISD,7,english,8,38,10,28,11,1,27,5,22,8,0
23,210905,TIMPSON ISD,7,english,8,58,7,51,33,18,40,4,36,21,1
23,210906,EXCELSIOR ISD,7,english,8,6,0,6,4,2,6,0,6,3,1
23,211902,STRATFORD ISD,16,english,8,45,4,41,36,19,45,5,40,29,14
23,212801,CUMBERLAND ACAD,7,english,8,152,27,125,85,30,147,34,113,71,22
23,212804,UT TYLER UNIVER,7,english,8,73,1,72,59,42,20,2,18,11,4
23,212901,ARP ISD,7,english,8,74,8,66,38,13,72,23,49,19,4
23,212902,BULLARD ISD,7,english,8,231,12,219,191,94,168,27,141,95,29
23,212903,LINDALE ISD,7,english,8,336,23,313,259,150,275,10,265,240,175
23,212904,TROUP ISD,7,english,8,88,11,77,57,33,85,10,75,53,16
23,212905,TYLER ISD,7,english,8,1316,269,1047,683,330,999,327,672,329,107
23,212906,WHITEHOUSE ISD,7,english,8,372,17,355,306,201,361,16,345,301,177
23,212909,CHAPEL HILL ISD,7,english,8,247,53,194,136,52,246,60,186,114,39
23,212910,WINONA ISD,7,english,8,77,5,72,56,33,63,15,48,29,9
23,213801,BRAZOS RIVER CH,11,english,8,6,4,2,1,1,7,6,1,1,0
23,213901,GLEN ROSE ISD,11,english,8,161,14,147,118,66,179,25,154,93,32
23,214901,RIO GRANDE CITY,1,english,8,664,166,498,286,115,566,171,395,194,40
23,214902,SAN ISIDRO ISD,1,english,8,17,2,15,12,2,11,6,5,0,0
23,214903,ROMA ISD,1,english,8,430,84,346,235,87,430,69,361,263,109
23,215901,BRECKENRIDGE IS,14,english,8,100,13,87,61,26,77,15,62,27,2
23,216901,STERLING CITY I,15,english,8,41,6,35,25,14,39,5,34,26,9
23,217901,ASPERMONT ISD,14,english,8,11,2,9,6,3,11,2,9,8,4
23,218901,SONORA ISD,15,english,8,60,9,51,29,13,60,16,44,20,4
23,219901,HAPPY ISD,16,english,8,21,2,19,11,6,21,1,20,17,10
23,219903,TULIA ISD,16,english,8,70,24,46,23,3,56,35,21,4,1
23,219905,KRESS ISD,16,english,8,24,6,18,8,2,24,8,16,5,0
23,220801,TREETOPS SCHOOL,11,english,8,27,1,26,13,8,27,2,25,14,3
23,220802,ARLINGTON CLASS,11,english,8,140,5,135,121,82,0,,,,
23,220809,FORT WORTH ACAD,11,english,8,82,2,80,75,50,83,10,73,50,21
23,220810,WESTLAKE ACADEM,11,english,8,73,2,71,63,48,94,5,89,70,40
23,220815,CHAPEL HILL ACA,11,english,8,67,7,60,26,8,67,20,47,24,5
23,220817,NEWMAN INTERNAT,11,english,8,213,21,192,138,47,235,46,189,103,32
23,220819,HIGH POINT ACAD,11,english,8,96,15,81,49,28,94,15,79,46,10
23,220901,ARLINGTON ISD,11,english,8,4087,1088,2999,1828,783,3244,1202,2042,876,207
23,220902,BIRDVILLE ISD,11,english,8,1705,294,1411,948,434,1197,354,843,469,142
23,220904,EVERMAN ISD,11,english,8,448,148,300,150,38,296,169,127,22,0
23,220905,FORT WORTH ISD,11,english,8,4140,1701,2439,928,210,5705,2268,3437,1554,418
23,220906,GRAPEVINE-COLLE,11,english,8,1119,85,1034,874,563,1131,126,1005,763,414
23,220907,KELLER ISD,11,english,8,1836,243,1593,1125,495,2520,372,2148,1518,692
23,220908,MANSFIELD ISD,11,english,8,2861,355,2506,1822,944,2032,445,1587,933,221
23,220910,LAKE WORTH ISD,11,english,8,259,92,167,72,22,266,132,134,38,6
23,220912,CROWLEY ISD,11,english,8,1278,334,944,562,226,1276,507,769,365,84
23,220914,KENNEDALE ISD,11,english,8,223,39,184,123,69,213,50,163,87,19
23,220915,AZLE ISD,11,english,8,570,83,487,313,135,596,125,471,309,127
23,220916,HURST-EULESS-BE,11,english,8,1736,165,1571,1219,701,1240,143,1097,766,257
23,220917,CASTLEBERRY ISD,11,english,8,294,74,220,149,65,281,117,164,86,12
23,220918,EAGLE MT-SAGINA,11,english,8,1817,280,1537,1090,517,1933,416,1517,970,369
23,220919,CARROLL ISD,11,english,8,688,15,673,627,476,856,12,844,810,692
23,220920,WHITE SETTLEMEN,11,english,8,520,88,432,267,133,443,183,260,95,16
23,221801,TEXAS COLLEGE P,14,english,8,1252,125,1127,812,395,830,224,606,311,114
23,221901,ABILENE ISD,14,english,8,999,246,753,426,147,724,301,423,146,20
23,221904,MERKEL ISD,14,english,8,69,14,55,38,19,70,21,49,24,9
23,221905,TRENT ISD,14,english,8,16,3,13,4,2,16,10,6,2,0
23,221911,JIM NED CISD,14,english,8,144,4,140,121,60,103,10,93,73,29
23,221912,WYLIE ISD,14,english,8,407,17,390,330,211,312,28,284,194,72
23,222901,TERRELL COUNTY,18,english,8,13,2,11,6,2,13,5,8,3,1
23,223901,BROWNFIELD ISD,17,english,8,138,34,104,40,15,138,44,94,49,15
23,223902,MEADOW ISD,17,english,8,24,4,20,9,3,24,10,14,4,0
23,223904,WELLMAN-UNION C,17,english,8,20,4,16,10,6,20,6,14,6,2
23,224901,THROCKMORTON CO,9,english,8,14,1,13,9,4,15,3,12,6,0
23,224902,WOODSON ISD,9,english,8,12,1,11,8,1,12,1,11,5,0
23,225902,MOUNT PLEASANT,8,english,8,396,71,325,209,76,326,99,227,78,6
23,225906,CHAPEL HILL ISD,8,english,8,82,6,76,61,26,65,10,55,42,10
23,225907,HARTS BLUFF ISD,8,english,8,60,2,58,46,20,43,5,38,20,3
23,226801,TEXAS LEADERSHI,15,english,8,343,49,294,181,87,304,80,224,103,29
23,226901,CHRISTOVAL ISD,15,english,8,40,2,38,28,10,40,9,31,21,4
23,226903,SAN ANGELO ISD,15,english,8,1066,275,791,452,189,938,299,639,315,74
23,226905,WATER VALLEY IS,15,english,8,28,6,22,13,3,28,7,21,9,2
23,226906,WALL ISD,15,english,8,93,2,91,79,45,76,2,74,51,19
23,226907,GRAPE CREEK ISD,15,english,8,98,23,75,45,15,96,31,65,33,9
23,226908,VERIBEST ISD,15,english,8,24,3,21,16,6,24,5,19,12,4
23,227622,TEXAS JUVENILE,13,english,8,10,8,2,0,0,8,8,0,0,0
23,227803,WAYSIDE SCHOOLS,13,english,8,98,36,62,32,9,122,73,49,11,1
23,227804,NYOS CHARTER SC,13,english,8,84,5,79,62,33,89,14,75,58,25
23,227805,TEXAS EMPOWERME,13,english,8,26,3,23,13,0,0,,,,
23,227806,UNIVERSITY OF T,13,english,8,71,43,28,12,6,66,46,20,5,0
23,227814,CHAPARRAL STAR,13,english,8,31,1,30,29,26,21,1,20,19,14
23,227816,HARMONY PUBLIC,13,english,8,337,66,271,182,106,239,69,170,85,28
23,227817,CEDARS INTERNAT,13,english,8,32,5,27,20,11,33,3,30,14,4
23,227820,KIPP TEXAS PUBL,4,english,8,2580,453,2127,1357,509,7,4,3,1,0
23,227824,VALERE PUBLIC S,13,english,8,48,14,34,19,11,48,22,26,13,3
23,227825,AUSTIN ACHIEVE,13,english,8,153,47,106,52,17,6,6,0,0,0
23,227829,VALOR PUBLIC SC,13,english,8,166,11,155,124,72,84,18,66,54,21
23,227901,AUSTIN ISD,13,english,8,4915,1119,3796,2751,1607,5236,1627,3609,2260,954
23,227904,PFLUGERVILLE IS,13,english,8,1848,339,1509,1021,520,1980,509,1471,845,338
23,227905,TEXAS SCH FOR T,13,english,8,0,,,,,0,,,,
23,227906,TEXAS SCH FOR T,13,english,8,33,20,13,4,0,33,17,16,3,0
23,227907,MANOR ISD,13,english,8,647,204,443,211,70,715,314,401,175,34
23,227909,EANES ISD,13,english,8,619,15,604,559,383,639,20,619,545,399
23,227910,DEL VALLE ISD,13,english,8,880,310,570,303,118,878,367,511,181,26
23,227912,LAGO VISTA ISD,13,english,8,164,22,142,113,63,150,28,122,83,25
23,227913,LAKE TRAVIS ISD,13,english,8,909,55,854,692,390,907,87,820,648,348
23,228901,GROVETON ISD,6,english,8,54,2,52,38,24,24,9,15,4,0
23,228903,TRINITY ISD,6,english,8,89,35,54,25,7,69,32,37,13,0
23,228904,CENTERVILLE ISD,6,english,8,7,0,7,5,2,7,0,7,5,2
23,228905,APPLE SPRINGS I,6,english,8,15,0,15,10,2,9,0,9,4,0
23,229901,COLMESNEIL ISD,5,english,8,33,0,33,24,14,33,4,29,15,6
23,229903,WOODVILLE ISD,5,english,8,98,23,75,40,20,97,26,71,41,11
23,229904,WARREN ISD,5,english,8,94,12,82,54,26,93,17,76,41,14
23,229905,SPURGER ISD,5,english,8,28,3,25,15,5,28,4,24,15,5
23,229906,CHESTER ISD,5,english,8,25,6,19,9,3,25,7,18,6,0
23,230901,BIG SANDY ISD,7,english,8,46,4,42,34,16,42,7,35,14,6
23,230902,GILMER ISD,7,english,8,220,26,194,142,75,203,46,157,88,26
23,230903,ORE CITY ISD,7,english,8,59,11,48,30,13,59,18,41,18,4
23,230904,UNION HILL ISD,7,english,8,23,6,17,11,6,23,8,15,8,1
23,230905,HARMONY ISD,7,english,8,76,11,65,45,19,76,10,66,49,20
23,230906,NEW DIANA ISD,7,english,8,76,6,70,53,21,76,21,55,33,10
23,230908,UNION GROVE ISD,7,english,8,56,2,54,46,18,56,3,53,47,30
23,231901,MCCAMEY ISD,18,english,8,44,5,39,26,8,41,12,29,13,5
23,231902,RANKIN ISD,18,english,8,14,1,13,12,6,14,1,13,11,8
23,232901,KNIPPA ISD,20,english,8,28,1,27,16,9,0,,,,
23,232902,SABINAL ISD,20,english,8,33,6,27,16,5,33,8,25,17,8
23,232903,UVALDE CISD,20,english,8,339,130,209,102,37,333,166,167,51,8
23,232904,UTOPIA ISD,20,english,8,19,5,14,7,2,0,,,,
23,233901,SAN FELIPE-DEL,15,english,8,685,214,471,251,77,510,219,291,127,21
23,233903,COMSTOCK ISD,15,english,8,16,0,16,11,5,10,5,5,2,0
23,234801,RANCH ACADEMY,7,english,8,12,4,8,2,2,12,7,5,2,0
23,234902,CANTON ISD,10,english,8,180,12,168,127,58,137,9,128,72,18
23,234903,EDGEWOOD ISD,7,english,8,68,7,61,45,16,74,19,55,31,14
23,234904,GRAND SALINE IS,7,english,8,87,18,69,46,12,68,22,46,20,3
23,234905,MARTINS MILL IS,7,english,8,37,7,30,24,11,16,1,15,10,2
23,234906,VAN ISD,7,english,8,188,19,169,128,55,152,34,118,53,10
23,234907,WILLS POINT ISD,10,english,8,225,44,181,117,33,225,65,160,79,18
23,234909,FRUITVALE ISD,7,english,8,30,4,26,19,5,23,7,16,10,1
23,235901,BLOOMINGTON ISD,3,english,8,64,23,41,16,6,64,20,44,22,5
23,235902,VICTORIA ISD,3,english,8,966,342,624,334,135,1009,434,575,296,97
23,236901,NEW WAVERLY ISD,6,english,8,80,5,75,57,33,86,11,75,57,17
23,236902,HUNTSVILLE ISD,6,english,8,1040,169,871,584,245,1120,257,863,498,164
23,237902,HEMPSTEAD ISD,4,english,8,103,39,64,34,17,107,41,66,32,2
23,237904,WALLER ISD,4,english,8,731,160,571,350,143,572,181,391,180,42
23,237905,ROYAL ISD,4,english,8,220,60,160,85,29,151,40,111,47,14
23,238902,MONAHANS-WICKET,18,english,8,190,50,140,79,31,174,58,116,43,9
23,238904,GRANDFALLS-ROYA,18,english,8,6,3,3,0,0,6,1,5,1,0
23,239901,BRENHAM ISD,6,english,8,388,87,301,187,81,291,98,193,86,16
23,239903,BURTON ISD,6,english,8,41,2,39,26,12,19,5,14,3,0
23,240901,LAREDO ISD,1,english,8,1439,335,1104,698,309,1253,412,841,392,74
23,240903,UNITED ISD,1,english,8,3204,404,2800,2080,1115,2580,400,2180,1447,319
23,240904,WEBB CISD,1,english,8,11,1,10,7,3,11,0,11,5,3
23,241901,BOLING ISD,3,english,8,100,16,84,47,17,74,14,60,32,4
23,241902,EAST BERNARD IS,3,english,8,67,7,60,43,24,50,11,39,25,3
23,241903,EL CAMPO ISD,3,english,8,230,38,192,115,48,137,46,91,31,0
23,241904,WHARTON ISD,3,english,8,131,40,91,50,17,134,64,70,29,3
23,241906,LOUISE ISD,3,english,8,34,3,31,18,2,32,2,30,21,7
23,242902,SHAMROCK ISD,16,english,8,30,6,24,11,6,29,8,21,14,5
23,242903,WHEELER ISD,16,english,8,22,1,21,17,4,22,3,19,10,4
23,242905,KELTON ISD,16,english,8,14,2,12,7,5,13,0,13,9,2
23,242906,FORT ELLIOTT CI,16,english,8,14,2,12,11,5,14,3,11,9,5
23,243901,BURKBURNETT ISD,9,english,8,232,37,195,130,50,245,52,193,104,35
23,243902,ELECTRA ISD,9,english,8,39,10,29,11,1,39,14,25,9,1
23,243903,IOWA PARK CISD,9,english,8,155,13,142,110,51,155,11,144,114,54
23,243905,WICHITA FALLS I,9,english,8,876,230,646,358,138,676,193,483,256,43
23,243906,CITY VIEW ISD,9,english,8,90,7,83,62,26,92,6,86,45,16
23,244901,HARROLD ISD,9,english,8,9,3,6,4,3,9,3,6,2,0
23,244903,VERNON ISD,9,english,8,131,29,102,58,19,131,35,96,63,19
23,244905,NORTHSIDE ISD,9,english,8,20,2,18,13,5,20,1,19,15,4
23,245901,LASARA ISD,1,english,8,29,3,26,17,6,0,,,,
23,245902,LYFORD CISD,1,english,8,111,34,77,47,15,73,41,32,5,0
23,245903,RAYMONDVILLE IS,1,english,8,130,11,119,84,29,129,12,117,88,21
23,245904,SAN PERLITA ISD,1,english,8,15,3,12,9,2,0,,,,
23,246801,MERIDIAN WORLD,13,english,8,142,2,140,131,105,149,10,139,102,55
23,246802,GOODWATER MONTE,13,english,8,12,2,10,7,4,12,3,9,5,0
23,246902,FLORENCE ISD,13,english,8,93,13,80,47,22,92,20,72,32,12
23,246904,GEORGETOWN ISD,13,english,8,952,175,777,538,257,935,264,671,376,135
23,246905,GRANGER ISD,13,english,8,46,4,42,27,13,36,11,25,12,1
23,246906,HUTTO ISD,13,english,8,722,129,593,403,182,757,208,549,275,72
23,246907,JARRELL ISD,13,english,8,242,41,201,135,44,253,65,188,86,9
23,246908,LIBERTY HILL IS,13,english,8,598,69,529,391,192,618,78,540,377,133
23,246909,ROUND ROCK ISD,13,english,8,3589,424,3165,2535,1580,4175,530,3645,2993,2063
23,246911,TAYLOR ISD,13,english,8,207,51,156,81,36,163,68,95,43,5
23,246912,THRALL ISD,13,english,8,66,8,58,49,31,60,8,52,44,31
23,246913,LEANDER ISD,13,english,8,3255,308,2947,2314,1320,3444,413,3031,2289,1107
23,246914,COUPLAND ISD,13,english,8,25,8,17,11,8,11,5,6,2,0
23,247901,FLORESVILLE ISD,20,english,8,283,49,234,145,70,255,62,193,112,34
23,247903,LA VERNIA ISD,20,english,8,280,27,253,193,110,196,45,151,81,19
23,247904,POTH ISD,20,english,8,72,1,71,64,42,51,2,49,43,24
23,247906,STOCKDALE ISD,20,english,8,74,7,67,45,19,75,13,62,37,13
23,248901,KERMIT ISD,18,english,8,101,35,66,37,11,101,40,61,26,4
23,248902,WINK-LOVING ISD,18,english,8,34,6,28,15,7,34,6,28,20,10
23,249901,ALVORD ISD,11,english,8,64,8,56,41,22,56,5,51,39,8
23,249902,BOYD ISD,11,english,8,97,9,88,61,28,64,12,52,27,2
23,249903,BRIDGEPORT ISD,11,english,8,155,21,134,88,37,120,19,101,47,3
23,249904,CHICO ISD,11,english,8,34,5,29,15,3,47,6,41,17,3
23,249905,DECATUR ISD,11,english,8,268,51,217,143,50,284,66,218,139,47
23,249906,PARADISE ISD,11,english,8,96,12,84,45,13,104,10,94,48,18
23,249908,SLIDELL ISD,11,english,8,30,6,24,8,2,15,6,9,3,0
23,250902,HAWKINS ISD,7,english,8,58,3,55,40,20,38,4,34,21,7
23,250903,MINEOLA ISD,7,english,8,141,15,126,94,38,119,20,99,59,8
23,250904,QUITMAN ISD,7,english,8,89,11,78,58,28,77,17,60,41,12
23,250905,YANTIS ISD,7,english,8,17,4,13,7,3,17,4,13,9,4
23,250906,ALBA-GOLDEN ISD,7,english,8,63,13,50,34,14,49,13,36,17,3
23,250907,WINNSBORO ISD,7,english,8,128,13,115,89,40,127,16,111,74,33
23,251901,DENVER CITY ISD,17,english,8,131,19,112,54,19,131,45,86,45,18
23,251902,PLAINS ISD,17,english,8,30,6,24,11,1,31,10,21,12,4
23,252901,GRAHAM ISD,9,english,8,198,37,161,96,41,180,33,147,95,26
23,252902,NEWCASTLE ISD,9,english,8,20,0,20,16,10,12,0,12,11,2
23,252903,OLNEY ISD,9,english,8,54,9,45,34,17,56,11,45,37,17
23,253901,ZAPATA COUNTY I,1,english,8,260,68,192,116,49,260,82,178,109,37
23,254901,CRYSTAL CITY IS,20,english,8,126,43,83,32,10,111,37,74,28,3
23,254902,LA PRYOR ISD,20,english,8,34,4,30,14,3,44,3,41,21,0
22,1902,CAYUGA ISD,7,english,3,40,7,33,29,21,40,7,33,24,15
22,1903,ELKHART ISD,7,english,3,85,10,75,48,26,85,11,74,38,22
22,1904,FRANKSTON ISD,7,english,3,61,7,54,31,11,61,12,49,24,10
22,1906,NECHES ISD,7,english,3,20,2,18,13,6,20,2,18,13,6
22,1907,PALESTINE ISD,7,english,3,221,55,166,111,65,239,83,156,96,43
22,1908,WESTWOOD ISD,7,english,3,93,19,74,46,26,93,28,65,40,24
22,1909,SLOCUM ISD,7,english,3,32,2,30,19,7,32,8,24,10,4
22,2901,ANDREWS ISD,18,english,3,301,44,257,179,97,318,75,243,145,59
22,3801,PINEYWOODS COMM,7,english,3,72,16,56,38,22,72,16,56,25,8
22,3902,HUDSON ISD,7,english,3,222,42,180,118,64,223,51,172,107,51
22,3903,LUFKIN ISD,7,english,3,477,130,347,184,107,478,193,285,158,67
22,3904,HUNTINGTON ISD,7,english,3,114,21,93,58,29,114,26,88,52,23
22,3905,DIBOLL ISD,7,english,3,123,19,104,66,31,123,24,99,53,17
22,3906,ZAVALLA ISD,7,english,3,17,3,14,7,4,17,6,11,2,1
22,3907,CENTRAL ISD,7,english,3,93,25,68,40,21,93,38,55,31,11
22,4901,ARANSAS COUNTY,2,english,3,192,63,129,72,42,189,81,108,41,17
22,5901,ARCHER CITY ISD,9,english,3,36,1,35,27,13,36,2,34,26,19
22,5902,HOLLIDAY ISD,9,english,3,94,20,74,45,29,94,19,75,47,18
22,5904,WINDTHORST ISD,9,english,3,33,3,30,18,13,33,1,32,25,13
22,6902,CLAUDE ISD,16,english,3,31,1,30,24,16,31,3,28,20,15
22,7901,CHARLOTTE ISD,20,english,3,24,9,15,8,5,24,8,16,8,2
22,7902,JOURDANTON ISD,20,english,3,102,13,89,59,33,102,23,79,47,27
22,7904,LYTLE ISD,20,english,3,138,50,88,48,18,141,71,70,19,8
22,7905,PLEASANTON ISD,20,english,3,236,82,154,102,51,236,90,146,83,39
22,7906,POTEET ISD,20,english,3,114,57,57,28,17,123,74,49,14,4
22,8901,BELLVILLE ISD,6,english,3,159,33,126,64,38,159,51,108,58,23
22,8902,SEALY ISD,6,english,3,149,28,121,78,42,178,43,135,69,34
22,8903,BRAZOS ISD,6,english,3,51,17,34,13,4,51,23,28,13,5
22,9901,MULESHOE ISD,17,english,3,89,33,56,26,14,89,34,55,29,14
22,10901,MEDINA ISD,20,english,3,20,3,17,13,5,20,6,14,5,1
22,10902,BANDERA ISD,20,english,3,170,48,122,76,45,170,69,101,43,16
22,11901,BASTROP ISD,13,english,3,770,266,504,306,167,773,303,470,245,88
22,11902,ELGIN ISD,13,english,3,277,86,191,108,48,355,157,198,86,26
22,11904,SMITHVILLE ISD,13,english,3,134,28,106,65,37,134,34,100,57,23
22,11905,MCDADE ISD,13,english,3,27,12,15,6,3,27,12,15,7,3
22,12901,SEYMOUR ISD,9,english,3,48,8,40,23,12,48,2,46,24,11
22,13801,ST MARY'S ACADE,2,english,3,61,10,51,31,14,61,16,45,16,2
22,13901,BEEVILLE ISD,2,english,3,198,49,149,77,38,198,74,124,62,23
22,13902,PAWNEE ISD,2,english,3,17,11,6,5,4,17,11,6,3,2
22,13903,PETTUS ISD,2,english,3,21,2,19,12,7,21,3,18,12,6
22,13905,SKIDMORE-TYNAN,2,english,3,56,14,42,24,14,54,23,31,22,8
22,14803,PRIORITY CHARTE,12,english,3,72,12,60,38,20,72,27,45,22,5
22,14804,ORENDA CHARTER,12,english,3,144,13,131,104,63,144,13,131,95,61
22,14901,ACADEMY ISD,12,english,3,132,23,109,77,48,132,32,100,64,32
22,14902,BARTLETT ISD,13,english,3,29,10,19,8,1,29,11,18,7,1
22,14903,BELTON ISD,12,english,3,871,179,692,440,256,902,301,601,328,145
22,14905,HOLLAND ISD,12,english,3,45,3,42,30,17,45,0,45,30,19
22,14906,KILLEEN ISD,12,english,3,3224,880,2344,1421,769,3243,1092,2151,1086,452
22,14907,ROGERS ISD,12,english,3,69,11,58,35,19,69,22,47,27,13
22,14908,SALADO ISD,12,english,3,164,33,131,81,48,165,45,120,66,35
22,14909,TEMPLE ISD,12,english,3,572,181,391,227,123,637,231,406,195,87
22,14910,TROY ISD,12,english,3,113,28,85,44,29,112,24,88,54,25
22,15802,GEORGE GERVIN A,20,english,3,48,28,20,11,5,48,36,12,2,0
22,15806,LEGACY TRADITIO,20,english,3,31,19,12,4,1,31,19,12,4,0
22,15807,SOUTHWEST PREPA,20,english,3,55,21,34,20,9,55,27,28,7,1
22,15808,INSPIRE ACADEMI,20,english,3,31,5,26,16,12,31,13,18,6,2
22,15809,BEXAR COUNTY AC,20,english,3,21,10,11,6,3,21,6,15,9,4
22,15815,HERITAGE ACADEM,20,english,3,18,8,10,7,5,18,9,9,5,3
22,15822,JUBILEE ACADEMI,20,english,3,458,159,299,180,98,460,198,262,133,60
22,15825,LIGHTHOUSE PUBL,20,english,3,29,15,14,9,4,27,18,9,4,2
22,15827,SCHOOL OF SCIEN,20,english,3,299,79,220,147,84,299,118,181,88,33
22,15828,HARMONY PUBLIC,20,english,3,262,103,159,77,40,264,123,141,55,25
22,15830,BROOKS ACADEMIE,20,english,3,248,74,174,93,51,246,116,130,65,21
22,15831,SCHOOL OF SCIEN,20,english,3,480,104,376,239,143,481,144,337,176,76
22,15834,BASIS TEXAS,20,english,3,397,14,383,338,262,397,34,363,296,184
22,15835,GREAT HEARTS TE,20,english,3,857,114,743,543,328,857,190,667,415,199
22,15836,ELEANOR KOLITZ,20,english,3,61,3,58,50,41,61,4,57,50,22
22,15838,COMPASS ROSE PU,20,english,3,171,87,84,46,24,170,109,61,23,8
22,15839,PROMESA ACADEMY,20,english,3,45,16,29,19,15,45,31,14,4,2
22,15841,THE GATHERING P,20,english,3,90,39,51,24,15,90,71,19,4,2
22,15901,ALAMO HEIGHTS I,20,english,3,315,22,293,246,179,318,37,281,185,100
22,15904,HARLANDALE ISD,20,english,3,640,225,415,225,108,623,311,312,113,34
22,15905,EDGEWOOD ISD,20,english,3,412,192,220,116,54,411,231,180,74,25
22,15906,RANDOLPH FIELD,20,english,3,100,9,91,64,44,98,17,81,37,22
22,15907,SAN ANTONIO ISD,20,english,3,2328,952,1376,767,404,2287,1202,1085,451,183
22,15908,SOUTH SAN ANTON,20,english,3,445,193,252,119,47,445,267,178,61,20
22,15909,SOMERSET ISD,20,english,3,240,30,210,136,71,276,52,224,127,61
22,15910,NORTH EAST ISD,20,english,3,3541,678,2863,2065,1305,3503,920,2583,1650,870
22,15911,EAST CENTRAL IS,20,english,3,619,244,375,187,97,608,273,335,147,56
22,15912,SOUTHWEST ISD,20,english,3,837,217,620,401,214,840,273,567,305,135
22,15913,LACKLAND ISD,20,english,3,68,11,57,38,23,68,16,52,26,13
22,15914,FT SAM HOUSTON,20,english,3,125,23,102,74,52,125,32,93,55,28
22,15915,NORTHSIDE ISD,20,english,3,6684,1679,5005,3252,1919,6682,2233,4449,2416,1048
22,15916,JUDSON ISD,20,english,3,1639,433,1206,744,407,1644,576,1068,518,220
22,15917,SOUTHSIDE ISD,20,english,3,257,75,182,103,54,256,91,165,91,39
22,16901,JOHNSON CITY IS,13,english,3,46,7,39,25,11,46,12,34,16,7
22,16902,BLANCO ISD,13,english,3,66,16,50,31,18,66,20,46,21,5
22,17901,BORDEN COUNTY I,17,english,3,18,0,18,13,8,18,0,18,14,6
22,18901,CLIFTON ISD,12,english,3,76,10,66,42,28,76,13,63,34,21
22,18902,MERIDIAN ISD,12,english,3,33,9,24,12,6,33,11,22,7,4
22,18903,MORGAN ISD,12,english,3,8,4,4,2,2,8,7,1,0,0
22,18904,VALLEY MILLS IS,12,english,3,44,10,34,18,11,44,14,30,17,8
22,18905,WALNUT SPRINGS,12,english,3,15,5,10,8,4,15,6,9,5,2
22,18906,IREDELL ISD,12,english,3,6,0,6,5,3,6,0,6,5,5
22,18907,KOPPERL ISD,12,english,3,18,4,14,8,4,18,12,6,4,2
22,18908,CRANFILLS GAP I,12,english,3,13,4,9,6,2,13,4,9,5,2
22,19901,DEKALB ISD,8,english,3,38,5,33,20,11,38,8,30,20,10
22,19902,HOOKS ISD,8,english,3,37,4,33,29,19,37,4,33,29,18
22,19903,MAUD ISD,8,english,3,33,4,29,20,15,33,3,30,19,9
22,19905,NEW BOSTON ISD,8,english,3,71,27,44,29,13,71,28,43,20,6
22,19906,REDWATER ISD,8,english,3,83,13,70,36,15,83,16,67,47,16
22,19907,TEXARKANA ISD,8,english,3,497,157,340,203,112,519,207,312,158,81
22,19908,LIBERTY-EYLAU I,8,english,3,144,62,82,41,18,142,67,75,32,13
22,19909,SIMMS ISD,8,english,3,32,4,28,25,12,32,4,28,23,13
22,19910,MALTA ISD,8,english,3,19,0,19,11,7,19,0,19,13,3
22,19911,RED LICK ISD,8,english,3,55,1,54,49,32,55,2,53,35,23
22,19912,PLEASANT GROVE,8,english,3,156,13,143,113,65,156,10,146,111,55
22,19913,HUBBARD ISD,8,english,3,7,2,5,3,0,7,1,6,3,1
22,19914,LEARY ISD,8,english,3,7,0,7,6,2,7,0,7,3,1
22,20901,ALVIN ISD,4,english,3,1864,332,1532,1097,660,1915,475,1440,891,453
22,20902,ANGLETON ISD,4,english,3,479,59,420,286,165,479,77,402,258,117
22,20904,DANBURY ISD,4,english,3,57,14,43,33,13,57,16,41,16,8
22,20905,BRAZOSPORT ISD,4,english,3,814,125,689,473,262,819,177,642,435,196
22,20906,SWEENY ISD,4,english,3,121,24,97,65,39,123,40,83,50,17
22,20907,COLUMBIA-BRAZOR,4,english,3,204,47,157,112,70,204,50,154,88,37
22,20908,PEARLAND ISD,4,english,3,1435,181,1254,952,647,1435,245,1190,866,515
22,20910,DAMON ISD,4,english,3,13,5,8,5,0,13,4,9,3,2
22,21803,BRAZOS SCHOOL F,6,english,3,35,11,24,13,5,35,12,23,7,5
22,21805,ARROW ACADEMY,6,english,3,94,22,72,44,29,94,26,68,34,14
22,21901,COLLEGE STATION,6,english,3,927,150,777,553,366,927,185,742,510,292
22,21902,BRYAN ISD,6,english,3,1096,292,804,494,290,1100,329,771,406,179
22,22004,TERLINGUA CSD,18,english,3,11,7,4,3,1,11,8,3,0,0
22,22901,ALPINE ISD,18,english,3,51,9,42,25,13,51,26,25,13,5
22,22902,MARATHON ISD,18,english,3,0,,,,,0,,,,
22,22903,SAN VICENTE ISD,18,english,3,0,,,,,0,,,,
22,23902,SILVERTON ISD,16,english,3,12,2,10,8,5,12,1,11,9,6
22,24901,BROOKS COUNTY I,1,english,3,76,38,38,19,12,75,51,24,9,6
22,25901,BANGS ISD,15,english,3,64,10,54,42,23,64,6,58,43,17
22,25902,BROWNWOOD ISD,15,english,3,229,53,176,115,66,229,47,182,112,55
22,25904,BLANKET ISD,15,english,3,9,2,7,4,1,9,6,3,1,0
22,25905,MAY ISD,15,english,3,14,4,10,6,4,13,4,9,4,2
22,25906,ZEPHYR ISD,15,english,3,11,0,11,7,4,11,3,8,4,2
22,25908,BROOKESMITH ISD,15,english,3,8,1,7,2,0,8,4,4,1,0
22,25909,EARLY ISD,15,english,3,87,12,75,48,27,87,31,56,36,22
22,26901,CALDWELL ISD,6,english,3,125,24,101,71,42,125,28,97,67,37
22,26902,SOMERVILLE ISD,6,english,3,43,23,20,9,3,43,25,18,5,3
22,26903,SNOOK ISD,6,english,3,36,12,24,16,9,35,12,23,13,8
22,27903,BURNET CISD,13,english,3,237,56,181,107,66,236,84,152,77,34
22,27904,MARBLE FALLS IS,13,english,3,230,47,183,135,70,266,75,191,105,42
22,28902,LOCKHART ISD,13,english,3,360,99,261,153,74,367,116,251,128,64
22,28903,LULING ISD,13,english,3,87,24,63,35,24,87,30,57,36,27
22,28906,PRAIRIE LEA ISD,13,english,3,17,11,6,2,1,17,15,2,0,0
22,29901,CALHOUN COUNTY,3,english,3,245,40,205,131,72,246,55,191,122,60
22,30901,CROSS PLAINS IS,14,english,3,27,1,26,19,12,27,3,24,19,6
22,30902,CLYDE CISD,14,english,3,98,23,75,44,24,98,33,65,26,8
22,30903,BAIRD ISD,14,english,3,28,6,22,14,6,28,10,18,9,4
22,30906,EULA ISD,14,english,3,40,2,38,23,9,40,14,26,15,4
22,31901,BROWNSVILLE ISD,1,english,3,2400,637,1763,1096,559,2402,769,1633,937,387
22,31903,HARLINGEN CISD,1,english,3,1083,258,825,496,258,1089,349,740,377,149
22,31905,LA FERIA ISD,1,english,3,167,47,120,77,37,167,46,121,65,28
22,31906,LOS FRESNOS CIS,1,english,3,705,129,576,400,228,705,169,536,334,149
22,31909,POINT ISABEL IS,1,english,3,110,26,84,50,31,114,35,79,34,16
22,31911,RIO HONDO ISD,1,english,3,125,33,92,53,31,125,42,83,46,22
22,31912,SAN BENITO CISD,1,english,3,586,187,399,242,129,587,206,381,198,79
22,31913,SANTA MARIA ISD,1,english,3,33,8,25,9,6,33,10,23,15,5
22,31914,SANTA ROSA ISD,1,english,3,54,13,41,20,9,55,21,34,16,7
22,32902,PITTSBURG ISD,8,english,3,186,47,139,69,36,185,68,117,42,12
22,33901,GROOM ISD,16,english,3,10,0,10,9,6,10,0,10,7,6
22,33902,PANHANDLE ISD,16,english,3,40,7,33,22,19,40,9,31,17,6
22,33904,WHITE DEER ISD,16,english,3,26,3,23,16,11,26,8,18,12,4
22,34901,ATLANTA ISD,8,english,3,153,26,127,94,52,153,33,120,68,33
22,34902,AVINGER ISD,8,english,3,7,2,5,5,2,7,1,6,4,2
22,34903,HUGHES SPRINGS,8,english,3,58,10,48,30,14,58,21,37,20,7
22,34905,LINDEN-KILDARE,8,english,3,51,12,39,28,17,51,19,32,22,10
22,34906,MCLEOD ISD,8,english,3,25,1,24,17,7,25,0,25,17,7
22,34907,QUEEN CITY ISD,8,english,3,54,12,42,21,10,54,13,41,20,7
22,34909,BLOOMBURG ISD,8,english,3,15,5,10,7,4,15,5,10,7,5
22,35901,DIMMITT ISD,16,english,3,85,38,47,21,12,85,37,48,22,14
22,35902,HART ISD,16,english,3,15,3,12,9,6,15,5,10,6,1
22,35903,NAZARETH ISD,16,english,3,22,3,19,17,12,22,1,21,17,10
22,36901,ANAHUAC ISD,4,english,3,96,42,54,32,20,96,46,50,22,9
22,36902,BARBERS HILL IS,4,english,3,520,48,472,386,272,520,60,460,327,194
22,36903,EAST CHAMBERS I,5,english,3,103,16,87,58,29,103,18,85,56,26
22,37901,ALTO ISD,7,english,3,36,7,29,16,9,36,8,28,16,3
22,37904,JACKSONVILLE IS,7,english,3,248,75,173,104,55,338,126,212,100,37
22,37907,RUSK ISD,7,english,3,129,9,120,75,37,129,24,105,60,27
22,37908,NEW SUMMERFIELD,7,english,3,39,5,34,24,14,39,9,30,21,9
22,37909,WELLS ISD,7,english,3,14,0,14,7,4,14,0,14,8,2
22,38901,CHILDRESS ISD,16,english,3,61,2,59,41,24,61,4,57,43,31
22,39902,HENRIETTA ISD,9,english,3,66,12,54,26,12,66,20,46,18,4
22,39903,PETROLIA CISD,9,english,3,36,10,26,13,6,36,11,25,13,3
22,39904,BELLEVUE ISD,9,english,3,15,0,15,9,6,15,4,11,4,0
22,39905,MIDWAY ISD,9,english,3,11,5,6,4,2,11,5,6,3,2
22,40901,MORTON ISD,17,english,3,19,6,13,6,4,19,3,16,11,3
22,40902,WHITEFACE CISD,17,english,3,19,4,15,9,3,19,7,12,5,2
22,41901,BRONTE ISD,15,english,3,23,3,20,13,10,23,5,18,12,9
22,41902,ROBERT LEE ISD,15,english,3,18,6,12,6,3,18,5,13,3,0
22,42901,COLEMAN ISD,15,english,3,58,17,41,22,16,57,22,35,20,9
22,42903,SANTA ANNA ISD,15,english,3,11,1,10,7,4,11,2,9,3,1
22,42905,PANTHER CREEK C,15,english,3,13,4,9,5,4,13,5,8,3,1
22,43801,IMAGINE INTERNA,10,english,3,124,9,115,90,63,124,18,106,80,53
22,43802,LONE STAR LANGU,10,english,3,37,2,35,22,15,37,5,32,24,14
22,43901,ALLEN ISD,10,english,3,1534,171,1363,1070,748,1533,214,1319,989,610
22,43902,ANNA ISD,10,english,3,332,67,265,177,108,334,89,245,138,71
22,43903,CELINA ISD,10,english,3,273,30,243,190,133,283,45,238,158,74
22,43904,FARMERSVILLE IS,10,english,3,143,26,117,87,56,143,41,102,55,18
22,43905,FRISCO ISD,10,english,3,4673,440,4233,3350,2283,4697,750,3947,2805,1705
22,43907,MCKINNEY ISD,10,english,3,1438,215,1223,896,573,1442,306,1136,744,387
22,43908,MELISSA ISD,10,english,3,397,46,351,281,188,397,44,353,266,166
22,43910,PLANO ISD,10,english,3,3127,405,2722,2110,1447,3141,609,2532,1771,1100
22,43911,PRINCETON ISD,10,english,3,528,124,404,276,162,530,121,409,253,110
22,43912,PROSPER ISD,10,english,3,1856,202,1654,1238,792,1857,243,1614,1106,593
22,43914,WYLIE ISD,10,english,3,1385,118,1267,1006,702,1414,143,1271,972,621
22,43917,BLUE RIDGE ISD,10,english,3,70,11,59,40,30,70,8,62,40,17
22,43918,COMMUNITY ISD,10,english,3,205,38,167,98,58,253,85,168,84,40
22,43919,LOVEJOY ISD,10,english,3,305,19,286,247,173,304,18,286,232,162
22,44902,WELLINGTON ISD,16,english,3,28,5,23,18,10,28,6,22,14,6
22,45902,COLUMBUS ISD,3,english,3,96,31,65,39,21,96,37,59,25,8
22,45903,RICE CISD,3,english,3,102,21,81,48,24,104,13,91,62,21
22,45905,WEIMAR ISD,3,english,3,52,9,43,30,18,52,11,41,24,16
22,46901,NEW BRAUNFELS I,13,english,3,743,102,641,472,320,747,158,589,373,194
22,46902,COMAL ISD,20,english,3,1970,273,1697,1261,812,1971,333,1638,1163,658
22,47901,COMANCHE ISD,14,english,3,94,28,66,36,19,93,24,69,37,17
22,47902,DE LEON ISD,14,english,3,50,5,45,31,21,50,2,48,27,13
22,47903,GUSTINE ISD,14,english,3,9,1,8,5,3,9,1,8,5,0
22,47905,SIDNEY ISD,14,english,3,15,3,12,5,4,15,5,10,2,1
22,48901,EDEN CISD,15,english,3,8,3,5,4,4,8,3,5,3,3
22,48903,PAINT ROCK ISD,15,english,3,12,4,8,5,2,12,5,7,3,1
22,49901,GAINESVILLE ISD,11,english,3,235,99,136,87,40,269,120,149,65,27
22,49902,MUENSTER ISD,11,english,3,35,3,32,27,23,35,3,32,26,17
22,49903,VALLEY VIEW ISD,11,english,3,70,22,48,32,19,77,28,49,28,17
22,49905,CALLISBURG ISD,11,english,3,90,24,66,42,27,90,22,68,43,25
22,49906,ERA ISD,11,english,3,39,7,32,23,13,39,10,29,13,6
22,49907,LINDSAY ISD,11,english,3,36,4,32,24,15,36,4,32,20,9
22,49908,WALNUT BEND ISD,11,english,3,9,2,7,3,1,9,3,6,3,0
22,49909,SIVELLS BEND IS,11,english,3,10,0,10,7,1,10,3,7,2,0
22,50901,EVANT ISD,12,english,3,15,4,11,5,2,15,6,9,3,0
22,50902,GATESVILLE ISD,12,english,3,187,23,164,107,67,189,45,144,94,46
22,50904,OGLESBY ISD,12,english,3,17,7,10,5,3,17,8,9,2,0
22,50909,JONESBORO ISD,12,english,3,18,3,15,10,4,18,4,14,4,1
22,50910,COPPERAS COVE I,12,english,3,577,110,467,292,159,580,155,425,256,124
22,51901,PADUCAH ISD,17,english,3,14,4,10,2,1,14,6,8,2,1
22,52901,CRANE ISD,15,english,3,83,26,57,30,21,83,33,50,27,11
22,53001,CROCKETT COUNTY,15,english,3,49,2,47,28,10,49,12,37,21,7
22,54901,CROSBYTON CISD,17,english,3,16,1,15,10,4,16,4,12,6,3
22,54902,LORENZO ISD,17,english,3,14,6,8,4,0,14,9,5,1,0
22,54903,RALLS ISD,17,english,3,21,16,5,4,2,21,12,9,3,3
22,55901,CULBERSON COUNT,18,english,3,32,13,19,10,5,32,17,15,7,3
22,56901,DALHART ISD,16,english,3,119,62,57,28,13,120,73,47,12,2
22,56902,TEXLINE ISD,16,english,3,15,1,14,11,8,15,1,14,9,5
22,57802,PEGASUS SCHOOL,10,english,3,31,14,17,6,2,31,15,16,3,0
22,57803,UPLIFT EDUCATIO,10,english,3,1669,542,1127,681,370,1672,661,1011,533,242
22,57805,LUMIN EDUCATION,10,english,3,27,7,20,14,10,29,8,21,9,5
22,57806,ADVANTAGE ACADE,10,english,3,93,50,43,23,9,93,73,20,5,1
22,57807,LIFE SCHOOL,10,english,3,415,139,276,164,87,415,190,225,107,35
22,57808,UNIVERSAL ACADE,10,english,3,204,31,173,139,99,203,42,161,117,72
22,57809,NOVA ACADEMY,10,english,3,8,3,5,2,1,8,4,4,3,1
22,57810,ACADEMY OF DALL,10,english,3,12,8,4,2,0,12,8,4,0,0
22,57813,TRINITY BASIN P,10,english,3,382,115,267,155,89,382,135,247,125,51
22,57816,A W BROWN LEADE,10,english,3,88,41,47,25,8,87,53,34,4,1
22,57819,JEAN MASSIEU AC,10,english,3,15,4,11,4,3,15,5,10,5,0
22,57827,NOVA ACADEMY SO,10,english,3,46,23,23,15,8,46,25,21,7,3
22,57829,A+ ACADEMY,10,english,3,92,50,42,24,12,92,52,40,22,10
22,57830,INSPIRED VISION,10,english,3,87,35,52,25,19,87,34,53,22,10
22,57831,GATEWAY CHARTER,10,english,3,47,23,24,12,3,47,33,14,6,1
22,57833,EDUCATION CENTE,10,english,3,64,15,49,22,12,64,23,41,20,5
22,57835,GOLDEN RULE CHA,10,english,3,124,19,105,70,44,124,28,96,50,20
22,57836,ST ANTHONY SCHO,10,english,3,38,6,32,13,5,38,9,29,6,3
22,57839,LA ACADEMIA DE,10,english,3,80,13,67,36,17,81,20,61,27,10
22,57841,CITYSCAPE SCHOO,10,english,3,101,46,55,29,10,133,79,54,19,4
22,57844,MANARA ACADEMY,10,english,3,44,14,30,19,10,44,20,24,7,3
22,57845,UME PREPARATORY,10,english,3,120,17,103,72,50,119,42,77,41,17
22,57846,LEGACY PREPARAT,10,english,3,124,58,66,39,23,126,76,50,21,4
22,57847,VILLAGE TECH SC,10,english,3,87,21,66,33,19,87,45,42,13,4
22,57848,INTERNATIONAL L,10,english,3,1827,628,1199,713,386,1837,928,909,380,154
22,57850,PIONEER TECHNOL,10,english,3,152,25,127,87,47,152,48,104,54,26
22,57851,BRIDGEWAY PREPA,10,english,3,5,4,1,1,0,5,4,1,1,0
22,57903,CARROLLTON-FARM,10,english,3,1469,329,1140,787,494,1745,509,1236,794,391
22,57904,CEDAR HILL ISD,10,english,3,447,179,268,150,81,447,208,239,101,34
22,57905,DALLAS ISD,10,english,3,6015,1825,4190,2722,1595,9558,3258,6300,3596,1712
22,57906,DESOTO ISD,10,english,3,359,137,222,112,56,383,200,183,75,27
22,57907,DUNCANVILLE ISD,10,english,3,529,220,309,182,89,661,310,351,167,75
22,57909,GARLAND ISD,10,english,3,2851,635,2216,1471,861,3555,962,2593,1655,793
22,57910,GRAND PRAIRIE I,10,english,3,1307,285,1022,687,405,1711,517,1194,686,344
22,57911,HIGHLAND PARK I,10,english,3,435,12,423,384,291,434,16,418,357,251
22,57912,IRVING ISD,10,english,3,1944,724,1220,650,329,1946,844,1102,504,197
22,57913,LANCASTER ISD,10,english,3,474,145,329,212,115,485,170,315,174,72
22,57914,MESQUITE ISD,10,english,3,2145,608,1537,903,484,2171,751,1420,794,333
22,57916,RICHARDSON ISD,10,english,3,2623,680,1943,1371,886,2714,885,1829,1205,682
22,57919,SUNNYVALE ISD,10,english,3,168,21,147,112,74,168,37,131,91,44
22,57922,COPPELL ISD,10,english,3,891,82,809,657,481,890,112,778,605,382
22,58902,DAWSON ISD,17,english,3,14,4,10,5,3,14,5,9,2,0
22,58905,KLONDIKE ISD,17,english,3,25,0,25,18,11,25,1,24,18,11
22,58906,LAMESA ISD,17,english,3,118,41,77,48,24,118,54,64,30,15
22,58909,SANDS CISD,17,english,3,17,3,14,6,3,17,5,12,6,2
22,59901,HEREFORD ISD,16,english,3,266,64,202,108,56,266,83,183,105,48
22,59902,WALCOTT ISD,16,english,3,15,0,15,9,7,15,2,13,9,1
22,60902,COOPER ISD,8,english,3,58,16,42,31,16,58,16,42,20,5
22,60914,FANNINDEL ISD,8,english,3,11,4,7,2,1,11,6,5,3,0
22,61802,NORTH TEXAS COL,11,english,3,67,28,39,20,11,67,31,36,21,9
22,61804,LEADERSHIP PREP,10,english,3,100,17,83,57,29,100,20,80,43,22
22,61805,TRIVIUM ACADEMY,11,english,3,68,5,63,48,36,68,17,51,24,13
22,61901,DENTON ISD,11,english,3,2197,504,1693,1142,696,2322,782,1540,865,392
22,61902,LEWISVILLE ISD,11,english,3,3129,515,2614,1935,1275,3134,712,2422,1595,850
22,61903,PILOT POINT ISD,11,english,3,70,15,55,38,17,93,27,66,31,11
22,61905,KRUM ISD,11,english,3,128,24,104,68,41,135,42,93,53,24
22,61906,PONDER ISD,11,english,3,131,30,101,60,34,131,47,84,45,13
22,61907,AUBREY ISD,11,english,3,255,41,214,161,88,255,61,194,112,52
22,61908,SANGER ISD,11,english,3,195,47,148,91,59,194,54,140,77,38
22,61910,ARGYLE ISD,11,english,3,320,30,290,244,160,320,45,275,202,105
22,61911,NORTHWEST ISD,11,english,3,2136,395,1741,1236,786,2107,497,1610,981,484
22,61912,LAKE DALLAS ISD,11,english,3,272,81,191,120,76,272,111,161,75,32
22,61914,LITTLE ELM ISD,11,english,3,566,123,443,283,170,598,185,413,222,95
22,62901,CUERO ISD,3,english,3,124,34,90,54,28,124,40,84,43,19
22,62902,NORDHEIM ISD,3,english,3,10,1,9,5,0,10,2,8,4,2
22,62903,YOAKUM ISD,3,english,3,81,4,77,49,22,81,6,75,45,24
22,62904,YORKTOWN ISD,3,english,3,45,19,26,19,10,45,18,27,14,6
22,62905,WESTHOFF ISD,3,english,3,9,0,9,7,4,9,0,9,6,3
22,62906,MEYERSVILLE ISD,3,english,3,17,1,16,11,7,17,1,16,9,5
22,63903,SPUR ISD,17,english,3,14,2,12,7,4,14,3,11,5,1
22,63906,PATTON SPRINGS,17,english,3,5,0,5,3,3,5,0,5,4,1
22,64903,CARRIZO SPRINGS,20,english,3,153,48,105,69,38,153,60,93,45,18
22,65901,CLARENDON ISD,16,english,3,33,5,28,20,12,33,9,24,10,4
22,65902,HEDLEY ISD,16,english,3,8,0,8,7,6,8,0,8,8,6
22,66005,RAMIREZ CSD,2,english,3,5,2,3,2,1,5,3,2,1,0
22,66901,BENAVIDES ISD,2,english,3,8,3,5,1,1,8,3,5,1,0
22,66902,SAN DIEGO ISD,2,english,3,82,26,56,34,17,82,36,46,24,9
22,66903,FREER ISD,2,english,3,45,8,37,20,8,46,19,27,13,5
22,67902,CISCO ISD,14,english,3,59,9,50,36,23,59,11,48,25,10
22,67903,EASTLAND ISD,14,english,3,62,11,51,30,15,62,14,48,27,10
22,67904,GORMAN ISD,14,english,3,22,1,21,18,10,22,4,18,11,6
22,67907,RANGER ISD,14,english,3,21,4,17,7,4,21,7,14,2,2
22,67908,RISING STAR ISD,14,english,3,15,8,7,4,3,15,9,6,2,1
22,68802,COMPASS ACADEMY,18,english,3,118,21,97,70,34,118,30,88,55,28
22,68803,UTPB STEM ACADE,18,english,3,63,8,55,32,22,63,16,47,27,14
22,68901,ECTOR COUNTY IS,18,english,3,1982,627,1355,784,411,1989,730,1259,639,278
22,69901,ROCKSPRINGS ISD,15,english,3,18,6,12,9,5,18,6,12,5,3
22,69902,NUECES CANYON C,15,english,3,18,2,16,8,5,18,4,14,8,4
22,70801,WAXAHACHIE FAIT,10,english,3,91,52,39,17,7,158,109,49,9,1
22,70901,AVALON ISD,10,english,3,30,10,20,11,7,30,14,16,10,1
22,70903,ENNIS ISD,10,english,3,395,81,314,184,111,395,99,296,166,77
22,70905,FERRIS ISD,10,english,3,142,30,112,73,43,172,50,122,62,32
22,70907,ITALY ISD,10,english,3,46,18,28,15,8,46,17,29,14,3
22,70908,MIDLOTHIAN ISD,10,english,3,773,104,669,447,285,787,116,671,431,234
22,70909,MILFORD ISD,10,english,3,10,2,8,5,3,10,6,4,2,1
22,70910,PALMER ISD,10,english,3,88,16,72,47,29,88,21,67,36,17
22,70911,RED OAK ISD,10,english,3,406,92,314,205,109,422,112,310,176,75
22,70912,WAXAHACHIE ISD,10,english,3,701,157,544,366,209,732,217,515,294,128
22,70915,MAYPEARL ISD,10,english,3,76,10,66,43,26,76,12,64,41,16
22,71801,BURNHAM WOOD CH,19,english,3,78,9,69,53,29,78,17,61,37,21
22,71806,HARMONY PUBLIC,19,english,3,365,84,281,186,112,366,104,262,148,53
22,71807,LA FE PREPARATO,19,english,3,9,3,6,3,3,9,2,7,4,1
22,71809,VISTA DEL FUTUR,19,english,3,31,7,24,15,9,31,11,20,9,4
22,71901,CLINT ISD,19,english,3,586,192,394,220,102,605,242,363,183,74
22,71902,EL PASO ISD,19,english,3,2792,568,2224,1535,896,2825,801,2024,1199,549
22,71903,FABENS ISD,19,english,3,74,29,45,21,9,76,19,57,26,9
22,71904,SAN ELIZARIO IS,19,english,3,111,28,83,44,24,179,71,108,42,13
22,71905,YSLETA ISD,19,english,3,1856,348,1508,992,565,2093,469,1624,937,398
22,71906,ANTHONY ISD,19,english,3,42,14,28,9,5,42,17,25,7,2
22,71907,CANUTILLO ISD,19,english,3,365,57,308,225,122,370,78,292,175,89
22,71908,TORNILLO ISD,19,english,3,19,5,14,10,4,46,12,34,16,6
22,71909,SOCORRO ISD,19,english,3,2877,647,2230,1454,816,2890,859,2031,1139,490
22,72901,THREE WAY ISD,11,english,3,20,9,11,4,3,20,13,7,1,0
22,72902,DUBLIN ISD,11,english,3,73,4,69,56,36,73,2,71,56,32
22,72903,STEPHENVILLE IS,11,english,3,245,30,215,159,110,266,43,223,166,98
22,72904,BLUFF DALE ISD,11,english,3,16,3,13,6,5,16,3,13,5,3
22,72908,HUCKABAY ISD,11,english,3,29,2,27,21,9,29,2,27,19,10
22,72909,LINGLEVILLE ISD,11,english,3,16,0,16,12,5,16,2,14,10,1
22,72910,MORGAN MILL ISD,11,english,3,11,4,7,5,2,11,6,5,3,0
22,73901,CHILTON ISD,12,english,3,40,7,33,9,5,40,21,19,9,1
22,73903,MARLIN ISD,12,english,3,65,33,32,14,6,65,41,24,12,3
22,73904,WESTPHALIA ISD,12,english,3,18,1,17,14,8,18,3,15,8,4
22,73905,ROSEBUD-LOTT IS,12,english,3,48,14,34,24,14,48,25,23,12,8
22,74903,BONHAM ISD,10,english,3,118,30,88,43,21,118,51,67,32,13
22,74904,DODD CITY ISD,10,english,3,24,3,21,14,7,24,9,15,6,1
22,74905,ECTOR ISD,10,english,3,14,8,6,4,1,14,11,3,3,1
22,74907,HONEY GROVE ISD,8,english,3,36,1,35,26,17,36,5,31,20,12
22,74909,LEONARD ISD,10,english,3,54,11,43,26,17,54,11,43,21,5
22,74911,SAVOY ISD,10,english,3,21,2,19,16,10,21,1,20,13,6
22,74912,TRENTON ISD,10,english,3,51,16,35,20,9,51,23,28,11,0
22,74917,SAM RAYBURN ISD,10,english,3,34,3,31,28,14,34,10,24,18,11
22,75901,FLATONIA ISD,13,english,3,27,2,25,20,12,27,1,26,22,13
22,75902,LA GRANGE ISD,13,english,3,131,32,99,64,31,131,50,81,42,14
22,75903,SCHULENBURG ISD,13,english,3,40,13,27,13,8,40,14,26,13,3
22,75906,FAYETTEVILLE IS,13,english,3,18,4,14,9,6,18,3,15,6,0
22,75908,ROUND TOP-CARMI,13,english,3,18,1,17,14,7,18,4,14,7,2
22,76903,ROBY CISD,14,english,3,25,9,16,12,8,25,9,16,10,6
22,76904,ROTAN ISD,14,english,3,20,2,18,9,5,20,0,20,16,8
22,77901,FLOYDADA COLLEG,17,english,3,48,12,36,21,13,48,17,31,17,8
22,77902,LOCKNEY ISD,17,english,3,26,8,18,6,2,26,17,9,2,1
22,78901,CROWELL ISD,9,english,3,12,2,10,5,4,12,7,5,4,1
22,79901,LAMAR CISD,4,english,3,2909,445,2464,1848,1148,2960,544,2416,1627,852
22,79906,NEEDVILLE ISD,4,english,3,263,35,228,161,87,264,24,240,175,91
22,79907,FORT BEND ISD,4,english,3,5232,963,4269,3128,2050,5270,1300,3970,2621,1482
22,79910,STAFFORD MSD,4,english,3,231,71,160,112,72,234,76,158,92,48
22,80901,MOUNT VERNON IS,8,english,3,91,16,75,46,30,91,19,72,45,21
22,81902,FAIRFIELD ISD,12,english,3,124,35,89,57,38,124,39,85,55,22
22,81904,TEAGUE ISD,12,english,3,88,10,78,52,26,88,8,80,58,27
22,81905,WORTHAM ISD,12,english,3,43,13,30,16,10,43,16,27,14,4
22,81906,DEW ISD,12,english,3,11,0,11,7,6,11,0,11,8,6
22,82902,DILLEY ISD,20,english,3,61,26,35,19,10,61,32,29,14,5
22,82903,PEARSALL ISD,20,english,3,136,52,84,48,24,136,52,84,47,29
22,83901,SEAGRAVES ISD,17,english,3,32,21,11,4,0,32,19,13,5,2
22,83902,LOOP ISD,17,english,3,13,2,11,8,7,13,2,11,6,4
22,83903,SEMINOLE ISD,17,english,3,216,37,179,116,69,216,47,169,114,65
22,84802,ODYSSEY ACADEMY,4,english,3,126,28,98,63,29,126,49,77,30,9
22,84804,AMBASSADORS PRE,4,english,3,21,5,16,7,1,21,4,17,6,0
22,84901,DICKINSON ISD,4,english,3,742,174,568,368,206,783,209,574,350,168
22,84902,GALVESTON ISD,4,english,3,397,89,308,196,115,404,123,281,163,79
22,84903,HIGH ISLAND ISD,5,english,3,6,0,6,3,0,6,4,2,0,0
22,84906,TEXAS CITY ISD,4,english,3,522,166,356,210,113,523,196,327,182,93
22,84908,HITCHCOCK ISD,4,english,3,106,38,68,30,21,106,61,45,18,9
22,84909,SANTA FE ISD,4,english,3,292,60,232,153,92,290,77,213,133,75
22,84910,CLEAR CREEK ISD,4,english,3,2657,406,2251,1638,1089,2645,564,2081,1324,717
22,84911,FRIENDSWOOD ISD,4,english,3,434,35,399,321,229,433,40,393,288,162
22,85902,POST ISD,17,english,3,45,22,23,11,4,45,26,19,8,1
22,85903,SOUTHLAND ISD,17,english,3,9,3,6,4,2,9,6,3,3,2
22,86024,DOSS CONSOLIDAT,13,english,3,5,0,5,2,1,5,0,5,3,1
22,86901,FREDERICKSBURG,13,english,3,178,37,141,104,65,180,40,140,85,39
22,86902,HARPER ISD,13,english,3,38,5,33,15,9,38,5,33,21,10
22,87901,GLASSCOCK COUNT,18,english,3,14,1,13,12,10,15,1,14,14,7
22,88902,GOLIAD ISD,3,english,3,94,19,75,46,21,94,20,74,51,28
22,89901,GONZALES ISD,13,english,3,186,55,131,73,32,187,69,118,58,32
22,89903,NIXON-SMILEY CI,13,english,3,68,14,54,36,24,68,17,51,40,21
22,89905,WAELDER ISD,13,english,3,14,5,9,6,1,14,9,5,2,0
22,90902,LEFORS ISD,16,english,3,17,6,11,7,4,17,6,11,6,5
22,90903,MCLEAN ISD,16,english,3,6,1,5,2,1,6,1,5,3,2
22,90904,PAMPA ISD,16,english,3,220,67,153,96,49,220,84,136,71,32
22,90905,GRANDVIEW-HOPKI,16,english,3,0,,,,,0,,,,
22,91901,BELLS ISD,10,english,3,69,7,62,49,31,69,11,58,42,18
22,91902,COLLINSVILLE IS,10,english,3,38,12,26,15,9,38,13,25,15,6
22,91903,DENISON ISD,10,english,3,290,54,236,146,74,305,74,231,148,54
22,91905,HOWE ISD,10,english,3,86,22,64,39,23,86,31,55,31,13
22,91906,SHERMAN ISD,10,english,3,531,184,347,190,109,568,259,309,146,58
22,91907,TIOGA ISD,10,english,3,50,5,45,37,20,50,4,46,38,27
22,91908,VAN ALSTYNE ISD,10,english,3,161,9,152,112,77,161,21,140,99,56
22,91909,WHITESBORO ISD,10,english,3,116,48,68,41,20,116,54,62,28,13
22,91910,WHITEWRIGHT ISD,10,english,3,41,10,31,22,14,41,8,33,17,6
22,91913,POTTSBORO ISD,10,english,3,92,11,81,47,22,92,25,67,29,12
22,91914,S AND S CISD,10,english,3,57,10,47,31,17,57,19,38,22,9
22,91917,GUNTER ISD,10,english,3,80,8,72,47,27,80,8,72,50,23
22,91918,TOM BEAN ISD,10,english,3,44,6,38,30,17,44,2,42,34,12
22,92901,GLADEWATER ISD,7,english,3,105,42,63,33,16,105,42,63,29,10
22,92902,KILGORE ISD,7,english,3,244,43,201,134,85,268,65,203,125,63
22,92903,LONGVIEW ISD,7,english,3,509,120,389,283,172,576,163,413,267,138
22,92904,PINE TREE ISD,7,english,3,328,55,273,190,105,329,68,261,144,58
22,92906,SABINE ISD,7,english,3,114,15,99,60,35,114,30,84,43,19
22,92907,SPRING HILL ISD,7,english,3,160,18,142,101,53,160,39,121,78,37
22,92908,WHITE OAK ISD,7,english,3,117,19,98,77,45,117,16,101,67,32
22,93901,ANDERSON-SHIRO,6,english,3,66,7,59,44,29,66,4,62,41,23
22,93903,IOLA ISD,6,english,3,41,3,38,29,18,41,4,37,29,20
22,93904,NAVASOTA ISD,6,english,3,226,54,172,103,47,226,62,164,91,41
22,93905,RICHARDS ISD,6,english,3,9,1,8,7,4,9,2,7,7,4
22,94901,SEGUIN ISD,20,english,3,484,147,337,202,129,479,166,313,173,78
22,94902,SCHERTZ-CIBOLO-,20,english,3,1070,238,832,513,296,1099,340,759,399,158
22,94903,NAVARRO ISD,20,english,3,137,19,118,69,36,137,25,112,63,23
22,94904,MARION ISD,20,english,3,95,19,76,55,35,95,34,61,32,12
22,95901,ABERNATHY ISD,17,english,3,58,12,46,28,17,58,21,37,22,17
22,95902,COTTON CENTER I,17,english,3,6,2,4,3,2,6,1,5,2,0
22,95903,HALE CENTER ISD,17,english,3,41,4,37,16,11,41,15,26,12,4
22,95904,PETERSBURG ISD,17,english,3,13,5,8,2,2,13,4,9,3,0
22,95905,PLAINVIEW ISD,17,english,3,306,97,209,104,50,306,130,176,102,39
22,96904,MEMPHIS ISD,16,english,3,21,5,16,9,4,21,7,14,9,2
22,96905,TURKEY-QUITAQUE,16,english,3,10,1,9,6,3,10,3,7,4,2
22,97902,HAMILTON ISD,12,english,3,54,9,45,30,13,54,10,44,33,16
22,97903,HICO ISD,12,english,3,43,4,39,27,10,43,5,38,22,13
22,98901,GRUVER ISD,16,english,3,20,1,19,16,8,20,2,18,13,7
22,98903,PRINGLE-MORSE C,16,english,3,10,1,9,7,3,10,3,7,4,1
22,98904,SPEARMAN ISD,16,english,3,47,4,43,27,15,47,8,39,23,11
22,99902,CHILLICOTHE ISD,9,english,3,16,9,7,2,1,16,8,8,4,0
22,99903,QUANAH ISD,9,english,3,35,1,34,25,21,35,4,31,20,6
22,100903,KOUNTZE ISD,5,english,3,85,20,65,38,24,85,24,61,32,15
22,100904,SILSBEE ISD,5,english,3,223,74,149,81,42,224,86,138,56,30
22,100905,HARDIN-JEFFERSO,5,english,3,209,51,158,103,60,210,56,154,75,36
22,100907,LUMBERTON ISD,5,english,3,290,37,253,177,103,290,46,244,142,63
22,100908,WEST HARDIN COU,5,english,3,41,8,33,23,10,41,17,24,13,2
22,101802,SER-NINOS CHART,4,english,3,54,22,32,19,11,54,25,29,15,6
22,101803,ARISTOI CLASSIC,4,english,3,103,16,87,66,46,103,29,74,51,22
22,101806,RAUL YZAGUIRRE,4,english,3,63,15,48,31,19,85,16,69,39,17
22,101810,ACADEMY OF ACCE,4,english,3,95,38,57,32,16,95,49,46,28,9
22,101814,THE VARNETT PUB,4,english,3,119,47,72,40,25,118,41,77,42,18
22,101815,ALIEF MONTESSOR,4,english,3,25,4,21,19,10,25,4,21,12,8
22,101819,AMIGOS POR VIDA,4,english,3,68,12,56,37,15,68,11,57,41,19
22,101828,HOUSTON GATEWAY,4,english,3,164,16,148,111,63,164,16,148,115,67
22,101838,SOUTHWEST SCHOO,4,english,3,125,60,65,28,14,125,64,61,24,9
22,101840,TWO DIMENSIONS,4,english,3,42,19,23,17,6,42,26,16,8,5
22,101842,COMQUEST ACADEM,4,english,3,0,,,,,0,,,,
22,101845,YES PREP PUBLIC,4,english,3,142,35,107,67,38,140,43,97,57,18
22,101846,HARMONY PUBLIC,4,english,3,213,50,163,105,46,212,82,130,73,34
22,101847,BEATRICE MAYES,4,english,3,50,16,34,22,10,49,15,34,17,7
22,101849,ACCELERATED INT,4,english,3,19,2,17,9,3,19,7,12,5,3
22,101853,PROMISE COMMUNI,4,english,3,91,38,53,28,14,91,39,52,30,9
22,101855,MEYERPARK ELEME,4,english,3,48,13,35,19,9,48,27,21,3,0
22,101856,DRAW ACADEMY,4,english,3,61,26,35,12,7,61,38,23,6,4
22,101858,HARMONY PUBLIC,4,english,3,494,123,371,249,136,493,149,344,202,102
22,101859,STEP CHARTER SC,4,english,3,68,13,55,35,24,68,17,51,30,15
22,101861,THE RHODES SCHO,4,english,3,75,34,41,23,8,75,27,48,21,8
22,101862,HARMONY PUBLIC,4,english,3,290,51,239,169,114,290,60,230,153,91
22,101868,THE PRO-VISION,4,english,3,11,3,8,2,0,11,7,4,0,0
22,101870,BETA ACADEMY,4,english,3,105,9,96,64,32,106,28,78,36,14
22,101875,BLOOM ACADEMY C,4,english,3,40,21,19,13,5,40,28,12,4,3
22,101876,REVE PREPARATOR,4,english,3,24,5,19,7,1,24,9,15,3,0
22,101902,ALDINE ISD,4,english,3,3727,1498,2229,1128,495,3790,1853,1937,876,290
22,101903,ALIEF ISD,4,english,3,2550,882,1668,1037,561,3020,1331,1689,869,378
22,101905,CHANNELVIEW ISD,4,english,3,543,173,370,216,104,613,219,394,225,91
22,101906,CROSBY ISD,4,english,3,437,90,347,232,140,441,144,297,171,70
22,101907,CYPRESS-FAIRBAN,4,english,3,7981,1562,6419,4595,2820,7980,2200,5780,3407,1684
22,101908,DEER PARK ISD,4,english,3,755,137,618,429,267,753,216,537,347,174
22,101910,GALENA PARK ISD,4,english,3,968,225,743,446,231,954,270,684,380,177
22,101911,GOOSE CREEK CIS,4,english,3,1669,427,1242,806,428,1670,570,1100,639,272
22,101912,HOUSTON ISD,4,english,3,11216,3014,8202,5479,3389,11431,3919,7512,4457,2378
22,101913,HUMBLE ISD,4,english,3,3207,668,2539,1695,965,3225,961,2264,1290,607
22,101914,KATY ISD,4,english,3,6082,776,5306,4136,2794,6231,1131,5100,3553,2113
22,101915,KLEIN ISD,4,english,3,3560,662,2898,2043,1237,3588,813,2775,1791,901
22,101916,LA PORTE ISD,4,english,3,469,65,404,273,155,469,86,383,237,106
22,101917,PASADENA ISD,4,english,3,2184,524,1660,993,514,2135,772,1363,662,250
22,101919,SPRING ISD,4,english,3,1936,700,1236,720,345,2129,883,1246,609,236
22,101920,SPRING BRANCH I,4,english,3,2080,446,1634,1174,767,2183,571,1612,1097,612
22,101921,TOMBALL ISD,4,english,3,1539,137,1402,1131,835,1612,209,1403,1041,633
22,101924,SHELDON ISD,4,english,3,711,243,468,256,137,715,289,426,209,85
22,101925,HUFFMAN ISD,4,english,3,251,61,190,122,61,253,74,179,104,42
22,102901,KARNACK ISD,7,english,3,7,1,6,1,0,7,2,5,3,0
22,102902,MARSHALL ISD,7,english,3,332,116,216,142,81,362,154,208,123,65
22,102903,WASKOM ISD,7,english,3,53,13,40,28,11,53,9,44,24,8
22,102904,HALLSVILLE ISD,7,english,3,513,115,398,250,149,513,153,360,225,107
22,102905,HARLETON ISD,7,english,3,56,6,50,35,21,56,8,48,26,12
22,102906,ELYSIAN FIELDS,7,english,3,58,2,56,31,15,58,12,46,23,7
22,103901,CHANNING ISD,16,english,3,17,8,9,6,3,17,8,9,4,0
22,103902,HARTLEY ISD,16,english,3,21,2,19,12,8,21,1,20,11,7
22,104901,HASKELL CISD,14,english,3,40,6,34,21,12,40,16,24,9,4
22,104903,RULE ISD,14,english,3,7,2,5,2,1,7,5,2,0,0
22,104907,PAINT CREEK ISD,14,english,3,7,1,6,4,1,7,1,6,6,2
22,105802,TEXAS PREPARATO,13,english,3,10,3,7,5,2,11,4,7,4,0
22,105803,KI CHARTER ACAD,13,english,3,0,,,,,0,,,,
22,105902,SAN MARCOS CISD,13,english,3,535,162,373,238,137,570,258,312,160,60
22,105904,DRIPPING SPRING,13,english,3,561,37,524,400,286,566,69,497,365,198
22,105905,WIMBERLEY ISD,13,english,3,170,21,149,117,77,168,33,135,75,41
22,105906,HAYS CISD,13,english,3,1350,247,1103,750,454,1467,424,1043,610,292
22,106901,CANADIAN ISD,16,english,3,42,1,41,26,13,42,4,38,23,11
22,107901,ATHENS ISD,10,english,3,203,50,153,109,62,203,61,142,94,48
22,107902,BROWNSBORO ISD,7,english,3,173,30,143,96,61,173,34,139,89,47
22,107904,CROSS ROADS ISD,7,english,3,36,3,33,15,12,36,7,29,17,4
22,107905,EUSTACE ISD,7,english,3,105,19,86,60,29,105,28,77,32,10
22,107906,MALAKOFF ISD,7,english,3,101,8,93,62,35,101,15,86,49,25
22,107907,TRINIDAD ISD,7,english,3,8,5,3,1,0,8,4,4,1,1
22,107908,MURCHISON ISD,7,english,3,23,6,17,7,1,23,7,16,5,1
22,107910,LAPOYNOR ISD,7,english,3,27,1,26,20,7,27,1,26,11,5
22,108802,HORIZON MONTESS,1,english,3,112,32,80,52,32,112,55,57,37,20
22,108807,IDEA PUBLIC SCH,1,english,3,5722,1367,4355,2866,1577,5730,1807,3923,2175,959
22,108808,VANGUARD ACADEM,1,english,3,419,80,339,208,117,419,103,316,193,107
22,108809,EXCELLENCE IN L,1,english,3,27,9,18,13,6,27,10,17,12,7
22,108902,DONNA ISD,1,english,3,625,231,394,213,96,796,357,439,175,65
22,108903,EDCOUCH-ELSA IS,1,english,3,243,86,157,89,42,244,107,137,72,30
22,108904,EDINBURG CISD,1,english,3,2103,439,1664,1097,630,2120,516,1604,980,493
22,108905,HIDALGO ISD,1,english,3,122,17,105,79,47,151,27,124,84,34
22,108906,MCALLEN ISD,1,english,3,1212,217,995,689,425,1271,333,938,588,293
22,108907,MERCEDES ISD,1,english,3,278,112,166,93,35,291,147,144,82,29
22,108908,MISSION CISD,1,english,3,632,173,459,293,148,858,350,508,269,118
22,108909,PHARR-SAN JUAN-,1,english,3,1384,370,1014,633,336,1839,654,1185,651,290
22,108910,PROGRESO ISD,1,english,3,70,30,40,25,13,98,41,57,20,6
22,108911,SHARYLAND ISD,1,english,3,492,68,424,302,169,499,108,391,240,114
22,108912,LA JOYA ISD,1,english,3,771,178,593,377,187,1570,528,1042,571,235
22,108913,WESLACO ISD,1,english,3,1027,239,788,480,262,1028,336,692,405,184
22,108914,LA VILLA ISD,1,english,3,31,12,19,4,2,32,17,15,6,3
22,108915,MONTE ALTO ISD,1,english,3,53,19,34,19,6,53,22,31,13,4
22,108916,VALLEY VIEW ISD,1,english,3,193,29,164,101,58,201,32,169,99,41
22,109901,ABBOTT ISD,12,english,3,19,2,17,14,9,19,6,13,9,5
22,109902,BYNUM ISD,12,english,3,16,3,13,10,7,16,4,12,8,4
22,109903,COVINGTON ISD,12,english,3,25,5,20,13,8,25,7,18,6,1
22,109904,HILLSBORO ISD,12,english,3,127,26,101,59,32,128,55,73,40,21
22,109905,HUBBARD ISD,12,english,3,32,8,24,16,8,32,8,24,14,8
22,109907,ITASCA ISD,12,english,3,40,12,28,15,7,40,17,23,13,4
22,109908,MALONE ISD,12,english,3,18,7,11,7,2,18,4,14,8,2
22,109910,MOUNT CALM ISD,12,english,3,15,6,9,2,1,15,6,9,3,2
22,109911,WHITNEY ISD,12,english,3,111,27,84,44,21,111,47,64,28,10
22,109912,AQUILLA ISD,12,english,3,17,2,15,11,6,17,5,12,8,4
22,109913,BLUM ISD,12,english,3,21,3,18,14,7,21,1,20,13,7
22,109914,PENELOPE ISD,12,english,3,14,3,11,7,3,14,5,9,1,0
22,110901,ANTON ISD,17,english,3,10,0,10,7,1,10,0,10,8,2
22,110902,LEVELLAND ISD,17,english,3,180,49,131,70,40,180,60,120,64,26
22,110905,ROPES ISD,17,english,3,36,4,32,25,17,36,9,27,15,7
22,110906,SMYER ISD,17,english,3,26,3,23,14,7,26,7,19,14,6
22,110907,SUNDOWN ISD,17,english,3,33,0,33,27,12,33,0,33,26,13
22,110908,WHITHARRAL ISD,17,english,3,14,1,13,7,6,14,2,12,8,5
22,111901,GRANBURY ISD,11,english,3,582,95,487,363,243,602,123,479,314,179
22,111902,LIPAN ISD,11,english,3,26,3,23,19,9,26,2,24,20,12
22,111903,TOLAR ISD,11,english,3,61,9,52,34,18,61,13,48,33,16
22,112901,SULPHUR SPRINGS,8,english,3,278,65,213,128,69,309,116,193,96,41
22,112905,CUMBY ISD,8,english,3,30,5,25,10,6,30,13,17,8,4
22,112906,NORTH HOPKINS I,8,english,3,34,3,31,22,15,35,2,33,23,16
22,112907,MILLER GROVE IS,8,english,3,19,1,18,12,7,19,3,16,9,5
22,112908,COMO-PICKTON CI,8,english,3,43,12,31,20,9,43,16,27,17,3
22,112909,SALTILLO ISD,8,english,3,14,0,14,9,3,14,0,14,9,3
22,112910,SULPHUR BLUFF I,8,english,3,10,1,9,5,3,10,3,7,2,2
22,113901,CROCKETT ISD,6,english,3,69,28,41,20,7,69,43,26,9,4
22,113902,GRAPELAND ISD,6,english,3,40,8,32,21,9,40,5,35,22,14
22,113903,LOVELADY ISD,6,english,3,38,6,32,20,8,38,5,33,17,6
22,113905,LATEXO ISD,6,english,3,36,4,32,16,8,36,12,24,8,2
22,113906,KENNARD ISD,6,english,3,15,2,13,9,3,15,2,13,7,4
22,114901,BIG SPRING ISD,18,english,3,248,85,163,91,47,248,84,164,98,42
22,114902,COAHOMA ISD,18,english,3,82,16,66,46,23,82,15,67,37,13
22,114904,FORSAN ISD,18,english,3,50,9,41,29,20,50,10,40,16,11
22,115901,FT HANCOCK ISD,19,english,3,24,7,17,6,4,29,7,22,10,0
22,115902,SIERRA BLANCA I,19,english,3,6,3,3,1,1,6,4,2,1,1
22,115903,DELL CITY ISD,19,english,3,5,2,3,2,1,5,3,2,1,1
22,116901,CADDO MILLS ISD,10,english,3,181,16,165,118,68,181,17,164,109,55
22,116902,CELESTE ISD,10,english,3,31,10,21,11,6,31,8,23,9,4
22,116903,COMMERCE ISD,10,english,3,94,29,65,35,15,94,32,62,31,11
22,116905,GREENVILLE ISD,10,english,3,292,99,193,110,60,340,165,175,73,24
22,116906,LONE OAK ISD,10,english,3,52,7,45,31,18,52,19,33,14,6
22,116908,QUINLAN ISD,10,english,3,194,85,109,55,30,193,87,106,52,24
22,116909,WOLFE CITY ISD,10,english,3,47,3,44,29,12,47,5,42,19,10
22,116910,CAMPBELL ISD,10,english,3,24,10,14,8,4,24,14,10,1,1
22,116915,BLAND ISD,10,english,3,40,10,30,19,14,40,12,28,18,8
22,116916,BOLES ISD,10,english,3,32,7,25,14,8,32,12,20,10,3
22,117901,BORGER ISD,16,english,3,160,44,116,77,42,164,59,105,65,29
22,117903,SANFORD-FRITCH,16,english,3,55,7,48,35,16,55,12,43,25,6
22,117904,PLEMONS-STINNET,16,english,3,41,7,34,22,14,41,8,33,22,13
22,117907,SPRING CREEK IS,16,english,3,7,2,5,3,1,7,1,6,4,2
22,118902,IRION COUNTY IS,15,english,3,20,0,20,13,10,20,4,16,12,5
22,119901,BRYSON ISD,9,english,3,21,7,14,10,5,21,6,15,8,5
22,119902,JACKSBORO ISD,9,english,3,83,27,56,36,17,83,28,55,32,7
22,119903,PERRIN-WHITT CI,9,english,3,18,2,16,8,3,18,5,13,4,0
22,120901,EDNA ISD,3,english,3,101,15,86,49,28,101,22,79,46,25
22,120902,GANADO ISD,3,english,3,61,11,50,43,28,61,9,52,41,27
22,120905,INDUSTRIAL ISD,3,english,3,76,0,76,58,35,76,2,74,55,29
22,121902,BROOKELAND ISD,5,english,3,31,8,23,15,5,31,7,24,9,4
22,121903,BUNA ISD,5,english,3,100,19,81,55,36,101,28,73,38,11
22,121904,JASPER ISD,5,english,3,138,75,63,21,11,139,86,53,21,5
22,121905,KIRBYVILLE CISD,5,english,3,106,20,86,53,34,106,23,83,56,34
22,121906,EVADALE ISD,5,english,3,31,9,22,9,3,31,9,22,10,2
22,122901,FT DAVIS ISD,18,english,3,5,1,4,2,2,5,0,5,1,0
22,122902,VALENTINE ISD,18,english,3,0,,,,,0,,,,
22,123803,TEKOA ACADEMY O,5,english,3,24,15,9,5,3,24,13,11,1,0
22,123805,EHRHART SCHOOL,5,english,3,54,5,49,29,14,54,12,42,20,6
22,123807,BOB HOPE SCHOOL,5,english,3,122,21,101,57,29,126,37,89,55,30
22,123905,NEDERLAND ISD,5,english,3,401,48,353,255,145,402,69,333,207,107
22,123907,PORT ARTHUR ISD,5,english,3,587,215,372,182,87,599,279,320,148,62
22,123908,PORT NECHES-GRO,5,english,3,373,44,329,217,124,374,95,279,151,55
22,123910,BEAUMONT ISD,5,english,3,1153,547,606,332,161,1152,683,469,202,89
22,123913,SABINE PASS ISD,5,english,3,19,4,15,11,4,19,8,11,6,4
22,123914,HAMSHIRE-FANNET,5,english,3,132,13,119,79,46,132,15,117,77,31
22,124901,JIM HOGG COUNTY,1,english,3,74,22,52,33,17,74,19,55,33,11
22,125901,ALICE ISD,2,english,3,327,118,209,117,59,327,138,189,93,33
22,125902,BEN BOLT-PALITO,2,english,3,31,9,22,13,5,31,14,17,7,3
22,125903,ORANGE GROVE IS,2,english,3,119,19,100,75,51,120,19,101,68,36
22,125905,PREMONT ISD,2,english,3,38,9,29,14,5,38,17,21,10,3
22,125906,LA GLORIA ISD,2,english,3,9,2,7,6,3,9,4,5,2,0
22,126901,ALVARADO ISD,11,english,3,214,53,161,98,52,248,63,185,96,53
22,126902,BURLESON ISD,11,english,3,895,150,745,528,330,895,183,712,447,250
22,126903,CLEBURNE ISD,11,english,3,436,107,329,188,94,473,156,317,152,56
22,126904,GRANDVIEW ISD,11,english,3,80,10,70,54,29,80,8,72,51,27
22,126905,JOSHUA ISD,11,english,3,416,75,341,230,146,432,72,360,254,122
22,126906,KEENE ISD,11,english,3,59,10,49,35,22,59,11,48,28,11
22,126907,RIO VISTA ISD,11,english,3,78,20,58,31,20,78,29,49,26,8
22,126908,VENUS ISD,11,english,3,150,52,98,53,22,155,71,84,37,9
22,126911,GODLEY ISD,11,english,3,192,39,153,100,52,192,41,151,79,31
22,127901,ANSON ISD,14,english,3,61,13,48,32,12,61,18,43,19,5
22,127903,HAMLIN COLLEGIA,14,english,3,34,11,23,16,8,34,9,25,14,6
22,127904,HAWLEY ISD,14,english,3,60,14,46,31,16,60,17,43,28,10
22,127905,LUEDERS-AVOCA I,14,english,3,5,1,4,2,1,5,0,5,2,1
22,127906,STAMFORD ISD,14,english,3,44,6,38,30,16,44,8,36,19,5
22,128901,KARNES CITY ISD,20,english,3,63,9,54,31,17,63,19,44,21,9
22,128902,KENEDY ISD,3,english,3,39,10,29,17,4,39,12,27,10,3
22,128903,RUNGE ISD,3,english,3,11,7,4,1,1,11,10,1,0,0
22,128904,FALLS CITY ISD,20,english,3,30,0,30,22,15,30,3,27,21,11
22,129901,CRANDALL ISD,10,english,3,404,125,279,159,92,409,186,223,125,58
22,129902,FORNEY ISD,10,english,3,1065,250,815,540,328,1092,329,763,439,226
22,129903,KAUFMAN ISD,10,english,3,304,63,241,153,91,304,91,213,117,55
22,129904,KEMP ISD,10,english,3,133,38,95,57,27,133,50,83,44,14
22,129905,MABANK ISD,10,english,3,257,54,203,133,75,257,50,207,126,54
22,129906,TERRELL ISD,10,english,3,366,115,251,139,68,366,156,210,102,47
22,129910,SCURRY-ROSSER I,10,english,3,70,13,57,33,15,70,21,49,29,6
22,130801,MEADOWLAND CHAR,20,english,3,6,4,2,1,1,6,4,2,0,0
22,130901,BOERNE ISD,20,english,3,652,68,584,461,298,651,102,549,395,228
22,130902,COMFORT ISD,13,english,3,55,12,43,21,8,55,21,34,18,8
22,131001,KENEDY COUNTY W,2,english,3,10,4,6,3,1,10,6,4,1,1
22,132902,JAYTON-GIRARD I,17,english,3,15,0,15,12,5,15,1,14,8,3
22,133901,CENTER POINT IS,20,english,3,31,10,21,12,7,31,10,21,11,2
22,133902,HUNT ISD,20,english,3,21,1,20,11,7,21,1,20,6,3
22,133903,KERRVILLE ISD,20,english,3,336,44,292,215,134,336,57,279,186,108
22,133904,INGRAM ISD,20,english,3,74,18,56,35,15,74,14,60,35,17
22,133905,DIVIDE ISD,20,english,3,5,0,5,3,0,5,1,4,1,0
22,134901,JUNCTION ISD,15,english,3,34,6,28,19,11,33,5,28,22,10
22,135001,GUTHRIE CSD,17,english,3,7,0,7,7,3,7,0,7,6,3
22,136901,BRACKETT ISD,20,english,3,29,5,24,14,6,29,6,23,10,3
22,137901,KINGSVILLE ISD,2,english,3,209,72,137,78,45,209,82,127,70,36
22,137902,RICARDO ISD,2,english,3,60,7,53,36,18,60,6,54,38,18
22,137903,RIVIERA ISD,2,english,3,23,7,16,11,7,23,9,14,4,2
22,137904,SANTA GERTRUDIS,2,english,3,40,8,32,21,12,40,5,35,24,10
22,138902,KNOX CITY-O'BRI,9,english,3,14,1,13,8,5,14,0,14,10,4
22,138903,MUNDAY CISD,9,english,3,29,5,24,13,8,29,11,18,9,3
22,138904,BENJAMIN ISD,9,english,3,7,0,7,5,3,7,0,7,5,2
22,139905,CHISUM ISD,8,english,3,81,9,72,59,29,81,21,60,25,8
22,139909,PARIS ISD,8,english,3,258,77,181,103,55,269,106,163,75,33
22,139911,NORTH LAMAR ISD,8,english,3,154,40,114,72,42,154,55,99,58,26
22,139912,PRAIRILAND ISD,8,english,3,82,13,69,54,32,82,15,67,44,20
22,140901,AMHERST ISD,17,english,3,11,4,7,4,1,11,7,4,2,1
22,140904,LITTLEFIELD ISD,17,english,3,87,21,66,30,14,87,27,60,30,9
22,140905,OLTON ISD,17,english,3,48,5,43,32,21,48,19,29,11,6
22,140907,SPRINGLAKE-EART,17,english,3,19,2,17,13,9,19,4,15,11,6
22,140908,SUDAN ISD,17,english,3,38,4,34,19,9,38,7,31,22,14
22,141901,LAMPASAS ISD,12,english,3,237,46,191,136,72,237,46,191,111,39
22,141902,LOMETA ISD,12,english,3,22,10,12,6,1,22,14,8,1,0
22,142901,COTULLA ISD,20,english,3,79,35,44,24,11,79,31,48,17,6
22,143901,HALLETTSVILLE I,3,english,3,81,14,67,43,25,81,10,71,53,25
22,143902,MOULTON ISD,3,english,3,19,6,13,9,5,19,5,14,10,5
22,143903,SHINER ISD,3,english,3,49,6,43,31,21,49,4,45,34,22
22,143904,VYSEHRAD ISD,3,english,3,7,1,6,6,2,7,0,7,5,4
22,143905,SWEET HOME ISD,3,english,3,13,2,11,9,6,13,1,12,8,1
22,143906,EZZELL ISD,3,english,3,8,0,8,7,3,8,0,8,5,3
22,144901,GIDDINGS ISD,13,english,3,120,22,98,56,31,120,24,96,51,17
22,144902,LEXINGTON ISD,13,english,3,85,18,67,44,22,86,17,69,41,11
22,144903,DIME BOX ISD,13,english,3,15,5,10,3,2,15,8,7,3,0
22,145901,BUFFALO ISD,6,english,3,59,4,55,42,25,59,12,47,26,11
22,145902,CENTERVILLE ISD,6,english,3,49,3,46,26,13,49,17,32,12,4
22,145906,NORMANGEE ISD,6,english,3,42,13,29,21,13,42,15,27,12,3
22,145907,OAKWOOD ISD,6,english,3,19,5,14,9,3,19,8,11,7,1
22,145911,LEON ISD,6,english,3,48,5,43,23,12,48,9,39,23,7
22,146901,CLEVELAND ISD,4,english,3,568,219,349,159,70,834,457,377,139,36
22,146902,DAYTON ISD,4,english,3,353,86,267,149,79,382,132,250,104,51
22,146903,DEVERS ISD,4,english,3,21,0,21,19,15,21,0,21,17,12
22,146904,HARDIN ISD,5,english,3,97,18,79,56,30,97,28,69,38,19
22,146905,HULL-DAISETTA I,5,english,3,36,16,20,9,5,36,21,15,10,6
22,146906,LIBERTY ISD,5,english,3,173,46,127,81,40,174,52,122,74,27
22,146907,TARKINGTON ISD,4,english,3,143,34,109,73,41,143,34,109,65,32
22,147901,COOLIDGE ISD,12,english,3,21,0,21,14,9,21,1,20,16,12
22,147902,GROESBECK ISD,12,english,3,110,21,89,54,27,110,30,80,45,24
22,147903,MEXIA ISD,12,english,3,121,34,87,50,23,121,58,63,23,13
22,148901,BOOKER ISD,16,english,3,22,4,18,12,6,22,3,19,7,4
22,148902,FOLLETT ISD,16,english,3,11,2,9,5,1,11,4,7,5,2
22,148905,DARROUZETT ISD,16,english,3,12,6,6,0,0,12,10,2,1,0
22,149901,GEORGE WEST ISD,2,english,3,79,8,71,59,41,79,4,75,65,42
22,149902,THREE RIVERS IS,2,english,3,42,8,34,18,6,42,10,32,19,6
22,150901,LLANO ISD,13,english,3,126,24,102,59,30,126,36,90,53,22
22,152504,TEXAS TECH UNIV,17,english,3,7,0,7,5,4,7,1,6,3,2
22,152802,RISE ACADEMY,17,english,3,31,1,30,24,13,31,5,26,9,5
22,152806,BETTY M CONDRA,17,english,3,29,14,15,7,6,29,21,8,4,2
22,152901,LUBBOCK ISD,17,english,3,1681,368,1313,852,487,1702,489,1213,691,350
22,152902,NEW DEAL ISD,17,english,3,43,13,30,16,8,43,19,24,11,4
22,152903,SLATON ISD,17,english,3,80,19,61,43,24,80,29,51,24,13
22,152906,LUBBOCK-COOPER,17,english,3,550,75,475,333,208,565,105,460,300,179
22,152907,FRENSHIP ISD,17,english,3,798,109,689,501,312,815,152,663,440,222
22,152908,ROOSEVELT ISD,17,english,3,63,19,44,23,6,63,19,44,14,8
22,152909,SHALLOWATER ISD,17,english,3,121,5,116,98,67,121,14,107,81,42
22,152910,IDALOU ISD,17,english,3,74,5,69,59,49,74,2,72,64,37
22,153903,O'DONNELL ISD,17,english,3,26,9,17,9,5,26,14,12,3,0
22,153904,TAHOKA ISD,17,english,3,33,10,23,20,15,33,10,23,18,13
22,153905,NEW HOME ISD,17,english,3,42,0,42,37,30,42,0,42,38,26
22,153907,WILSON ISD,17,english,3,8,2,6,2,0,8,4,4,0,0
22,154901,MADISONVILLE CI,6,english,3,179,31,148,90,49,179,41,138,75,34
22,154903,NORTH ZULCH ISD,6,english,3,28,3,25,17,7,28,9,19,11,4
22,155901,JEFFERSON ISD,8,english,3,77,14,63,44,27,77,17,60,36,15
22,156902,STANTON ISD,18,english,3,88,18,70,45,27,88,22,66,32,13
22,156905,GRADY ISD,18,english,3,22,0,22,20,14,22,1,21,15,9
22,157901,MASON ISD,15,english,3,47,5,42,35,24,47,5,42,34,20
22,158901,BAY CITY ISD,3,english,3,227,105,122,64,33,227,106,121,66,30
22,158902,TIDEHAVEN ISD,3,english,3,66,4,62,47,30,66,5,61,44,26
22,158904,MATAGORDA ISD,3,english,3,11,3,8,5,1,11,3,8,5,3
22,158905,PALACIOS ISD,3,english,3,94,23,71,46,26,94,24,70,44,20
22,158906,VAN VLECK ISD,3,english,3,73,9,64,47,26,73,10,63,48,31
22,159901,EAGLE PASS ISD,20,english,3,882,233,649,376,195,897,310,587,305,142
22,160901,BRADY ISD,15,english,3,64,8,56,32,22,64,20,44,20,10
22,160904,ROCHELLE ISD,15,english,3,14,1,13,10,7,14,0,14,10,6
22,160905,LOHN ISD,15,english,3,15,5,10,6,4,15,5,10,2,1
22,161801,WACO CHARTER SC,12,english,3,28,14,14,4,2,28,22,6,3,2
22,161802,RAPOPORT ACADEM,12,english,3,66,36,30,17,6,66,42,24,8,3
22,161807,HARMONY PUBLIC,12,english,3,706,199,507,317,183,711,257,454,254,132
22,161901,CRAWFORD ISD,12,english,3,51,5,46,34,26,51,7,44,26,9
22,161903,MIDWAY ISD,12,english,3,596,77,519,389,259,596,83,513,352,209
22,161906,LA VEGA ISD,12,english,3,178,31,147,88,40,188,52,136,73,20
22,161907,LORENA ISD,12,english,3,145,10,135,102,71,145,13,132,84,47
22,161908,MART ISD,12,english,3,40,8,32,16,10,40,11,29,15,8
22,161909,MCGREGOR ISD,12,english,3,102,25,77,47,20,102,28,74,34,10
22,161910,MOODY ISD,12,english,3,46,4,42,29,20,46,12,34,25,11
22,161912,RIESEL ISD,12,english,3,44,8,36,21,15,44,10,34,22,10
22,161914,WACO ISD,12,english,3,1013,477,536,268,137,1010,583,427,191,66
22,161916,WEST ISD,12,english,3,83,16,67,43,28,83,18,65,40,22
22,161918,AXTELL ISD,12,english,3,56,6,50,28,14,56,13,43,16,5
22,161919,BRUCEVILLE-EDDY,12,english,3,37,7,30,14,9,37,11,26,11,3
22,161920,CHINA SPRING IS,12,english,3,238,35,203,157,100,238,44,194,135,64
22,161921,CONNALLY ISD,12,english,3,163,61,102,46,22,165,70,95,41,17
22,161922,ROBINSON ISD,12,english,3,165,26,139,94,68,165,36,129,75,37
22,161923,BOSQUEVILLE ISD,12,english,3,55,5,50,34,17,55,11,44,21,8
22,161924,HALLSBURG ISD,12,english,3,19,1,18,10,3,19,5,14,8,1
22,161925,GHOLSON ISD,12,english,3,9,4,5,2,0,9,8,1,1,0
22,162904,MCMULLEN COUNTY,2,english,3,16,3,13,11,8,16,2,14,11,6
22,163901,DEVINE ISD,20,english,3,126,22,104,65,38,126,29,97,53,23
22,163902,D'HANIS ISD,20,english,3,13,0,13,13,10,13,1,12,10,7
22,163903,NATALIA ISD,20,english,3,61,25,36,22,16,61,26,35,18,6
22,163904,HONDO ISD,20,english,3,129,42,87,48,24,127,57,70,36,10
22,163908,MEDINA VALLEY I,20,english,3,519,93,426,308,193,522,130,392,239,120
22,164901,MENARD ISD,15,english,3,15,4,11,8,2,14,5,9,4,0
22,165802,MIDLAND ACADEMY,18,english,3,52,5,47,34,25,52,7,45,32,12
22,165901,MIDLAND ISD,18,english,3,1864,471,1393,900,530,1874,553,1321,810,366
22,165902,GREENWOOD ISD,18,english,3,220,35,185,114,70,220,38,182,129,59
22,166901,CAMERON ISD,6,english,3,96,21,75,38,17,96,29,67,25,8
22,166902,GAUSE ISD,6,english,3,14,1,13,12,3,14,3,11,5,5
22,166903,MILANO ISD,6,english,3,30,0,30,24,12,30,0,30,25,15
22,166904,ROCKDALE ISD,6,english,3,76,14,62,34,12,76,29,47,25,9
22,166905,THORNDALE ISD,13,english,3,46,15,31,15,6,46,19,27,10,2
22,166907,BUCKHOLTS ISD,12,english,3,14,8,6,2,0,14,11,3,1,0
22,167901,GOLDTHWAITE ISD,12,english,3,38,2,36,27,19,38,4,34,31,16
22,167902,MULLIN ISD,12,english,3,7,3,4,3,3,7,2,5,3,0
22,167904,PRIDDY ISD,12,english,3,5,2,3,1,1,5,2,3,0,0
22,168901,COLORADO ISD,14,english,3,44,9,35,19,11,44,18,26,15,4
22,168902,LORAINE ISD,14,english,3,12,2,10,5,3,12,3,9,3,3
22,168903,WESTBROOK ISD,14,english,3,17,9,8,4,2,17,8,9,1,0
22,169901,BOWIE ISD,9,english,3,126,49,77,44,23,126,50,76,25,9
22,169902,NOCONA ISD,9,english,3,53,13,40,29,20,53,11,42,23,7
22,169906,GOLD BURG ISD,9,english,3,7,1,6,5,2,7,1,6,1,0
22,169908,MONTAGUE ISD,9,english,3,15,0,15,9,6,16,1,15,8,5
22,169909,PRAIRIE VALLEY,9,english,3,11,0,11,7,2,11,3,8,3,2
22,169910,FORESTBURG ISD,9,english,3,10,2,8,4,2,10,4,6,0,0
22,169911,SAINT JO ISD,9,english,3,19,4,15,12,5,19,6,13,8,7
22,170801,TEXAS SERENITY,6,english,3,36,26,10,5,3,35,31,4,1,0
22,170902,CONROE ISD,6,english,3,4497,705,3792,2841,1900,4554,821,3733,2659,1583
22,170903,MONTGOMERY ISD,6,english,3,639,54,585,472,307,641,82,559,375,206
22,170904,WILLIS ISD,6,english,3,590,135,455,292,173,604,168,436,220,92
22,170906,MAGNOLIA ISD,6,english,3,825,114,711,506,317,913,177,736,464,249
22,170907,SPLENDORA ISD,6,english,3,333,99,234,130,59,333,118,215,80,36
22,170908,NEW CANEY ISD,6,english,3,1139,359,780,474,259,1135,466,669,355,145
22,171901,DUMAS ISD,16,english,3,297,71,226,153,69,297,69,228,164,80
22,171902,SUNRAY COLLEGIA,16,english,3,33,4,29,22,10,33,1,32,23,14
22,172902,DAINGERFIELD-LO,8,english,3,73,15,58,24,11,73,25,48,22,6
22,172905,PEWITT CISD,8,english,3,43,3,40,34,15,43,2,41,29,11
22,173901,MOTLEY COUNTY I,17,english,3,10,1,9,8,6,10,1,9,5,2
22,174801,STEPHEN F AUSTI,7,english,3,44,1,43,39,31,44,3,41,34,23
22,174901,CHIRENO ISD,7,english,3,27,9,18,8,3,27,11,16,5,1
22,174902,CUSHING ISD,7,english,3,41,10,31,20,10,41,14,27,12,4
22,174903,GARRISON ISD,7,english,3,54,6,48,38,25,54,15,39,17,4
22,174904,NACOGDOCHES ISD,7,english,3,395,176,219,117,52,396,187,209,109,39
22,174906,WODEN ISD,7,english,3,52,4,48,23,16,52,12,40,21,12
22,174908,CENTRAL HEIGHTS,7,english,3,89,10,79,58,30,89,14,75,44,18
22,174909,MARTINSVILLE IS,7,english,3,17,3,14,10,4,17,8,9,0,0
22,174910,ETOILE ISD,7,english,3,10,4,6,6,1,10,4,6,2,1
22,174911,DOUGLASS ISD,7,english,3,29,3,26,22,11,31,6,25,20,12
22,175902,BLOOMING GROVE,12,english,3,54,9,45,28,12,54,19,35,18,7
22,175903,CORSICANA ISD,12,english,3,435,109,326,198,111,455,135,320,166,62
22,175904,DAWSON ISD,12,english,3,29,4,25,17,6,29,5,24,9,5
22,175905,FROST ISD,12,english,3,22,5,17,9,6,22,5,17,10,4
22,175907,KERENS ISD,12,english,3,32,7,25,11,7,31,10,21,7,3
22,175910,MILDRED ISD,12,english,3,54,12,42,31,17,54,9,45,27,16
22,175911,RICE ISD,12,english,3,60,19,41,21,12,60,22,38,22,13
22,176901,BURKEVILLE ISD,5,english,3,16,10,6,1,1,16,7,9,2,0
22,176902,NEWTON ISD,5,english,3,65,17,48,26,17,65,28,37,15,4
22,176903,DEWEYVILLE ISD,5,english,3,39,11,28,17,11,39,16,23,10,2
22,177901,ROSCOE COLLEGIA,14,english,3,573,271,302,147,70,575,368,207,62,24
22,177902,SWEETWATER ISD,14,english,3,124,49,75,45,27,124,46,78,43,18
22,177903,BLACKWELL CISD,14,english,3,11,0,11,8,4,11,1,10,5,1
22,177905,HIGHLAND ISD,14,english,3,9,0,9,7,2,9,0,9,7,4
22,178801,DR M L GARZA-GO,2,english,3,19,5,14,5,4,19,9,10,4,0
22,178807,CORPUS CHRISTI,2,english,3,17,3,14,12,8,17,8,9,0,0
22,178808,SEASHORE CHARTE,2,english,3,56,6,50,39,32,56,14,42,23,10
22,178901,AGUA DULCE ISD,2,english,3,22,1,21,17,9,22,6,16,11,7
22,178902,BISHOP CISD,2,english,3,86,19,67,45,30,86,19,67,42,18
22,178903,CALALLEN ISD,2,english,3,273,45,228,158,88,273,63,210,128,72
22,178904,CORPUS CHRISTI,2,english,3,2277,590,1687,1091,600,2289,750,1539,883,380
22,178905,DRISCOLL ISD,2,english,3,38,3,35,20,9,38,12,26,11,1
22,178906,LONDON ISD,2,english,3,89,10,79,63,41,89,13,76,55,31
22,178908,PORT ARANSAS IS,2,english,3,39,11,28,21,14,39,7,32,20,9
22,178909,ROBSTOWN ISD,2,english,3,169,63,106,61,31,170,70,100,43,14
22,178912,TULOSO-MIDWAY I,2,english,3,284,58,226,144,93,279,89,190,95,42
22,178913,BANQUETE ISD,2,english,3,60,6,54,37,20,60,17,43,27,12
22,178914,FLOUR BLUFF ISD,2,english,3,383,50,333,225,127,383,85,298,196,95
22,178915,WEST OSO ISD,2,english,3,118,29,89,47,26,119,41,78,32,13
22,179901,PERRYTON ISD,16,english,3,128,19,109,67,28,128,26,102,69,34
22,180901,BOYS RANCH ISD,16,english,3,6,0,6,3,2,6,1,5,2,1
22,180902,VEGA ISD,16,english,3,26,1,25,24,20,26,0,26,23,13
22,180903,ADRIAN ISD,16,english,3,9,1,8,4,3,9,3,6,3,0
22,180904,WILDORADO ISD,16,english,3,22,5,17,12,7,22,5,17,11,5
22,181901,BRIDGE CITY ISD,5,english,3,206,31,175,115,75,206,34,172,107,51
22,181905,ORANGEFIELD ISD,5,english,3,132,27,105,78,46,132,24,108,62,29
22,181906,WEST ORANGE-COV,5,english,3,182,81,101,45,17,182,120,62,17,2
22,181907,VIDOR ISD,5,english,3,316,86,230,133,79,316,102,214,131,64
22,181908,LITTLE CYPRESS-,5,english,3,241,63,178,112,63,241,71,170,97,37
22,182901,GORDON ISD,11,english,3,13,1,12,8,5,13,5,8,3,0
22,182902,GRAFORD ISD,11,english,3,18,8,10,5,4,18,5,13,7,3
22,182903,MINERAL WELLS I,11,english,3,216,51,165,107,51,228,83,145,89,30
22,182904,SANTO ISD,11,english,3,36,1,35,24,18,36,9,27,22,9
22,182905,STRAWN ISD,11,english,3,9,1,8,6,2,9,1,8,5,2
22,182906,PALO PINTO ISD,11,english,3,10,1,9,8,6,10,0,10,8,4
22,183901,BECKVILLE ISD,7,english,3,42,3,39,25,11,42,5,37,29,14
22,183902,CARTHAGE ISD,7,english,3,175,29,146,86,55,175,32,143,89,36
22,183904,GARY ISD,7,english,3,38,7,31,21,13,38,12,26,13,6
22,184901,POOLVILLE ISD,11,english,3,43,3,40,31,21,43,2,41,33,18
22,184902,SPRINGTOWN ISD,11,english,3,281,53,228,144,94,281,60,221,136,75
22,184903,WEATHERFORD ISD,11,english,3,555,122,433,286,165,561,163,398,227,105
22,184904,MILLSAP ISD,11,english,3,81,27,54,30,19,81,30,51,25,9
22,184907,ALEDO ISD,11,english,3,554,36,518,444,337,560,55,505,389,239
22,184908,PEASTER ISD,11,english,3,134,33,101,66,40,134,35,99,56,30
22,184909,BROCK ISD,11,english,3,175,22,153,125,73,175,28,147,112,58
22,184911,GARNER ISD,11,english,3,22,8,14,9,7,22,7,15,10,4
22,185901,BOVINA ISD,16,english,3,31,10,21,13,9,31,10,21,11,5
22,185902,FARWELL ISD,16,english,3,39,3,36,31,11,39,4,35,29,16
22,185903,FRIONA ISD,16,english,3,86,37,49,23,10,86,47,39,12,2
22,185904,LAZBUDDIE ISD,16,english,3,7,0,7,4,1,7,3,4,2,0
22,186901,BUENA VISTA ISD,18,english,3,19,3,16,8,4,19,1,18,9,6
22,186902,FORT STOCKTON I,18,english,3,141,33,108,59,28,141,57,84,42,16
22,186903,IRAAN-SHEFFIELD,18,english,3,23,9,14,6,4,23,9,14,8,4
22,187901,BIG SANDY ISD,6,english,3,33,1,32,17,7,33,3,30,20,5
22,187903,GOODRICH ISD,6,english,3,21,8,13,7,4,21,10,11,4,2
22,187904,CORRIGAN-CAMDEN,6,english,3,57,10,47,30,15,57,15,42,19,8
22,187906,LEGGETT ISD,6,english,3,15,8,7,3,1,16,9,7,1,0
22,187907,LIVINGSTON ISD,6,english,3,307,46,261,183,107,307,46,261,181,85
22,187910,ONALASKA ISD,6,english,3,95,16,79,47,30,95,17,78,38,17
22,188901,AMARILLO ISD,16,english,3,2134,425,1709,1139,636,2219,576,1643,988,464
22,188902,RIVER ROAD ISD,16,english,3,83,28,55,32,17,83,29,54,34,15
22,188903,HIGHLAND PARK I,16,english,3,56,8,48,30,17,56,14,42,21,8
22,188904,BUSHLAND ISD,16,english,3,110,7,103,85,59,110,6,104,76,40
22,189901,MARFA ISD,18,english,3,19,3,16,10,3,19,9,10,5,0
22,189902,PRESIDIO ISD,18,english,3,52,25,27,14,8,52,23,29,14,6
22,190903,RAINS ISD,7,english,3,124,21,103,58,28,124,53,71,31,10
22,191901,CANYON ISD,16,english,3,810,91,719,519,333,810,121,689,464,223
22,192901,REAGAN COUNTY I,18,english,3,60,14,46,28,13,60,21,39,19,10
22,193801,BIG SPRINGS CHA,20,english,3,7,4,3,1,1,8,8,0,0,0
22,193902,LEAKEY ISD,20,english,3,17,4,13,6,2,17,6,11,4,1
22,194902,AVERY ISD,8,english,3,30,5,25,17,12,30,3,27,18,8
22,194903,RIVERCREST ISD,8,english,3,43,8,35,20,12,43,14,29,11,6
22,194904,CLARKSVILLE ISD,8,english,3,36,11,25,13,6,36,16,20,7,2
22,194905,DETROIT ISD,8,english,3,33,4,29,15,8,35,6,29,18,4
22,195901,PECOS-BARSTOW-T,18,english,3,185,72,113,57,26,187,75,112,47,20
22,195902,BALMORHEA ISD,18,english,3,0,,,,,0,,,,
22,196901,AUSTWELL-TIVOLI,3,english,3,14,4,10,7,4,14,4,10,5,4
22,196902,WOODSBORO ISD,3,english,3,27,9,18,12,7,27,12,15,7,4
22,196903,REFUGIO ISD,3,english,3,44,10,34,20,9,45,24,21,5,2
22,197902,MIAMI ISD,16,english,3,12,1,11,5,4,12,4,8,1,1
22,198901,BREMOND ISD,6,english,3,34,8,26,14,10,34,12,22,13,6
22,198902,CALVERT ISD,6,english,3,7,4,3,0,0,7,4,3,0,0
22,198903,FRANKLIN ISD,6,english,3,94,4,90,70,49,94,6,88,64,35
22,198905,HEARNE ISD,6,english,3,36,16,20,12,5,36,23,13,4,1
22,198906,MUMFORD ISD,6,english,3,40,0,40,35,18,40,0,40,30,16
22,199901,ROCKWALL ISD,10,english,3,1218,162,1056,803,538,1227,210,1017,737,419
22,199902,ROYSE CITY ISD,10,english,3,561,97,464,312,173,567,114,453,283,147
22,200901,BALLINGER ISD,15,english,3,45,8,37,21,12,45,16,29,15,7
22,200902,MILES ISD,15,english,3,32,3,29,24,14,32,3,29,25,15
22,200904,WINTERS ISD,15,english,3,36,4,32,19,15,36,7,29,14,7
22,200906,OLFEN ISD,15,english,3,7,1,6,6,3,7,2,5,2,1
22,201902,HENDERSON ISD,7,english,3,233,86,147,71,39,233,115,118,51,21
22,201903,LANEVILLE ISD,7,english,3,7,2,5,4,1,7,2,5,1,1
22,201904,LEVERETTS CHAPE,7,english,3,13,2,11,8,4,13,2,11,9,5
22,201907,MOUNT ENTERPRIS,7,english,3,36,5,31,20,12,36,9,27,11,4
22,201908,OVERTON ISD,7,english,3,31,3,28,19,11,32,4,28,17,10
22,201910,TATUM ISD,7,english,3,92,12,80,55,27,92,14,78,55,26
22,201913,CARLISLE ISD,7,english,3,36,5,31,20,10,36,9,27,14,6
22,201914,WEST RUSK COUNT,7,english,3,66,16,50,28,7,66,27,39,17,3
22,202903,HEMPHILL ISD,7,english,3,56,11,45,25,12,56,14,42,20,2
22,202905,WEST SABINE ISD,7,english,3,36,8,28,16,9,36,13,23,14,8
22,203901,SAN AUGUSTINE I,7,english,3,41,19,22,11,6,41,22,19,6,3
22,203902,BROADDUS ISD,7,english,3,20,5,15,10,9,20,4,16,10,6
22,204901,COLDSPRING-OAKH,6,english,3,93,25,68,42,22,94,38,56,23,12
22,204904,SHEPHERD ISD,6,english,3,140,50,90,50,23,140,55,85,44,13
22,205901,ARANSAS PASS IS,2,english,3,117,32,85,41,16,117,57,60,26,5
22,205902,GREGORY-PORTLAN,2,english,3,363,64,299,190,111,362,76,286,167,78
22,205903,INGLESIDE ISD,2,english,3,133,26,107,75,42,133,27,106,55,21
22,205904,MATHIS ISD,2,english,3,95,19,76,51,28,95,24,71,37,12
22,205905,ODEM-EDROY ISD,2,english,3,58,14,44,26,17,58,26,32,16,8
22,205906,SINTON ISD,2,english,3,148,36,112,73,50,148,40,108,67,35
22,205907,TAFT ISD,2,english,3,56,22,34,17,6,56,27,29,15,6
22,206901,SAN SABA ISD,15,english,3,53,5,48,31,16,53,16,37,18,4
22,206902,RICHLAND SPRING,15,english,3,5,0,5,1,1,5,2,3,1,0
22,206903,CHEROKEE ISD,15,english,3,7,0,7,6,5,7,2,5,3,3
22,207901,SCHLEICHER ISD,15,english,3,36,8,28,16,9,36,6,30,19,11
22,208901,HERMLEIGH ISD,14,english,3,11,4,7,5,3,11,6,5,2,1
22,208902,SNYDER ISD,14,english,3,144,31,113,64,37,166,33,133,86,43
22,208903,IRA ISD,14,english,3,21,0,21,14,9,21,1,20,11,5
22,209901,ALBANY ISD,14,english,3,41,11,30,19,13,41,13,28,12,6
22,209902,MORAN ISD,14,english,3,6,1,5,4,4,6,1,5,3,2
22,210901,CENTER ISD,7,english,3,195,52,143,83,39,195,53,142,67,36
22,210902,JOAQUIN ISD,7,english,3,44,4,40,23,8,44,3,41,30,16
22,210903,SHELBYVILLE ISD,7,english,3,54,3,51,34,22,54,6,48,28,15
22,210904,TENAHA ISD,7,english,3,28,3,25,19,7,28,5,23,17,10
22,210905,TIMPSON ISD,7,english,3,37,5,32,18,6,37,16,21,9,2
22,210906,EXCELSIOR ISD,7,english,3,5,3,2,1,1,5,3,2,0,0
22,211901,TEXHOMA ISD,16,english,3,16,1,15,12,8,16,3,13,11,6
22,211902,STRATFORD ISD,16,english,3,33,10,23,18,10,33,13,20,13,6
22,212801,CUMBERLAND ACAD,7,english,3,136,32,104,59,32,136,66,70,23,9
22,212804,UT TYLER UNIVER,7,english,3,83,13,70,48,34,83,18,65,39,19
22,212901,ARP ISD,7,english,3,66,11,55,43,29,66,10,56,32,14
22,212902,BULLARD ISD,7,english,3,191,13,178,131,90,191,30,161,110,57
22,212903,LINDALE ISD,7,english,3,306,30,276,229,154,306,30,276,223,140
22,212904,TROUP ISD,7,english,3,67,10,57,35,24,67,18,49,38,15
22,212905,TYLER ISD,7,english,3,1283,353,930,580,312,1327,407,920,547,268
22,212906,WHITEHOUSE ISD,7,english,3,363,44,319,237,136,363,48,315,224,122
22,212909,CHAPEL HILL ISD,7,english,3,198,52,146,102,64,258,91,167,101,51
22,212910,WINONA ISD,7,english,3,65,20,45,26,17,65,22,43,23,10
22,213801,BRAZOS RIVER CH,11,english,3,0,,,,,0,,,,
22,213901,GLEN ROSE ISD,11,english,3,148,20,128,95,63,149,31,118,77,46
22,214901,RIO GRANDE CITY,1,english,3,613,198,415,228,123,613,249,364,190,78
22,214902,SAN ISIDRO ISD,1,english,3,10,0,10,4,2,10,4,6,1,0
22,214903,ROMA ISD,1,english,3,391,45,346,267,175,390,63,327,251,145
22,215901,BRECKENRIDGE IS,14,english,3,88,17,71,38,19,88,14,74,40,29
22,216901,STERLING CITY I,15,english,3,19,2,17,12,6,19,6,13,6,4
22,217901,ASPERMONT ISD,14,english,3,14,2,12,8,8,14,4,10,8,5
22,218901,SONORA ISD,15,english,3,54,4,50,40,25,54,12,42,23,13
22,219901,HAPPY ISD,16,english,3,18,3,15,11,8,18,5,13,9,3
22,219903,TULIA ISD,16,english,3,65,23,42,19,11,65,27,38,11,5
22,219905,KRESS ISD,16,english,3,15,4,11,2,2,15,7,8,2,0
22,220801,TREETOPS SCHOOL,11,english,3,21,1,20,17,9,21,1,20,17,11
22,220802,ARLINGTON CLASS,11,english,3,175,12,163,133,95,175,15,160,118,81
22,220809,FORT WORTH ACAD,11,english,3,38,0,38,35,25,38,1,37,24,13
22,220810,WESTLAKE ACADEM,11,english,3,61,3,58,53,38,62,4,58,45,22
22,220811,EAST FORT WORTH,11,english,3,28,6,22,15,9,28,12,16,7,0
22,220814,TEXAS SCHOOL OF,11,english,3,28,2,26,22,13,28,5,23,17,11
22,220815,CHAPEL HILL ACA,11,english,3,63,29,34,18,13,63,25,38,26,13
22,220817,NEWMAN INTERNAT,11,english,3,226,59,167,103,58,227,60,167,77,28
22,220819,HIGH POINT ACAD,11,english,3,138,27,111,79,46,138,30,108,66,31
22,220901,ARLINGTON ISD,11,english,3,3352,992,2360,1468,830,3573,1368,2205,1168,517
22,220902,BIRDVILLE ISD,11,english,3,1376,284,1092,761,485,1341,383,958,600,308
22,220904,EVERMAN ISD,11,english,3,304,87,217,128,81,321,97,224,114,47
22,220905,FORT WORTH ISD,11,english,3,4358,1491,2867,1648,872,5044,2291,2753,1345,585
22,220906,GRAPEVINE-COLLE,11,english,3,855,109,746,576,409,818,152,666,467,279
22,220907,KELLER ISD,11,english,3,2327,362,1965,1450,934,2394,499,1895,1297,700
22,220908,MANSFIELD ISD,11,english,3,2311,382,1929,1373,869,2319,506,1813,1132,612
22,220910,LAKE WORTH ISD,11,english,3,195,100,95,44,17,229,120,109,51,18
22,220912,CROWLEY ISD,11,english,3,942,283,659,409,205,1061,414,647,364,173
22,220914,KENNEDALE ISD,11,english,3,174,47,127,84,57,174,58,116,73,40
22,220915,AZLE ISD,11,english,3,514,101,413,273,167,514,112,402,244,113
22,220916,HURST-EULESS-BE,11,english,3,1547,210,1337,993,636,1552,292,1260,840,442
22,220917,CASTLEBERRY ISD,11,english,3,197,55,142,85,43,255,89,166,86,33
22,220918,EAGLE MT-SAGINA,11,english,3,1538,393,1145,750,404,1606,519,1087,582,229
22,220919,CARROLL ISD,11,english,3,568,12,556,509,411,568,22,546,476,351
22,220920,WHITE SETTLEMEN,11,english,3,456,103,353,234,144,458,140,318,190,99
22,221801,TEXAS COLLEGE P,14,english,3,1350,266,1084,748,452,1348,398,950,508,203
22,221901,ABILENE ISD,14,english,3,1066,334,732,430,225,1073,414,659,335,142
22,221904,MERKEL ISD,14,english,3,78,27,51,32,14,78,34,44,21,6
22,221905,TRENT ISD,14,english,3,9,3,6,6,3,9,3,6,2,0
22,221911,JIM NED CISD,14,english,3,0,,,,,123,15,108,74,34
22,221912,WYLIE ISD,14,english,3,364,44,320,245,151,365,50,315,222,127
22,222901,TERRELL COUNTY,18,english,3,9,2,7,5,2,9,1,8,4,1
22,223901,BROWNFIELD ISD,17,english,3,94,51,43,26,10,94,48,46,20,7
22,223902,MEADOW ISD,17,english,3,22,6,16,10,4,22,7,15,6,5
22,223904,WELLMAN-UNION C,17,english,3,22,3,19,15,12,22,2,20,12,5
22,224901,THROCKMORTON CO,9,english,3,11,4,7,3,2,11,5,6,5,1
22,224902,WOODSON ISD,9,english,3,7,3,4,3,1,7,4,3,1,0
22,225902,MOUNT PLEASANT,8,english,3,218,35,183,135,70,324,74,250,143,66
22,225906,CHAPEL HILL ISD,8,english,3,83,4,79,65,39,83,12,71,39,13
22,225907,HARTS BLUFF ISD,8,english,3,63,18,45,24,10,77,36,41,21,11
22,226801,TEXAS LEADERSHI,15,english,3,278,102,176,93,50,278,130,148,53,24
22,226901,CHRISTOVAL ISD,15,english,3,34,1,33,28,22,34,3,31,24,9
22,226903,SAN ANGELO ISD,15,english,3,1065,317,748,454,270,1065,421,644,353,154
22,226905,WATER VALLEY IS,15,english,3,11,2,9,6,6,11,2,9,7,2
22,226906,WALL ISD,15,english,3,106,5,101,80,54,106,8,98,71,45
22,226907,GRAPE CREEK ISD,15,english,3,67,20,47,33,20,67,27,40,19,10
22,226908,VERIBEST ISD,15,english,3,16,5,11,6,2,16,8,8,2,1
22,227803,WAYSIDE SCHOOLS,13,english,3,93,26,67,38,20,134,52,82,38,13
22,227804,NYOS CHARTER SC,13,english,3,143,21,122,96,68,143,24,119,80,47
22,227805,TEXAS EMPOWERME,13,english,3,30,12,18,8,5,31,26,5,2,2
22,227806,UNIVERSITY OF T,13,english,3,10,9,1,1,1,10,9,1,0,0
22,227814,CHAPARRAL STAR,13,english,3,26,1,25,19,10,26,2,24,17,9
22,227816,HARMONY PUBLIC,13,english,3,311,71,240,166,119,310,82,228,147,79
22,227817,CEDARS INTERNAT,13,english,3,33,15,18,8,4,33,16,17,6,3
22,227819,UNIVERSITY OF T,13,english,3,44,5,39,29,20,44,9,35,22,11
22,227820,KIPP TEXAS PUBL,4,english,3,2249,807,1442,870,500,2258,964,1294,659,287
22,227821,AUSTIN DISCOVER,13,english,3,47,7,40,27,17,47,22,25,12,6
22,227824,VALERE PUBLIC S,13,english,3,69,17,52,34,15,69,25,44,20,4
22,227825,AUSTIN ACHIEVE,13,english,3,145,80,65,29,13,145,50,95,45,17
22,227826,MONTESSORI FOR,13,english,3,56,10,46,31,21,57,21,36,14,6
22,227829,VALOR PUBLIC SC,13,english,3,144,20,124,96,66,144,32,112,65,28
22,227901,AUSTIN ISD,13,english,3,4391,858,3533,2660,1858,5001,1476,3525,2263,1292
22,227904,PFLUGERVILLE IS,13,english,3,1485,313,1172,837,527,1689,478,1211,751,397
22,227906,TEXAS SCH FOR T,13,english,3,28,23,5,1,1,28,24,4,0,0
22,227907,MANOR ISD,13,english,3,550,158,392,244,128,575,227,348,184,73
22,227909,EANES ISD,13,english,3,547,21,526,448,307,547,45,502,378,226
22,227910,DEL VALLE ISD,13,english,3,451,150,301,163,73,639,282,357,189,77
22,227912,LAGO VISTA ISD,13,english,3,103,16,87,63,47,103,27,76,49,27
22,227913,LAKE TRAVIS ISD,13,english,3,831,101,730,547,357,862,153,709,470,262
22,228901,GROVETON ISD,6,english,3,48,13,35,22,10,48,16,32,15,8
22,228903,TRINITY ISD,6,english,3,62,13,49,28,13,62,19,43,21,9
22,228904,CENTERVILLE ISD,6,english,3,0,,,,,0,,,,
22,228905,APPLE SPRINGS I,6,english,3,16,3,13,7,4,16,3,13,5,1
22,229901,COLMESNEIL ISD,5,english,3,40,13,27,10,9,40,21,19,6,2
22,229903,WOODVILLE ISD,5,english,3,125,43,82,47,27,125,58,67,31,11
22,229904,WARREN ISD,5,english,3,107,28,79,52,32,107,29,78,43,24
22,229905,SPURGER ISD,5,english,3,27,4,23,11,5,27,5,22,7,4
22,229906,CHESTER ISD,5,english,3,7,1,6,5,2,7,1,6,6,2
22,230901,BIG SANDY ISD,7,english,3,40,9,31,21,15,40,11,29,17,10
22,230902,GILMER ISD,7,english,3,180,46,134,86,43,180,43,137,89,47
22,230903,ORE CITY ISD,7,english,3,70,18,52,32,16,70,32,38,10,4
22,230904,UNION HILL ISD,7,english,3,17,0,17,10,4,18,4,14,6,0
22,230905,HARMONY ISD,7,english,3,71,7,64,49,19,71,7,64,42,24
22,230906,NEW DIANA ISD,7,english,3,88,6,82,62,43,88,9,79,56,34
22,230908,UNION GROVE ISD,7,english,3,44,6,38,25,16,44,9,35,21,7
22,231901,MCCAMEY ISD,18,english,3,39,11,28,17,11,39,19,20,13,3
22,231902,RANKIN ISD,18,english,3,24,10,14,9,5,24,5,19,9,4
22,232901,KNIPPA ISD,20,english,3,39,3,36,29,19,39,5,34,27,12
22,232902,SABINAL ISD,20,english,3,22,7,15,12,4,22,9,13,5,1
22,232903,UVALDE CISD,20,english,3,260,59,201,124,63,249,89,160,72,28
22,232904,UTOPIA ISD,20,english,3,17,5,12,6,3,17,5,12,6,3
22,233901,SAN FELIPE-DEL,15,english,3,692,192,500,276,151,692,258,434,224,92
22,233903,COMSTOCK ISD,15,english,3,15,0,15,11,5,15,1,14,9,4
22,234902,CANTON ISD,10,english,3,177,17,160,113,69,177,26,151,84,33
22,234903,EDGEWOOD ISD,7,english,3,70,20,50,24,9,70,21,49,19,10
22,234904,GRAND SALINE IS,7,english,3,89,23,66,38,20,89,25,64,39,19
22,234905,MARTINS MILL IS,7,english,3,36,6,30,21,13,36,7,29,18,10
22,234906,VAN ISD,7,english,3,164,33,131,85,45,166,40,126,69,33
22,234907,WILLS POINT ISD,10,english,3,204,59,145,85,33,204,87,117,51,17
22,234909,FRUITVALE ISD,7,english,3,25,2,23,15,6,25,5,20,12,4
22,235901,BLOOMINGTON ISD,3,english,3,65,33,32,14,8,65,40,25,11,4
22,235902,VICTORIA ISD,3,english,3,888,256,632,385,222,890,370,520,276,123
22,235904,NURSERY ISD,3,english,3,17,1,16,12,10,17,0,17,15,7
22,236802,SAM HOUSTON STA,6,english,3,71,5,66,50,30,71,5,66,48,24
22,236901,NEW WAVERLY ISD,6,english,3,65,7,58,45,25,65,14,51,35,14
22,236902,HUNTSVILLE ISD,6,english,3,1600,581,1019,625,336,1597,809,788,354,147
22,237902,HEMPSTEAD ISD,4,english,3,106,39,67,39,18,106,52,54,28,17
22,237904,WALLER ISD,4,english,3,580,149,431,260,128,584,152,432,246,105
22,237905,ROYAL ISD,4,english,3,99,22,77,52,31,167,52,115,50,20
22,238902,MONAHANS-WICKET,18,english,3,146,19,127,87,55,147,22,125,78,33
22,238904,GRANDFALLS-ROYA,18,english,3,13,5,8,3,3,13,7,6,2,0
22,239901,BRENHAM ISD,6,english,3,347,108,239,138,69,347,111,236,131,61
22,239903,BURTON ISD,6,english,3,38,4,34,25,15,38,3,35,23,11
22,240901,LAREDO ISD,1,english,3,1374,322,1052,671,371,1371,450,921,532,213
22,240903,UNITED ISD,1,english,3,2729,554,2175,1443,785,2715,706,2009,1219,589
22,240904,WEBB CISD,1,english,3,12,4,8,3,2,12,2,10,5,1
22,241901,BOLING ISD,3,english,3,70,24,46,33,20,70,28,42,21,8
22,241902,EAST BERNARD IS,3,english,3,74,10,64,47,25,74,9,65,37,19
22,241903,EL CAMPO ISD,3,english,3,249,70,179,111,64,249,67,182,110,56
22,241904,WHARTON ISD,3,english,3,118,44,74,42,22,118,52,66,28,13
22,241906,LOUISE ISD,3,english,3,37,15,22,11,8,37,11,26,13,9
22,242902,SHAMROCK ISD,16,english,3,23,4,19,10,6,23,7,16,7,3
22,242903,WHEELER ISD,16,english,3,24,3,21,11,7,24,5,19,14,5
22,242905,KELTON ISD,16,english,3,14,2,12,10,4,14,3,11,6,2
22,242906,FORT ELLIOTT CI,16,english,3,13,3,10,6,3,13,1,12,5,5
22,243901,BURKBURNETT ISD,9,english,3,238,72,166,94,52,237,86,151,85,32
22,243902,ELECTRA ISD,9,english,3,35,24,11,8,4,35,22,13,9,3
22,243903,IOWA PARK CISD,9,english,3,138,22,116,69,34,138,36,102,60,25
22,243905,WICHITA FALLS I,9,english,3,890,280,610,374,209,947,360,587,271,121
22,243906,CITY VIEW ISD,9,english,3,80,24,56,33,14,81,30,51,26,7
22,244901,HARROLD ISD,9,english,3,8,1,7,5,4,8,2,6,4,0
22,244903,VERNON ISD,9,english,3,134,41,93,34,15,134,48,86,37,15
22,244905,NORTHSIDE ISD,9,english,3,22,2,20,15,9,22,1,21,12,4
22,245901,LASARA ISD,1,english,3,14,5,9,8,4,14,4,10,3,1
22,245902,LYFORD CISD,1,english,3,90,33,57,26,12,90,41,49,15,4
22,245903,RAYMONDVILLE IS,1,english,3,138,27,111,71,43,139,32,107,59,25
22,245904,SAN PERLITA ISD,1,english,3,17,4,13,6,3,17,5,12,6,4
22,246801,MERIDIAN WORLD,13,english,3,150,6,144,121,90,150,13,137,102,58
22,246802,GOODWATER MONTE,13,english,3,36,15,21,18,11,37,19,18,6,3
22,246902,FLORENCE ISD,13,english,3,73,31,42,26,15,77,31,46,17,8
22,246904,GEORGETOWN ISD,13,english,3,822,202,620,406,248,857,306,551,291,141
22,246905,GRANGER ISD,13,english,3,42,18,24,9,3,42,21,21,6,1
22,246906,HUTTO ISD,13,english,3,628,128,500,316,202,648,205,443,241,95
22,246907,JARRELL ISD,13,english,3,219,79,140,75,40,221,135,86,26,4
22,246908,LIBERTY HILL IS,13,english,3,578,91,487,361,214,578,103,475,315,165
22,246909,ROUND ROCK ISD,13,english,3,3233,447,2786,2197,1585,3279,682,2597,1826,1127
22,246911,TAYLOR ISD,13,english,3,195,67,128,75,44,204,104,100,33,15
22,246912,THRALL ISD,13,english,3,54,3,51,40,26,54,4,50,32,16
22,246913,LEANDER ISD,13,english,3,2801,392,2409,1837,1201,2839,668,2171,1323,656
22,246914,COUPLAND ISD,13,english,3,25,7,18,9,2,25,9,16,9,4
22,247901,FLORESVILLE ISD,20,english,3,242,59,183,119,68,240,92,148,68,22
22,247903,LA VERNIA ISD,20,english,3,247,47,200,132,79,251,57,194,132,70
22,247904,POTH ISD,20,english,3,67,5,62,45,30,67,11,56,35,13
22,247906,STOCKDALE ISD,20,english,3,57,19,38,22,15,57,28,29,13,5
22,248901,KERMIT ISD,18,english,3,93,36,57,26,8,93,26,67,29,12
22,248902,WINK-LOVING ISD,18,english,3,24,3,21,14,5,24,4,20,11,7
22,249901,ALVORD ISD,11,english,3,48,5,43,31,11,48,5,43,28,7
22,249902,BOYD ISD,11,english,3,96,23,73,44,23,96,22,74,44,22
22,249903,BRIDGEPORT ISD,11,english,3,114,33,81,56,33,148,63,85,42,15
22,249904,CHICO ISD,11,english,3,44,11,33,19,10,44,13,31,15,9
22,249905,DECATUR ISD,11,english,3,249,54,195,124,63,269,90,179,83,28
22,249906,PARADISE ISD,11,english,3,107,11,96,61,37,107,14,93,53,30
22,249908,SLIDELL ISD,11,english,3,36,9,27,15,8,36,16,20,12,3
22,250902,HAWKINS ISD,7,english,3,46,10,36,18,11,46,14,32,20,7
22,250903,MINEOLA ISD,7,english,3,121,22,99,55,28,121,24,97,56,22
22,250904,QUITMAN ISD,7,english,3,85,8,77,52,22,85,16,69,40,18
22,250905,YANTIS ISD,7,english,3,25,6,19,13,6,25,5,20,15,6
22,250906,ALBA-GOLDEN ISD,7,english,3,70,9,61,34,22,70,19,51,24,13
22,250907,WINNSBORO ISD,7,english,3,107,27,80,51,31,107,47,60,30,10
22,251901,DENVER CITY ISD,17,english,3,121,31,90,49,28,121,40,81,46,21
22,251902,PLAINS ISD,17,english,3,28,9,19,13,6,28,6,22,8,3
22,252901,GRAHAM ISD,9,english,3,144,31,113,72,48,144,27,117,70,37
22,252902,NEWCASTLE ISD,9,english,3,12,5,7,6,4,12,4,8,3,1
22,252903,OLNEY ISD,9,english,3,43,11,32,21,13,43,16,27,9,4
22,253901,ZAPATA COUNTY I,1,english,3,209,57,152,94,40,209,66,143,93,36
22,254901,CRYSTAL CITY IS,20,english,3,120,42,78,40,23,120,53,67,31,10
22,254902,LA PRYOR ISD,20,english,3,45,13,32,21,9,45,18,27,12,5
22,1907,PALESTINE ISD,7,spanish,3,18,14,4,1,0,0,,,,
22,2901,ANDREWS ISD,18,spanish,3,30,12,18,8,4,13,8,5,1,0
22,3903,LUFKIN ISD,7,spanish,3,0,,,,,0,,,,
22,4901,ARANSAS COUNTY,2,spanish,3,0,,,,,0,,,,
22,7905,PLEASANTON ISD,20,spanish,3,0,,,,,0,,,,
22,7906,POTEET ISD,20,spanish,3,9,6,3,1,1,0,,,,
22,8902,SEALY ISD,6,spanish,3,29,9,20,11,8,0,,,,
22,9901,MULESHOE ISD,17,spanish,3,0,,,,,0,,,,
22,10902,BANDERA ISD,20,spanish,3,0,,,,,0,,,,
22,11901,BASTROP ISD,13,spanish,3,18,16,2,1,1,13,12,1,0,0
22,11902,ELGIN ISD,13,spanish,3,87,47,40,17,4,9,4,5,0,0
22,14903,BELTON ISD,12,spanish,3,34,24,10,3,2,0,,,,
22,14906,KILLEEN ISD,12,spanish,3,45,23,22,7,5,29,11,18,5,1
22,14909,TEMPLE ISD,12,spanish,3,69,23,46,18,14,0,,,,
22,15802,GEORGE GERVIN A,20,spanish,3,14,8,6,4,2,14,7,7,4,0
22,15822,JUBILEE ACADEMI,20,spanish,3,21,10,11,4,1,19,10,9,2,0
22,15825,LIGHTHOUSE PUBL,20,spanish,3,0,,,,,0,,,,
22,15827,SCHOOL OF SCIEN,20,spanish,3,0,,,,,0,,,,
22,15828,HARMONY PUBLIC,20,spanish,3,14,10,4,0,0,11,9,2,1,0
22,15838,COMPASS ROSE PU,20,spanish,3,0,,,,,0,,,,
22,15901,ALAMO HEIGHTS I,20,spanish,3,15,4,11,3,2,13,5,8,2,0
22,15904,HARLANDALE ISD,20,spanish,3,144,65,79,24,10,161,62,99,45,14
22,15905,EDGEWOOD ISD,20,spanish,3,122,69,53,22,11,122,63,59,30,9
22,15907,SAN ANTONIO ISD,20,spanish,3,574,292,282,120,73,615,281,334,168,85
22,15908,SOUTH SAN ANTON,20,spanish,3,95,61,34,15,6,95,51,44,18,4
22,15909,SOMERSET ISD,20,spanish,3,41,19,22,8,2,5,3,2,0,0
22,15910,NORTH EAST ISD,20,spanish,3,537,179,358,186,130,570,156,414,246,122
22,15911,EAST CENTRAL IS,20,spanish,3,88,46,42,12,2,98,49,49,21,11
22,15912,SOUTHWEST ISD,20,spanish,3,49,27,22,11,7,47,19,28,11,4
22,15915,NORTHSIDE ISD,20,spanish,3,358,165,193,87,37,365,160,205,85,32
22,15916,JUDSON ISD,20,spanish,3,54,28,26,14,7,52,20,32,10,7
22,15917,SOUTHSIDE ISD,20,spanish,3,82,37,45,23,15,83,23,60,34,14
22,19907,TEXARKANA ISD,8,spanish,3,30,9,21,4,2,7,5,2,0,0
22,20901,ALVIN ISD,4,spanish,3,100,50,50,17,5,44,31,13,7,3
22,20902,ANGLETON ISD,4,spanish,3,0,,,,,0,,,,
22,20904,DANBURY ISD,4,spanish,3,0,,,,,0,,,,
22,20905,BRAZOSPORT ISD,4,spanish,3,11,2,9,3,0,6,3,3,1,1
22,20907,COLUMBIA-BRAZOR,4,spanish,3,0,,,,,0,,,,
22,20908,PEARLAND ISD,4,spanish,3,5,4,1,1,0,5,3,2,1,1
22,21901,COLLEGE STATION,6,spanish,3,24,5,19,7,4,24,12,12,3,1
22,21902,BRYAN ISD,6,spanish,3,25,5,20,12,5,22,9,13,7,4
22,25901,BANGS ISD,15,spanish,3,0,,,,,0,,,,
22,25905,MAY ISD,15,spanish,3,0,,,,,0,,,,
22,26901,CALDWELL ISD,6,spanish,3,0,,,,,0,,,,
22,27904,MARBLE FALLS IS,13,spanish,3,47,23,24,13,5,11,10,1,0,0
22,28902,LOCKHART ISD,13,spanish,3,66,36,30,5,0,60,33,27,6,1
22,31901,BROWNSVILLE ISD,1,spanish,3,99,45,54,17,8,96,50,46,17,8
22,31903,HARLINGEN CISD,1,spanish,3,11,9,2,0,0,8,8,0,0,0
22,31905,LA FERIA ISD,1,spanish,3,0,,,,,0,,,,
22,31906,LOS FRESNOS CIS,1,spanish,3,10,6,4,0,0,10,5,5,1,1
22,31909,POINT ISABEL IS,1,spanish,3,11,8,3,1,0,7,6,1,1,0
22,31912,SAN BENITO CISD,1,spanish,3,14,10,4,3,0,13,9,4,2,1
22,31913,SANTA MARIA ISD,1,spanish,3,0,,,,,0,,,,
22,35901,DIMMITT ISD,16,spanish,3,0,,,,,0,,,,
22,36902,BARBERS HILL IS,4,spanish,3,0,,,,,0,,,,
22,37904,JACKSONVILLE IS,7,spanish,3,95,34,61,32,13,0,,,,
22,40901,MORTON ISD,17,spanish,3,0,,,,,0,,,,
22,43901,ALLEN ISD,10,spanish,3,25,13,12,6,1,26,14,12,0,0
22,43903,CELINA ISD,10,spanish,3,13,4,9,2,1,0,,,,
22,43904,FARMERSVILLE IS,10,spanish,3,0,,,,,0,,,,
22,43905,FRISCO ISD,10,spanish,3,44,25,19,12,10,23,14,9,2,2
22,43907,MCKINNEY ISD,10,spanish,3,65,39,26,6,4,61,31,30,14,5
22,43910,PLANO ISD,10,spanish,3,313,148,165,71,38,294,132,162,65,25
22,43911,PRINCETON ISD,10,spanish,3,0,,,,,0,,,,
22,43912,PROSPER ISD,10,spanish,3,0,,,,,0,,,,
22,43914,WYLIE ISD,10,spanish,3,27,3,24,9,5,0,,,,
22,43918,COMMUNITY ISD,10,spanish,3,49,22,27,8,3,0,,,,
22,45903,RICE CISD,3,spanish,3,0,,,,,0,,,,
22,46901,NEW BRAUNFELS I,13,spanish,3,18,6,12,5,2,14,8,6,3,1
22,46902,COMAL ISD,20,spanish,3,12,3,9,5,2,12,7,5,4,2
22,47901,COMANCHE ISD,14,spanish,3,0,,,,,0,,,,
22,49901,GAINESVILLE ISD,11,spanish,3,36,19,17,4,3,0,,,,
22,49903,VALLEY VIEW ISD,11,spanish,3,9,6,3,1,0,0,,,,
22,50901,EVANT ISD,12,spanish,3,0,,,,,0,,,,
22,50902,GATESVILLE ISD,12,spanish,3,0,,,,,0,,,,
22,50910,COPPERAS COVE I,12,spanish,3,5,3,2,1,1,0,,,,
22,56901,DALHART ISD,16,spanish,3,0,,,,,0,,,,
22,57803,UPLIFT EDUCATIO,10,spanish,3,8,7,1,0,0,7,7,0,0,0
22,57806,ADVANTAGE ACADE,10,spanish,3,0,,,,,0,,,,
22,57835,GOLDEN RULE CHA,10,spanish,3,7,5,2,0,0,7,4,3,0,0
22,57839,LA ACADEMIA DE,10,spanish,3,0,,,,,0,,,,
22,57841,CITYSCAPE SCHOO,10,spanish,3,32,19,13,5,3,0,,,,
22,57846,LEGACY PREPARAT,10,spanish,3,0,,,,,0,,,,
22,57848,INTERNATIONAL L,10,spanish,3,52,34,18,10,4,44,27,17,3,0
22,57903,CARROLLTON-FARM,10,spanish,3,368,137,231,96,45,54,36,18,5,1
22,57904,CEDAR HILL ISD,10,spanish,3,0,,,,,0,,,,
22,57905,DALLAS ISD,10,spanish,3,3764,1516,2248,1151,695,224,131,93,30,9
22,57906,DESOTO ISD,10,spanish,3,29,17,12,2,0,0,,,,
22,57907,DUNCANVILLE ISD,10,spanish,3,147,74,73,33,22,15,6,9,4,2
22,57909,GARLAND ISD,10,spanish,3,785,317,468,222,121,68,34,34,12,2
22,57910,GRAND PRAIRIE I,10,spanish,3,425,194,231,116,65,23,14,9,2,2
22,57912,IRVING ISD,10,spanish,3,190,112,78,26,14,188,130,58,19,9
22,57913,LANCASTER ISD,10,spanish,3,13,4,9,5,1,0,,,,
22,57914,MESQUITE ISD,10,spanish,3,374,193,181,76,40,348,149,199,91,34
22,57916,RICHARDSON ISD,10,spanish,3,174,106,68,12,7,87,50,37,10,3
22,57922,COPPELL ISD,10,spanish,3,12,8,4,2,1,12,7,5,3,2
22,59901,HEREFORD ISD,16,spanish,3,0,,,,,0,,,,
22,61805,TRIVIUM ACADEMY,11,spanish,3,0,,,,,0,,,,
22,61901,DENTON ISD,11,spanish,3,161,85,76,25,12,37,21,16,6,3
22,61902,LEWISVILLE ISD,11,spanish,3,165,86,79,30,17,159,95,64,22,6
22,61903,PILOT POINT ISD,11,spanish,3,25,9,16,12,4,0,,,,
22,61905,KRUM ISD,11,spanish,3,8,6,2,2,1,0,,,,
22,61911,NORTHWEST ISD,11,spanish,3,0,,,,,0,,,,
22,61914,LITTLE ELM ISD,11,spanish,3,40,19,21,6,5,8,7,1,0,0
22,62901,CUERO ISD,3,spanish,3,0,,,,,0,,,,
22,68901,ECTOR COUNTY IS,18,spanish,3,410,224,186,69,44,403,199,204,88,30
22,70801,WAXAHACHIE FAIT,10,spanish,3,77,56,21,4,3,10,9,1,0,0
22,70903,ENNIS ISD,10,spanish,3,8,5,3,0,0,8,6,2,0,0
22,70905,FERRIS ISD,10,spanish,3,31,17,14,3,2,0,,,,
22,70908,MIDLOTHIAN ISD,10,spanish,3,14,3,11,6,5,0,,,,
22,70911,RED OAK ISD,10,spanish,3,18,7,11,5,4,0,,,,
22,70912,WAXAHACHIE ISD,10,spanish,3,32,14,18,5,3,0,,,,
22,71801,BURNHAM WOOD CH,19,spanish,3,0,,,,,0,,,,
22,71806,HARMONY PUBLIC,19,spanish,3,7,1,6,3,3,6,1,5,3,0
22,71807,LA FE PREPARATO,19,spanish,3,12,5,7,4,4,12,4,8,5,2
22,71809,VISTA DEL FUTUR,19,spanish,3,5,3,2,2,2,5,3,2,1,1
22,71901,CLINT ISD,19,spanish,3,112,58,54,29,15,92,55,37,11,4
22,71902,EL PASO ISD,19,spanish,3,536,197,339,162,94,504,210,294,139,51
22,71903,FABENS ISD,19,spanish,3,53,17,36,17,10,51,16,35,20,11
22,71904,SAN ELIZARIO IS,19,spanish,3,79,54,25,5,2,11,9,2,2,0
22,71905,YSLETA ISD,19,spanish,3,533,173,360,164,93,295,80,215,128,48
22,71906,ANTHONY ISD,19,spanish,3,8,4,4,3,2,8,1,7,3,1
22,71907,CANUTILLO ISD,19,spanish,3,79,30,49,20,11,75,27,48,26,7
22,71908,TORNILLO ISD,19,spanish,3,27,13,14,7,5,0,,,,
22,71909,SOCORRO ISD,19,spanish,3,62,27,35,13,4,51,29,22,8,2
22,72903,STEPHENVILLE IS,11,spanish,3,23,12,11,4,2,0,,,,
22,73904,WESTPHALIA ISD,12,spanish,3,0,,,,,0,,,,
22,74903,BONHAM ISD,10,spanish,3,0,,,,,0,,,,
22,75902,LA GRANGE ISD,13,spanish,3,0,,,,,0,,,,
22,75906,FAYETTEVILLE IS,13,spanish,3,0,,,,,0,,,,
22,79901,LAMAR CISD,4,spanish,3,79,39,40,11,6,32,15,17,5,1
22,79906,NEEDVILLE ISD,4,spanish,3,0,,,,,0,,,,
22,79907,FORT BEND ISD,4,spanish,3,70,40,30,8,2,44,27,17,4,1
22,79910,STAFFORD MSD,4,spanish,3,0,,,,,0,,,,
22,82903,PEARSALL ISD,20,spanish,3,0,,,,,0,,,,
22,83903,SEMINOLE ISD,17,spanish,3,6,4,2,0,0,6,4,2,1,0
22,84901,DICKINSON ISD,4,spanish,3,98,50,48,19,9,59,25,34,20,3
22,84902,GALVESTON ISD,4,spanish,3,57,13,44,24,14,47,16,31,24,5
22,84906,TEXAS CITY ISD,4,spanish,3,5,3,2,2,0,0,,,,
22,84909,SANTA FE ISD,4,spanish,3,0,,,,,0,,,,
22,84910,CLEAR CREEK ISD,4,spanish,3,174,84,90,32,19,184,70,114,55,22
22,84911,FRIENDSWOOD ISD,4,spanish,3,0,,,,,0,,,,
22,86901,FREDERICKSBURG,13,spanish,3,0,,,,,0,,,,
22,89901,GONZALES ISD,13,spanish,3,0,,,,,0,,,,
22,89903,NIXON-SMILEY CI,13,spanish,3,0,,,,,0,,,,
22,90904,PAMPA ISD,16,spanish,3,0,,,,,0,,,,
22,91902,COLLINSVILLE IS,10,spanish,3,0,,,,,0,,,,
22,91903,DENISON ISD,10,spanish,3,16,11,5,3,2,0,,,,
22,91906,SHERMAN ISD,10,spanish,3,37,27,10,3,1,0,,,,
22,92901,GLADEWATER ISD,7,spanish,3,0,,,,,0,,,,
22,92902,KILGORE ISD,7,spanish,3,24,16,8,3,0,0,,,,
22,92903,LONGVIEW ISD,7,spanish,3,68,36,32,15,6,0,,,,
22,92904,PINE TREE ISD,7,spanish,3,0,,,,,0,,,,
22,93904,NAVASOTA ISD,6,spanish,3,0,,,,,0,,,,
22,94901,SEGUIN ISD,20,spanish,3,42,24,18,6,5,47,25,22,8,1
22,94902,SCHERTZ-CIBOLO-,20,spanish,3,33,12,21,10,8,0,,,,
22,94904,MARION ISD,20,spanish,3,0,,,,,0,,,,
22,95905,PLAINVIEW ISD,17,spanish,3,0,,,,,0,,,,
22,99902,CHILLICOTHE ISD,9,spanish,3,0,,,,,0,,,,
22,101802,SER-NINOS CHART,4,spanish,3,52,22,30,14,9,52,31,21,10,4
22,101806,RAUL YZAGUIRRE,4,spanish,3,22,4,18,9,5,0,,,,
22,101814,THE VARNETT PUB,4,spanish,3,0,,,,,0,,,,
22,101845,YES PREP PUBLIC,4,spanish,3,73,19,54,26,17,75,12,63,44,21
22,101853,PROMISE COMMUNI,4,spanish,3,0,,,,,0,,,,
22,101856,DRAW ACADEMY,4,spanish,3,0,,,,,0,,,,
22,101858,HARMONY PUBLIC,4,spanish,3,0,,,,,0,,,,
22,101859,STEP CHARTER SC,4,spanish,3,0,,,,,0,,,,
22,101902,ALDINE ISD,4,spanish,3,509,323,186,57,25,445,306,139,35,9
22,101903,ALIEF ISD,4,spanish,3,485,206,279,127,75,12,10,2,1,0
22,101905,CHANNELVIEW ISD,4,spanish,3,106,46,60,36,20,40,17,23,10,4
22,101906,CROSBY ISD,4,spanish,3,31,15,16,7,4,29,8,21,6,3
22,101907,CYPRESS-FAIRBAN,4,spanish,3,61,32,29,14,7,58,38,20,7,2
22,101908,DEER PARK ISD,4,spanish,3,76,30,46,21,11,76,33,43,27,15
22,101910,GALENA PARK ISD,4,spanish,3,442,159,283,126,67,449,104,345,200,89
22,101911,GOOSE CREEK CIS,4,spanish,3,14,3,11,6,5,14,6,8,2,1
22,101912,HOUSTON ISD,4,spanish,3,3309,1322,1987,937,541,3106,1180,1926,994,431
22,101913,HUMBLE ISD,4,spanish,3,115,54,61,29,13,113,56,57,20,9
22,101914,KATY ISD,4,spanish,3,351,102,249,132,82,207,82,125,57,18
22,101915,KLEIN ISD,4,spanish,3,74,33,41,16,7,48,28,20,7,1
22,101916,LA PORTE ISD,4,spanish,3,5,0,5,2,0,5,2,3,2,0
22,101917,PASADENA ISD,4,spanish,3,942,357,585,262,141,992,308,684,304,127
22,101919,SPRING ISD,4,spanish,3,442,203,239,104,64,263,102,161,82,24
22,101920,SPRING BRANCH I,4,spanish,3,238,126,112,32,15,66,41,25,7,0
22,101921,TOMBALL ISD,4,spanish,3,85,27,58,29,20,10,2,8,5,2
22,101924,SHELDON ISD,4,spanish,3,38,22,16,5,3,34,22,12,6,1
22,101925,HUFFMAN ISD,4,spanish,3,13,3,10,5,0,11,2,9,6,0
22,102902,MARSHALL ISD,7,spanish,3,33,10,23,5,2,0,,,,
22,105902,SAN MARCOS CISD,13,spanish,3,54,32,22,9,3,17,11,6,2,0
22,105904,DRIPPING SPRING,13,spanish,3,14,7,7,2,1,0,,,,
22,105905,WIMBERLEY ISD,13,spanish,3,0,,,,,0,,,,
22,105906,HAYS CISD,13,spanish,3,141,82,59,16,5,25,17,8,3,1
22,107901,ATHENS ISD,10,spanish,3,0,,,,,0,,,,
22,107906,MALAKOFF ISD,7,spanish,3,0,,,,,0,,,,
22,108802,HORIZON MONTESS,1,spanish,3,0,,,,,0,,,,
22,108807,IDEA PUBLIC SCH,1,spanish,3,14,10,4,1,0,9,6,3,2,1
22,108808,VANGUARD ACADEM,1,spanish,3,18,9,9,4,4,18,6,12,5,2
22,108902,DONNA ISD,1,spanish,3,250,167,83,16,6,80,60,20,7,1
22,108903,EDCOUCH-ELSA IS,1,spanish,3,0,,,,,0,,,,
22,108904,EDINBURG CISD,1,spanish,3,46,23,23,9,5,35,17,18,5,2
22,108905,HIDALGO ISD,1,spanish,3,50,9,41,33,26,22,12,10,5,3
22,108906,MCALLEN ISD,1,spanish,3,98,40,58,32,13,40,17,23,15,6
22,108907,MERCEDES ISD,1,spanish,3,15,7,8,2,0,0,,,,
22,108908,MISSION CISD,1,spanish,3,232,125,107,49,27,6,4,2,0,0
22,108909,PHARR-SAN JUAN-,1,spanish,3,472,216,256,104,58,16,10,6,2,0
22,108910,PROGRESO ISD,1,spanish,3,31,14,17,9,5,0,,,,
22,108911,SHARYLAND ISD,1,spanish,3,95,38,57,33,21,88,32,56,27,10
22,108912,LA JOYA ISD,1,spanish,3,815,324,491,214,126,16,7,9,3,2
22,108913,WESLACO ISD,1,spanish,3,9,5,4,4,1,8,4,4,1,0
22,108916,VALLEY VIEW ISD,1,spanish,3,40,14,26,7,3,31,11,20,3,0
22,109904,HILLSBORO ISD,12,spanish,3,0,,,,,0,,,,
22,109907,ITASCA ISD,12,spanish,3,0,,,,,0,,,,
22,111901,GRANBURY ISD,11,spanish,3,24,4,20,8,6,0,,,,
22,112901,SULPHUR SPRINGS,8,spanish,3,30,15,15,4,4,0,,,,
22,112907,MILLER GROVE IS,8,spanish,3,0,,,,,0,,,,
22,115901,FT HANCOCK ISD,19,spanish,3,6,2,4,1,1,0,,,,
22,116903,COMMERCE ISD,10,spanish,3,0,,,,,0,,,,
22,116905,GREENVILLE ISD,10,spanish,3,49,31,18,5,2,0,,,,
22,116908,QUINLAN ISD,10,spanish,3,0,,,,,0,,,,
22,117901,BORGER ISD,16,spanish,3,5,2,3,0,0,0,,,,
22,123807,BOB HOPE SCHOOL,5,spanish,3,25,6,19,10,4,21,5,16,8,2
22,123905,NEDERLAND ISD,5,spanish,3,0,,,,,0,,,,
22,123907,PORT ARTHUR ISD,5,spanish,3,23,10,13,4,1,11,8,3,3,0
22,123910,BEAUMONT ISD,5,spanish,3,14,8,6,2,1,13,10,3,2,1
22,125903,ORANGE GROVE IS,2,spanish,3,0,,,,,0,,,,
22,126901,ALVARADO ISD,11,spanish,3,36,23,13,5,3,0,,,,
22,126902,BURLESON ISD,11,spanish,3,8,5,3,2,0,8,5,3,3,2
22,126903,CLEBURNE ISD,11,spanish,3,52,25,27,6,5,16,5,11,3,1
22,126905,JOSHUA ISD,11,spanish,3,16,7,9,3,2,0,,,,
22,126906,KEENE ISD,11,spanish,3,0,,,,,0,,,,
22,126908,VENUS ISD,11,spanish,3,7,4,3,0,0,0,,,,
22,126911,GODLEY ISD,11,spanish,3,0,,,,,0,,,,
22,128901,KARNES CITY ISD,20,spanish,3,0,,,,,0,,,,
22,129901,CRANDALL ISD,10,spanish,3,6,4,2,0,0,0,,,,
22,129902,FORNEY ISD,10,spanish,3,33,14,19,9,6,7,4,3,1,1
22,129903,KAUFMAN ISD,10,spanish,3,0,,,,,0,,,,
22,129904,KEMP ISD,10,spanish,3,0,,,,,0,,,,
22,129906,TERRELL ISD,10,spanish,3,0,,,,,0,,,,
22,130901,BOERNE ISD,20,spanish,3,27,12,15,7,4,28,13,15,11,6
22,130902,COMFORT ISD,13,spanish,3,0,,,,,0,,,,
22,137901,KINGSVILLE ISD,2,spanish,3,0,,,,,0,,,,
22,139909,PARIS ISD,8,spanish,3,11,6,5,1,1,0,,,,
22,142901,COTULLA ISD,20,spanish,3,0,,,,,0,,,,
22,144902,LEXINGTON ISD,13,spanish,3,0,,,,,0,,,,
22,146901,CLEVELAND ISD,4,spanish,3,290,189,101,29,12,24,21,3,1,0
22,146902,DAYTON ISD,4,spanish,3,38,21,17,5,1,9,9,0,0,0
22,146906,LIBERTY ISD,5,spanish,3,0,,,,,0,,,,
22,152901,LUBBOCK ISD,17,spanish,3,53,18,35,19,11,32,10,22,11,2
22,152906,LUBBOCK-COOPER,17,spanish,3,15,3,12,4,3,0,,,,
22,152907,FRENSHIP ISD,17,spanish,3,17,6,11,1,1,0,,,,
22,154901,MADISONVILLE CI,6,spanish,3,0,,,,,0,,,,
22,156902,STANTON ISD,18,spanish,3,0,,,,,0,,,,
22,159901,EAGLE PASS ISD,20,spanish,3,87,46,41,20,4,74,46,28,13,4
22,161807,HARMONY PUBLIC,12,spanish,3,6,4,2,1,0,0,,,,
22,161906,LA VEGA ISD,12,spanish,3,14,6,8,4,1,0,,,,
22,161909,MCGREGOR ISD,12,spanish,3,0,,,,,0,,,,
22,161914,WACO ISD,12,spanish,3,9,7,2,0,0,10,10,0,0,0
22,161921,CONNALLY ISD,12,spanish,3,0,,,,,0,,,,
22,165901,MIDLAND ISD,18,spanish,3,202,77,125,58,29,194,69,125,75,32
22,165902,GREENWOOD ISD,18,spanish,3,0,,,,,0,,,,
22,168902,LORAINE ISD,14,spanish,3,0,,,,,0,,,,
22,170902,CONROE ISD,6,spanish,3,334,136,198,81,48,283,98,185,84,38
22,170903,MONTGOMERY ISD,6,spanish,3,0,,,,,0,,,,
22,170904,WILLIS ISD,6,spanish,3,21,18,3,0,0,6,4,2,0,0
22,170906,MAGNOLIA ISD,6,spanish,3,95,43,52,25,16,9,5,4,2,1
22,170908,NEW CANEY ISD,6,spanish,3,84,56,28,7,2,87,58,29,7,4
22,171902,SUNRAY COLLEGIA,16,spanish,3,0,,,,,0,,,,
22,174904,NACOGDOCHES ISD,7,spanish,3,0,,,,,0,,,,
22,175903,CORSICANA ISD,12,spanish,3,21,7,14,7,3,0,,,,
22,175907,KERENS ISD,12,spanish,3,0,,,,,0,,,,
22,177901,ROSCOE COLLEGIA,14,spanish,3,0,,,,,0,,,,
22,178903,CALALLEN ISD,2,spanish,3,0,,,,,0,,,,
22,178904,CORPUS CHRISTI,2,spanish,3,12,5,7,2,1,11,8,3,1,0
22,178909,ROBSTOWN ISD,2,spanish,3,0,,,,,0,,,,
22,178914,FLOUR BLUFF ISD,2,spanish,3,0,,,,,0,,,,
22,178915,WEST OSO ISD,2,spanish,3,0,,,,,0,,,,
22,181906,WEST ORANGE-COV,5,spanish,3,0,,,,,0,,,,
22,182903,MINERAL WELLS I,11,spanish,3,13,6,7,3,3,0,,,,
22,184903,WEATHERFORD ISD,11,spanish,3,9,5,4,1,1,0,,,,
22,186901,BUENA VISTA ISD,18,spanish,3,0,,,,,0,,,,
22,187907,LIVINGSTON ISD,6,spanish,3,0,,,,,0,,,,
22,188901,AMARILLO ISD,16,spanish,3,96,16,80,48,27,11,4,7,3,2
22,189902,PRESIDIO ISD,18,spanish,3,6,2,4,3,1,6,3,3,1,1
22,190903,RAINS ISD,7,spanish,3,0,,,,,0,,,,
22,191901,CANYON ISD,16,spanish,3,0,,,,,0,,,,
22,195901,PECOS-BARSTOW-T,18,spanish,3,10,4,6,3,3,8,3,5,3,1
22,196903,REFUGIO ISD,3,spanish,3,0,,,,,0,,,,
22,198903,FRANKLIN ISD,6,spanish,3,0,,,,,0,,,,
22,199901,ROCKWALL ISD,10,spanish,3,15,5,10,6,3,0,,,,
22,199902,ROYSE CITY ISD,10,spanish,3,9,5,4,3,2,0,,,,
22,201902,HENDERSON ISD,7,spanish,3,0,,,,,0,,,,
22,205902,GREGORY-PORTLAN,2,spanish,3,0,,,,,0,,,,
22,205906,SINTON ISD,2,spanish,3,0,,,,,0,,,,
22,208902,SNYDER ISD,14,spanish,3,23,9,14,8,4,0,,,,
22,211902,STRATFORD ISD,16,spanish,3,0,,,,,0,,,,
22,212905,TYLER ISD,7,spanish,3,48,19,29,14,9,0,,,,
22,212909,CHAPEL HILL ISD,7,spanish,3,62,25,37,18,8,0,,,,
22,214901,RIO GRANDE CITY,1,spanish,3,6,1,5,1,0,6,2,4,0,0
22,214903,ROMA ISD,1,spanish,3,18,1,17,14,9,17,1,16,13,5
22,216901,STERLING CITY I,15,spanish,3,0,,,,,0,,,,
22,220901,ARLINGTON ISD,11,spanish,3,375,209,166,55,34,154,105,49,11,5
22,220902,BIRDVILLE ISD,11,spanish,3,181,93,88,33,17,204,74,130,50,15
22,220904,EVERMAN ISD,11,spanish,3,24,11,13,4,3,7,3,4,0,0
22,220905,FORT WORTH ISD,11,spanish,3,752,409,343,124,75,66,48,18,6,4
22,220906,GRAPEVINE-COLLE,11,spanish,3,13,6,7,4,2,13,9,4,1,0
22,220907,KELLER ISD,11,spanish,3,79,28,51,20,14,8,6,2,1,0
22,220908,MANSFIELD ISD,11,spanish,3,48,14,34,19,10,41,8,33,15,7
22,220910,LAKE WORTH ISD,11,spanish,3,46,26,20,9,2,12,8,4,0,0
22,220912,CROWLEY ISD,11,spanish,3,123,42,81,40,26,5,2,3,1,1
22,220914,KENNEDALE ISD,11,spanish,3,0,,,,,0,,,,
22,220915,AZLE ISD,11,spanish,3,0,,,,,0,,,,
22,220916,HURST-EULESS-BE,11,spanish,3,111,25,86,46,26,112,17,95,65,33
22,220917,CASTLEBERRY ISD,11,spanish,3,62,14,48,18,12,0,,,,
22,220918,EAGLE MT-SAGINA,11,spanish,3,71,23,48,19,13,0,,,,
22,220920,WHITE SETTLEMEN,11,spanish,3,51,24,27,15,8,49,19,30,17,5
22,221801,TEXAS COLLEGE P,14,spanish,3,0,,,,,0,,,,
22,221901,ABILENE ISD,14,spanish,3,8,6,2,1,0,0,,,,
22,221912,WYLIE ISD,14,spanish,3,0,,,,,0,,,,
22,225902,MOUNT PLEASANT,8,spanish,3,108,22,86,47,26,0,,,,
22,225907,HARTS BLUFF ISD,8,spanish,3,14,8,6,0,0,0,,,,
22,226801,TEXAS LEADERSHI,15,spanish,3,0,,,,,0,,,,
22,226903,SAN ANGELO ISD,15,spanish,3,5,4,1,0,0,5,5,0,0,0
22,227803,WAYSIDE SCHOOLS,13,spanish,3,49,18,31,17,11,5,4,1,1,0
22,227816,HARMONY PUBLIC,13,spanish,3,12,9,3,1,1,12,11,1,1,0
22,227817,CEDARS INTERNAT,13,spanish,3,0,,,,,0,,,,
22,227820,KIPP TEXAS PUBL,4,spanish,3,9,7,2,0,0,0,,,,
22,227901,AUSTIN ISD,13,spanish,3,974,491,483,208,114,368,227,141,39,11
22,227904,PFLUGERVILLE IS,13,spanish,3,231,95,136,69,44,40,20,20,6,3
22,227907,MANOR ISD,13,spanish,3,93,58,35,14,11,71,40,31,12,2
22,227910,DEL VALLE ISD,13,spanish,3,240,136,104,34,19,52,36,16,5,0
22,227913,LAKE TRAVIS ISD,13,spanish,3,30,18,12,6,2,0,,,,
22,230901,BIG SANDY ISD,7,spanish,3,0,,,,,0,,,,
22,230905,HARMONY ISD,7,spanish,3,0,,,,,0,,,,
22,232903,UVALDE CISD,20,spanish,3,18,10,8,5,4,29,17,12,6,3
22,233901,SAN FELIPE-DEL,15,spanish,3,0,,,,,0,,,,
22,234903,EDGEWOOD ISD,7,spanish,3,0,,,,,0,,,,
22,235902,VICTORIA ISD,3,spanish,3,30,11,19,7,3,30,9,21,6,3
22,236902,HUNTSVILLE ISD,6,spanish,3,6,3,3,1,1,9,6,3,0,0
22,237904,WALLER ISD,4,spanish,3,6,4,2,0,0,5,4,1,1,1
22,237905,ROYAL ISD,4,spanish,3,75,44,31,9,4,6,5,1,1,1
22,238902,MONAHANS-WICKET,18,spanish,3,7,1,6,2,0,6,0,6,2,1
22,240901,LAREDO ISD,1,spanish,3,38,19,19,3,1,39,23,16,4,0
22,240903,UNITED ISD,1,spanish,3,28,12,16,7,2,25,11,14,6,1
22,241901,BOLING ISD,3,spanish,3,0,,,,,0,,,,
22,241903,EL CAMPO ISD,3,spanish,3,0,,,,,0,,,,
22,243905,WICHITA FALLS I,9,spanish,3,62,41,21,8,1,7,2,5,2,0
22,245903,RAYMONDVILLE IS,1,spanish,3,0,,,,,0,,,,
22,246902,FLORENCE ISD,13,spanish,3,9,8,1,0,0,5,4,1,1,0
22,246904,GEORGETOWN ISD,13,spanish,3,53,34,19,7,3,18,14,4,2,1
22,246906,HUTTO ISD,13,spanish,3,26,12,14,5,3,0,,,,
22,246907,JARRELL ISD,13,spanish,3,10,6,4,2,0,8,5,3,0,0
22,246908,LIBERTY HILL IS,13,spanish,3,0,,,,,0,,,,
22,246909,ROUND ROCK ISD,13,spanish,3,99,57,42,18,9,53,38,15,4,0
22,246911,TAYLOR ISD,13,spanish,3,14,11,3,1,0,0,,,,
22,246913,LEANDER ISD,13,spanish,3,67,37,30,8,4,31,26,5,1,0
22,247901,FLORESVILLE ISD,20,spanish,3,13,6,7,4,3,16,4,12,7,1
22,247903,LA VERNIA ISD,20,spanish,3,5,4,1,1,1,0,,,,
22,248901,KERMIT ISD,18,spanish,3,0,,,,,0,,,,
22,249903,BRIDGEPORT ISD,11,spanish,3,34,22,12,5,3,0,,,,
22,249905,DECATUR ISD,11,spanish,3,20,17,3,0,0,0,,,,
22,250902,HAWKINS ISD,7,spanish,3,0,,,,,0,,,,
22,251901,DENVER CITY ISD,17,spanish,3,0,,,,,0,,,,
22,253901,ZAPATA COUNTY I,1,spanish,3,0,,,,,0,,,,
22,1902,CAYUGA ISD,7,english,4,31,5,26,21,14,31,5,26,20,13
22,1903,ELKHART ISD,7,english,4,108,16,92,61,26,108,15,93,66,36
22,1904,FRANKSTON ISD,7,english,4,45,5,40,33,15,45,8,37,32,15
22,1906,NECHES ISD,7,english,4,25,0,25,19,7,25,2,23,16,4
22,1907,PALESTINE ISD,7,english,4,203,67,136,83,32,203,85,118,54,20
22,1908,WESTWOOD ISD,7,english,4,90,23,67,43,17,91,29,62,35,17
22,1909,SLOCUM ISD,7,english,4,31,8,23,17,9,31,14,17,7,3
22,2901,ANDREWS ISD,18,english,4,286,51,235,145,63,288,98,190,90,40
22,3801,PINEYWOODS COMM,7,english,4,82,18,64,49,30,82,20,62,41,28
22,3902,HUDSON ISD,7,english,4,206,32,174,110,45,206,30,176,95,46
22,3903,LUFKIN ISD,7,english,4,532,136,396,241,112,536,203,333,163,75
22,3904,HUNTINGTON ISD,7,english,4,103,21,82,46,26,103,35,68,39,18
22,3905,DIBOLL ISD,7,english,4,116,29,87,50,16,116,45,71,26,10
22,3906,ZAVALLA ISD,7,english,4,18,2,16,13,5,18,2,16,6,4
22,3907,CENTRAL ISD,7,english,4,110,23,87,65,30,110,27,83,50,25
22,4901,ARANSAS COUNTY,2,english,4,214,68,146,93,37,213,114,99,46,24
22,5901,ARCHER CITY ISD,9,english,4,32,6,26,21,12,32,2,30,21,16
22,5902,HOLLIDAY ISD,9,english,4,86,20,66,50,27,86,17,69,42,32
22,5904,WINDTHORST ISD,9,english,4,40,2,38,28,15,40,2,38,29,18
22,6902,CLAUDE ISD,16,english,4,22,0,22,18,10,22,5,17,12,9
22,7901,CHARLOTTE ISD,20,english,4,27,3,24,16,5,27,3,24,17,11
22,7902,JOURDANTON ISD,20,english,4,119,23,96,65,33,119,25,94,57,31
22,7904,LYTLE ISD,20,english,4,131,43,88,39,9,130,61,69,33,18
22,7905,PLEASANTON ISD,20,english,4,230,63,167,103,58,230,83,147,82,46
22,7906,POTEET ISD,20,english,4,112,36,76,41,20,112,54,58,29,12
22,8901,BELLVILLE ISD,6,english,4,165,39,126,77,34,164,79,85,32,10
22,8902,SEALY ISD,6,english,4,212,58,154,104,47,213,83,130,78,39
22,8903,BRAZOS ISD,6,english,4,48,7,41,30,14,48,10,38,21,12
22,9901,MULESHOE ISD,17,english,4,90,30,60,32,14,90,41,49,31,13
22,10901,MEDINA ISD,20,english,4,15,7,8,7,4,15,8,7,4,2
22,10902,BANDERA ISD,20,english,4,167,53,114,66,28,167,77,90,49,24
22,11901,BASTROP ISD,13,english,4,789,281,508,303,124,794,403,391,191,87
22,11902,ELGIN ISD,13,english,4,241,88,153,79,34,304,199,105,40,15
22,11904,SMITHVILLE ISD,13,english,4,138,28,110,71,33,138,34,104,68,28
22,11905,MCDADE ISD,13,english,4,21,11,10,4,3,21,11,10,3,2
22,12901,SEYMOUR ISD,9,english,4,46,4,42,31,20,46,7,39,26,18
22,13801,ST MARY'S ACADE,2,english,4,56,20,36,24,13,56,28,28,11,6
22,13901,BEEVILLE ISD,2,english,4,165,32,133,87,40,164,38,126,74,39
22,13902,PAWNEE ISD,2,english,4,9,0,9,6,2,9,3,6,4,2
22,13903,PETTUS ISD,2,english,4,23,8,15,7,4,23,13,10,4,1
22,13905,SKIDMORE-TYNAN,2,english,4,65,8,57,33,14,65,20,45,23,8
22,14803,PRIORITY CHARTE,12,english,4,71,25,46,33,15,71,40,31,14,2
22,14804,ORENDA CHARTER,12,english,4,151,12,139,113,64,151,24,127,94,63
22,14901,ACADEMY ISD,12,english,4,127,38,89,57,23,127,31,96,58,25
22,14902,BARTLETT ISD,13,english,4,24,15,9,4,1,24,16,8,1,0
22,14903,BELTON ISD,12,english,4,916,194,722,501,259,919,267,652,405,227
22,14905,HOLLAND ISD,12,english,4,55,13,42,27,14,55,20,35,20,7
22,14906,KILLEEN ISD,12,english,4,3065,826,2239,1440,700,3071,1222,1849,965,478
22,14907,ROGERS ISD,12,english,4,69,21,48,27,16,69,18,51,27,13
22,14908,SALADO ISD,12,english,4,161,32,129,86,56,161,29,132,80,45
22,14909,TEMPLE ISD,12,english,4,559,162,397,242,116,598,246,352,175,79
22,14910,TROY ISD,12,english,4,134,44,90,57,27,134,31,103,66,38
22,15802,GEORGE GERVIN A,20,english,4,39,20,19,9,4,39,24,15,9,3
22,15806,LEGACY TRADITIO,20,english,4,27,17,10,5,0,27,22,5,2,0
22,15807,SOUTHWEST PREPA,20,english,4,55,19,36,21,12,55,38,17,7,2
22,15808,INSPIRE ACADEMI,20,english,4,29,7,22,12,6,29,17,12,6,2
22,15809,BEXAR COUNTY AC,20,english,4,29,18,11,6,1,29,24,5,2,0
22,15815,HERITAGE ACADEM,20,english,4,23,5,18,10,4,23,6,17,9,7
22,15822,JUBILEE ACADEMI,20,english,4,491,223,268,137,49,491,274,217,109,52
22,15825,LIGHTHOUSE PUBL,20,english,4,24,8,16,10,7,24,17,7,2,0
22,15827,SCHOOL OF SCIEN,20,english,4,273,84,189,127,62,269,112,157,84,39
22,15828,HARMONY PUBLIC,20,english,4,262,79,183,96,41,263,147,116,48,15
22,15830,BROOKS ACADEMIE,20,english,4,242,64,178,113,59,242,129,113,54,31
22,15831,SCHOOL OF SCIEN,20,english,4,489,88,401,286,161,490,174,316,177,95
22,15834,BASIS TEXAS,20,english,4,370,19,351,307,222,370,40,330,260,168
22,15835,GREAT HEARTS TE,20,english,4,834,122,712,546,289,835,206,629,366,210
22,15836,ELEANOR KOLITZ,20,english,4,59,6,53,46,29,59,15,44,30,16
22,15838,COMPASS ROSE PU,20,english,4,156,72,84,50,19,156,100,56,25,9
22,15901,ALAMO HEIGHTS I,20,english,4,326,33,293,242,173,328,73,255,180,116
22,15904,HARLANDALE ISD,20,english,4,692,226,466,267,104,684,340,344,123,46
22,15905,EDGEWOOD ISD,20,english,4,455,206,249,127,51,576,361,215,78,29
22,15906,RANDOLPH FIELD,20,english,4,113,4,109,89,52,113,16,97,69,52
22,15907,SAN ANTONIO ISD,20,english,4,2465,968,1497,855,362,2545,1362,1183,532,260
22,15908,SOUTH SAN ANTON,20,english,4,425,172,253,142,67,452,264,188,82,37
22,15909,SOMERSET ISD,20,english,4,232,36,196,143,68,251,31,220,164,108
22,15910,NORTH EAST ISD,20,english,4,3639,663,2976,2162,1177,3381,950,2431,1508,841
22,15911,EAST CENTRAL IS,20,english,4,600,249,351,198,70,641,349,292,123,63
22,15912,SOUTHWEST ISD,20,english,4,869,210,659,435,202,876,289,587,319,153
22,15913,LACKLAND ISD,20,english,4,95,19,76,52,23,95,27,68,34,17
22,15914,FT SAM HOUSTON,20,english,4,117,20,97,77,34,117,27,90,48,29
22,15915,NORTHSIDE ISD,20,english,4,6895,1808,5087,3439,1756,6891,2673,4218,2243,1149
22,15916,JUDSON ISD,20,english,4,1678,402,1276,824,392,1683,617,1066,520,253
22,15917,SOUTHSIDE ISD,20,english,4,287,87,200,131,51,355,116,239,149,79
22,16901,JOHNSON CITY IS,13,english,4,46,4,42,32,21,46,9,37,23,12
22,16902,BLANCO ISD,13,english,4,72,13,59,39,17,72,15,57,37,20
22,17901,BORDEN COUNTY I,17,english,4,12,0,12,8,3,12,1,11,6,5
22,18901,CLIFTON ISD,12,english,4,79,21,58,34,13,79,35,44,12,3
22,18902,MERIDIAN ISD,12,english,4,31,9,22,12,4,31,14,17,10,5
22,18903,MORGAN ISD,12,english,4,9,5,4,3,1,9,7,2,1,0
22,18904,VALLEY MILLS IS,12,english,4,42,13,29,20,11,42,13,29,18,8
22,18905,WALNUT SPRINGS,12,english,4,11,4,7,3,1,11,7,4,1,1
22,18906,IREDELL ISD,12,english,4,9,0,9,8,6,9,0,9,7,4
22,18907,KOPPERL ISD,12,english,4,18,3,15,10,5,18,6,12,6,4
22,18908,CRANFILLS GAP I,12,english,4,6,1,5,4,3,6,5,1,0,0
22,19901,DEKALB ISD,8,english,4,49,5,44,33,19,49,10,39,29,17
22,19902,HOOKS ISD,8,english,4,59,5,54,38,17,59,14,45,28,11
22,19903,MAUD ISD,8,english,4,33,5,28,22,12,32,9,23,16,6
22,19905,NEW BOSTON ISD,8,english,4,75,34,41,24,11,75,42,33,18,9
22,19906,REDWATER ISD,8,english,4,75,19,56,37,21,76,10,66,44,23
22,19907,TEXARKANA ISD,8,english,4,485,149,336,228,113,503,216,287,159,98
22,19908,LIBERTY-EYLAU I,8,english,4,135,50,85,41,16,135,46,89,51,23
22,19909,SIMMS ISD,8,english,4,41,6,35,22,7,41,7,34,22,12
22,19910,MALTA ISD,8,english,4,27,2,25,14,7,27,8,19,9,3
22,19911,RED LICK ISD,8,english,4,72,4,68,51,29,72,4,68,54,23
22,19912,PLEASANT GROVE,8,english,4,160,11,149,125,79,160,8,152,125,79
22,19913,HUBBARD ISD,8,english,4,0,,,,,0,,,,
22,19914,LEARY ISD,8,english,4,6,0,6,6,2,6,1,5,2,2
22,20901,ALVIN ISD,4,english,4,1979,394,1585,1141,631,1988,562,1426,883,525
22,20902,ANGLETON ISD,4,english,4,486,55,431,320,165,486,99,387,247,132
22,20904,DANBURY ISD,4,english,4,48,4,44,33,16,48,7,41,29,17
22,20905,BRAZOSPORT ISD,4,english,4,797,124,673,506,273,801,160,641,439,251
22,20906,SWEENY ISD,4,english,4,150,34,116,73,34,151,53,98,50,27
22,20907,COLUMBIA-BRAZOR,4,english,4,222,63,159,100,41,222,60,162,85,46
22,20908,PEARLAND ISD,4,english,4,1494,166,1328,1064,644,1496,198,1298,996,627
22,20910,DAMON ISD,4,english,4,10,4,6,4,3,10,2,8,5,3
22,21803,BRAZOS SCHOOL F,6,english,4,33,17,16,9,6,33,12,21,8,5
22,21805,ARROW ACADEMY,6,english,4,84,21,63,43,20,84,37,47,21,6
22,21901,COLLEGE STATION,6,english,4,962,161,801,597,365,961,210,751,547,363
22,21902,BRYAN ISD,6,english,4,1063,272,791,488,239,1065,341,724,370,176
22,22004,TERLINGUA CSD,18,english,4,9,8,1,1,0,9,7,2,0,0
22,22901,ALPINE ISD,18,english,4,63,16,47,26,10,63,36,27,13,5
22,22902,MARATHON ISD,18,english,4,0,,,,,0,,,,
22,23902,SILVERTON ISD,16,english,4,19,5,14,7,2,19,6,13,7,4
22,24901,BROOKS COUNTY I,1,english,4,101,47,54,27,14,101,68,33,10,7
22,25901,BANGS ISD,15,english,4,64,17,47,35,14,64,12,52,34,14
22,25902,BROWNWOOD ISD,15,english,4,227,52,175,121,54,227,64,163,96,47
22,25904,BLANKET ISD,15,english,4,12,6,6,1,0,12,11,1,0,0
22,25905,MAY ISD,15,english,4,13,5,8,4,2,13,4,9,4,1
22,25906,ZEPHYR ISD,15,english,4,18,4,14,10,4,18,6,12,5,3
22,25908,BROOKESMITH ISD,15,english,4,20,12,8,6,4,20,14,6,3,1
22,25909,EARLY ISD,15,english,4,87,8,79,53,26,87,33,54,25,10
22,26901,CALDWELL ISD,6,english,4,118,18,100,66,30,119,25,94,56,22
22,26902,SOMERVILLE ISD,6,english,4,33,18,15,9,3,33,17,16,8,3
22,26903,SNOOK ISD,6,english,4,37,12,25,17,8,37,13,24,16,10
22,27903,BURNET CISD,13,english,4,216,72,144,93,40,214,90,124,64,39
22,27904,MARBLE FALLS IS,13,english,4,256,56,200,137,75,269,105,164,90,48
22,28902,LOCKHART ISD,13,english,4,429,118,311,190,81,430,133,297,152,75
22,28903,LULING ISD,13,english,4,93,29,64,39,21,93,32,61,34,18
22,28906,PRAIRIE LEA ISD,13,english,4,15,9,6,3,1,15,10,5,1,0
22,29901,CALHOUN COUNTY,3,english,4,250,38,212,149,68,250,38,212,153,85
22,30901,CROSS PLAINS IS,14,english,4,25,1,24,19,6,25,4,21,15,5
22,30902,CLYDE CISD,14,english,4,100,18,82,56,26,100,24,76,47,25
22,30903,BAIRD ISD,14,english,4,17,4,13,8,3,17,3,14,8,4
22,30906,EULA ISD,14,english,4,28,7,21,13,7,28,12,16,5,1
22,31901,BROWNSVILLE ISD,1,english,4,2449,490,1959,1349,643,2454,578,1876,1196,622
22,31903,HARLINGEN CISD,1,english,4,1158,274,884,592,290,1154,383,771,430,217
22,31905,LA FERIA ISD,1,english,4,195,50,145,83,34,195,54,141,76,39
22,31906,LOS FRESNOS CIS,1,english,4,724,122,602,432,242,725,152,573,376,192
22,31909,POINT ISABEL IS,1,english,4,150,47,103,52,25,150,34,116,46,13
22,31911,RIO HONDO ISD,1,english,4,107,40,67,42,17,107,38,69,33,16
22,31912,SAN BENITO CISD,1,english,4,645,184,461,283,130,645,235,410,235,115
22,31913,SANTA MARIA ISD,1,english,4,35,10,25,16,6,35,13,22,15,7
22,31914,SANTA ROSA ISD,1,english,4,72,26,46,25,11,71,36,35,19,9
22,32902,PITTSBURG ISD,8,english,4,138,13,125,86,39,138,19,119,60,27
22,33901,GROOM ISD,16,english,4,11,3,8,5,3,11,1,10,6,3
22,33902,PANHANDLE ISD,16,english,4,46,4,42,31,15,46,10,36,23,13
22,33904,WHITE DEER ISD,16,english,4,16,5,11,9,2,16,6,10,7,3
22,34901,ATLANTA ISD,8,english,4,154,14,140,105,56,154,25,129,84,57
22,34902,AVINGER ISD,8,english,4,7,1,6,4,4,7,3,4,2,0
22,34903,HUGHES SPRINGS,8,english,4,70,11,59,45,24,70,13,57,37,11
22,34905,LINDEN-KILDARE,8,english,4,49,13,36,21,12,49,16,33,16,7
22,34906,MCLEOD ISD,8,english,4,33,2,31,24,15,33,3,30,17,8
22,34907,QUEEN CITY ISD,8,english,4,47,11,36,23,13,47,12,35,24,16
22,34909,BLOOMBURG ISD,8,english,4,18,3,15,11,3,18,8,10,7,6
22,35901,DIMMITT ISD,16,english,4,76,18,58,34,16,76,35,41,20,10
22,35902,HART ISD,16,english,4,10,1,9,9,4,10,1,9,8,1
22,35903,NAZARETH ISD,16,english,4,19,1,18,14,6,19,2,17,14,10
22,36901,ANAHUAC ISD,4,english,4,100,32,68,39,17,100,30,70,42,27
22,36902,BARBERS HILL IS,4,english,4,454,39,415,332,190,454,37,417,332,216
22,36903,EAST CHAMBERS I,5,english,4,115,22,93,65,36,115,22,93,66,36
22,37901,ALTO ISD,7,english,4,38,14,24,13,8,38,10,28,15,9
22,37904,JACKSONVILLE IS,7,english,4,229,51,178,117,56,316,80,236,123,51
22,37907,RUSK ISD,7,english,4,160,53,107,70,27,160,74,86,37,16
22,37908,NEW SUMMERFIELD,7,english,4,46,10,36,19,12,46,9,37,23,13
22,37909,WELLS ISD,7,english,4,21,7,14,11,7,21,5,16,8,5
22,38901,CHILDRESS ISD,16,english,4,76,14,62,51,22,76,13,63,47,24
22,39902,HENRIETTA ISD,9,english,4,75,22,53,35,18,75,19,56,27,14
22,39903,PETROLIA CISD,9,english,4,29,11,18,9,2,29,15,14,7,2
22,39904,BELLEVUE ISD,9,english,4,9,2,7,4,0,9,3,6,1,1
22,39905,MIDWAY ISD,9,english,4,10,4,6,3,3,10,4,6,3,2
22,40901,MORTON ISD,17,english,4,23,8,15,8,4,23,10,13,6,1
22,40902,WHITEFACE CISD,17,english,4,22,5,17,8,4,22,6,16,6,2
22,41901,BRONTE ISD,15,english,4,20,6,14,10,4,20,8,12,1,1
22,41902,ROBERT LEE ISD,15,english,4,19,6,13,6,3,19,13,6,4,2
22,42901,COLEMAN ISD,15,english,4,72,22,50,29,15,72,33,39,21,9
22,42903,SANTA ANNA ISD,15,english,4,20,3,17,10,4,20,6,14,9,2
22,42905,PANTHER CREEK C,15,english,4,6,2,4,1,1,6,5,1,0,0
22,43801,IMAGINE INTERNA,10,english,4,123,7,116,103,80,123,10,113,87,55
22,43802,LONE STAR LANGU,10,english,4,21,1,20,19,11,21,2,19,15,9
22,43901,ALLEN ISD,10,english,4,1595,181,1414,1107,680,1600,257,1343,999,665
22,43902,ANNA ISD,10,english,4,337,82,255,170,92,339,104,235,140,72
22,43903,CELINA ISD,10,english,4,238,26,212,168,100,244,37,207,137,87
22,43904,FARMERSVILLE IS,10,english,4,143,10,133,89,43,143,46,97,54,22
22,43905,FRISCO ISD,10,english,4,4818,529,4289,3546,2344,4828,818,4010,3013,2040
22,43907,MCKINNEY ISD,10,english,4,1507,231,1276,978,567,1526,362,1164,782,450
22,43908,MELISSA ISD,10,english,4,404,40,364,295,163,405,62,343,229,142
22,43910,PLANO ISD,10,english,4,3309,528,2781,2184,1386,3324,839,2485,1738,1157
22,43911,PRINCETON ISD,10,english,4,542,135,407,292,153,542,141,401,257,135
22,43912,PROSPER ISD,10,english,4,1807,243,1564,1184,678,1807,290,1517,1053,645
22,43914,WYLIE ISD,10,english,4,1376,97,1279,1090,743,1407,130,1277,1047,774
22,43917,BLUE RIDGE ISD,10,english,4,76,16,60,40,20,76,24,52,34,18
22,43918,COMMUNITY ISD,10,english,4,229,42,187,119,60,267,94,173,81,33
22,43919,LOVEJOY ISD,10,english,4,304,13,291,250,181,305,14,291,257,196
22,44902,WELLINGTON ISD,16,english,4,47,13,34,22,10,47,9,38,21,14
22,45902,COLUMBUS ISD,3,english,4,85,22,63,41,21,85,29,56,30,17
22,45903,RICE CISD,3,english,4,89,23,66,42,22,89,10,79,56,31
22,45905,WEIMAR ISD,3,english,4,45,6,39,29,18,45,8,37,27,14
22,46802,TRINITY CHARTER,20,english,4,0,,,,,0,,,,
22,46901,NEW BRAUNFELS I,13,english,4,677,86,591,454,235,684,161,523,322,168
22,46902,COMAL ISD,20,english,4,1977,229,1748,1398,826,1977,294,1683,1239,804
22,47901,COMANCHE ISD,14,english,4,95,25,70,38,16,95,35,60,38,19
22,47902,DE LEON ISD,14,english,4,43,7,36,27,11,43,6,37,23,13
22,47903,GUSTINE ISD,14,english,4,8,2,6,5,2,8,1,7,3,1
22,47905,SIDNEY ISD,14,english,4,9,3,6,2,0,9,4,5,1,1
22,48901,EDEN CISD,15,english,4,15,3,12,8,3,15,3,12,5,1
22,48903,PAINT ROCK ISD,15,english,4,17,0,17,11,3,17,6,11,4,0
22,49901,GAINESVILLE ISD,11,english,4,169,68,101,60,27,189,77,112,45,24
22,49902,MUENSTER ISD,11,english,4,38,0,38,34,19,38,0,38,31,23
22,49903,VALLEY VIEW ISD,11,english,4,61,13,48,29,13,61,15,46,26,13
22,49905,CALLISBURG ISD,11,english,4,86,33,53,35,14,86,27,59,35,21
22,49906,ERA ISD,11,english,4,33,2,31,21,10,33,1,32,27,16
22,49907,LINDSAY ISD,11,english,4,47,7,40,27,13,47,11,36,18,8
22,49908,WALNUT BEND ISD,11,english,4,0,,,,,0,,,,
22,49909,SIVELLS BEND IS,11,english,4,0,,,,,0,,,,
22,50901,EVANT ISD,12,english,4,11,2,9,3,1,11,3,8,2,1
22,50902,GATESVILLE ISD,12,english,4,182,39,143,96,54,182,68,114,70,40
22,50904,OGLESBY ISD,12,english,4,16,1,15,11,6,16,6,10,6,2
22,50909,JONESBORO ISD,12,english,4,22,9,13,8,3,22,12,10,1,0
22,50910,COPPERAS COVE I,12,english,4,543,118,425,285,130,546,149,397,252,143
22,51901,PADUCAH ISD,17,english,4,9,5,4,3,2,9,3,6,2,2
22,52901,CRANE ISD,15,english,4,70,19,51,31,18,70,21,49,27,20
22,53001,CROCKETT COUNTY,15,english,4,48,4,44,29,16,48,8,40,21,12
22,54901,CROSBYTON CISD,17,english,4,20,6,14,8,2,20,12,8,4,0
22,54902,LORENZO ISD,17,english,4,14,2,12,4,1,14,8,6,3,0
22,54903,RALLS ISD,17,english,4,30,14,16,10,5,30,18,12,5,3
22,55901,CULBERSON COUNT,18,english,4,21,2,19,12,4,21,9,12,4,1
22,56901,DALHART ISD,16,english,4,113,50,63,37,18,113,56,57,27,14
22,56902,TEXLINE ISD,16,english,4,18,1,17,12,6,18,4,14,10,5
22,57802,PEGASUS SCHOOL,10,english,4,39,15,24,13,2,39,22,17,5,3
22,57803,UPLIFT EDUCATIO,10,english,4,1697,547,1150,698,349,1698,788,910,443,212
22,57806,ADVANTAGE ACADE,10,english,4,70,35,35,16,6,70,59,11,1,1
22,57807,LIFE SCHOOL,10,english,4,435,150,285,166,68,437,176,261,133,67
22,57808,UNIVERSAL ACADE,10,english,4,177,14,163,132,89,177,24,153,117,86
22,57809,NOVA ACADEMY,10,english,4,15,7,8,5,2,15,7,8,1,0
22,57810,ACADEMY OF DALL,10,english,4,15,8,7,4,2,15,7,8,5,2
22,57813,TRINITY BASIN P,10,english,4,406,139,267,161,63,406,191,215,106,49
22,57816,A W BROWN LEADE,10,english,4,79,37,42,25,12,79,64,15,3,2
22,57819,JEAN MASSIEU AC,10,english,4,13,4,9,3,1,13,3,10,0,0
22,57827,NOVA ACADEMY SO,10,english,4,37,11,26,15,9,38,24,14,6,1
22,57829,A+ ACADEMY,10,english,4,92,41,51,24,11,92,41,51,25,13
22,57830,INSPIRED VISION,10,english,4,73,27,46,29,14,73,29,44,16,7
22,57831,GATEWAY CHARTER,10,english,4,27,13,14,10,4,27,15,12,4,0
22,57833,EDUCATION CENTE,10,english,4,42,13,29,18,4,42,25,17,6,1
22,57835,GOLDEN RULE CHA,10,english,4,123,21,102,68,33,125,26,99,57,34
22,57836,ST ANTHONY SCHO,10,english,4,35,13,22,12,3,35,12,23,8,3
22,57839,LA ACADEMIA DE,10,english,4,88,23,65,38,17,88,13,75,45,18
22,57841,CITYSCAPE SCHOO,10,english,4,93,58,35,16,6,110,89,21,4,1
22,57844,MANARA ACADEMY,10,english,4,47,12,35,21,8,47,27,20,6,3
22,57845,UME PREPARATORY,10,english,4,102,10,92,62,39,102,23,79,35,21
22,57846,LEGACY PREPARAT,10,english,4,113,51,62,33,19,113,84,29,6,2
22,57847,VILLAGE TECH SC,10,english,4,90,16,74,44,21,88,54,34,9,3
22,57848,INTERNATIONAL L,10,english,4,1801,607,1194,759,382,1823,963,860,419,212
22,57850,PIONEER TECHNOL,10,english,4,155,24,131,92,46,155,40,115,55,28
22,57851,BRIDGEWAY PREPA,10,english,4,11,5,6,3,2,11,4,7,2,1
22,57903,CARROLLTON-FARM,10,english,4,1371,340,1031,711,383,1612,523,1089,635,299
22,57904,CEDAR HILL ISD,10,english,4,433,138,295,169,75,432,183,249,128,48
22,57905,DALLAS ISD,10,english,4,6290,1785,4505,3024,1573,9640,3298,6342,3567,1782
22,57906,DESOTO ISD,10,english,4,379,115,264,159,78,389,166,223,120,64
22,57907,DUNCANVILLE ISD,10,english,4,574,214,360,209,78,700,352,348,164,65
22,57909,GARLAND ISD,10,english,4,2952,660,2292,1646,901,3602,1117,2485,1468,794
22,57910,GRAND PRAIRIE I,10,english,4,1412,333,1079,758,380,1784,645,1139,654,315
22,57911,HIGHLAND PARK I,10,english,4,477,27,450,388,261,477,27,450,367,267
22,57912,IRVING ISD,10,english,4,2058,760,1298,773,330,2064,985,1079,473,217
22,57913,LANCASTER ISD,10,english,4,449,133,316,194,83,450,183,267,132,54
22,57914,MESQUITE ISD,10,english,4,2366,676,1690,1092,520,2401,785,1616,905,470
22,57916,RICHARDSON ISD,10,english,4,2662,637,2025,1470,860,2679,812,1867,1199,687
22,57919,SUNNYVALE ISD,10,english,4,151,20,131,100,59,151,30,121,79,40
22,57922,COPPELL ISD,10,english,4,966,96,870,750,521,965,134,831,675,495
22,58902,DAWSON ISD,17,english,4,15,3,12,3,0,15,13,2,0,0
22,58905,KLONDIKE ISD,17,english,4,17,2,15,11,7,17,3,14,10,5
22,58906,LAMESA ISD,17,english,4,123,41,82,40,19,123,70,53,19,7
22,58909,SANDS CISD,17,english,4,27,1,26,15,7,27,3,24,16,7
22,59901,HEREFORD ISD,16,english,4,220,61,159,98,44,220,84,136,65,24
22,59902,WALCOTT ISD,16,english,4,19,0,19,16,8,19,0,19,16,10
22,60902,COOPER ISD,8,english,4,62,13,49,29,12,63,21,42,13,5
22,60914,FANNINDEL ISD,8,english,4,12,5,7,2,1,12,7,5,3,1
22,61802,NORTH TEXAS COL,11,english,4,49,14,35,20,12,49,20,29,13,10
22,61804,LEADERSHIP PREP,10,english,4,100,7,93,73,47,100,16,84,61,37
22,61805,TRIVIUM ACADEMY,11,english,4,61,10,51,40,22,61,7,54,34,19
22,61901,DENTON ISD,11,english,4,2121,482,1639,1140,608,2198,769,1429,819,422
22,61902,LEWISVILLE ISD,11,english,4,3164,503,2661,2062,1243,3173,829,2344,1572,907
22,61903,PILOT POINT ISD,11,english,4,106,16,90,48,25,107,18,89,60,29
22,61905,KRUM ISD,11,english,4,166,27,139,108,51,167,42,125,71,35
22,61906,PONDER ISD,11,english,4,95,21,74,50,26,95,14,81,56,32
22,61907,AUBREY ISD,11,english,4,247,43,204,154,93,247,69,178,117,57
22,61908,SANGER ISD,11,english,4,186,22,164,115,57,186,34,152,83,43
22,61910,ARGYLE ISD,11,english,4,323,31,292,239,144,323,33,290,214,150
22,61911,NORTHWEST ISD,11,english,4,2186,386,1800,1324,755,2183,631,1552,970,580
22,61912,LAKE DALLAS ISD,11,english,4,272,58,214,141,64,273,99,174,91,49
22,61914,LITTLE ELM ISD,11,english,4,581,151,430,292,159,608,221,387,218,122
22,62901,CUERO ISD,3,english,4,125,37,88,53,26,126,54,72,35,18
22,62902,NORDHEIM ISD,3,english,4,11,3,8,6,4,11,5,6,5,1
22,62903,YOAKUM ISD,3,english,4,104,22,82,57,23,104,12,92,61,32
22,62904,YORKTOWN ISD,3,english,4,45,17,28,17,7,45,21,24,14,7
22,62905,WESTHOFF ISD,3,english,4,7,0,7,6,2,7,1,6,6,4
22,62906,MEYERSVILLE ISD,3,english,4,7,1,6,6,4,7,1,6,4,1
22,63903,SPUR ISD,17,english,4,13,0,13,13,6,13,0,13,13,7
22,63906,PATTON SPRINGS,17,english,4,0,,,,,0,,,,
22,64903,CARRIZO SPRINGS,20,english,4,140,60,80,55,20,140,73,67,34,17
22,65901,CLARENDON ISD,16,english,4,25,6,19,13,10,25,7,18,10,4
22,65902,HEDLEY ISD,16,english,4,8,1,7,4,2,8,3,5,4,2
22,66901,BENAVIDES ISD,2,english,4,16,4,12,8,2,16,7,9,4,1
22,66902,SAN DIEGO ISD,2,english,4,114,33,81,42,15,114,53,61,34,15
22,66903,FREER ISD,2,english,4,48,15,33,20,8,48,14,34,21,9
22,67902,CISCO ISD,14,english,4,47,6,41,29,20,48,5,43,29,16
22,67903,EASTLAND ISD,14,english,4,58,16,42,26,11,58,22,36,19,10
22,67904,GORMAN ISD,14,english,4,10,1,9,6,1,10,3,7,5,2
22,67907,RANGER ISD,14,english,4,22,5,17,13,2,22,5,17,7,1
22,67908,RISING STAR ISD,14,english,4,9,4,5,2,1,9,3,6,2,0
22,68802,COMPASS ACADEMY,18,english,4,118,25,93,60,30,118,30,88,51,21
22,68803,UTPB STEM ACADE,18,english,4,61,11,50,29,14,61,15,46,26,14
22,68901,ECTOR COUNTY IS,18,english,4,2138,684,1454,876,390,2205,847,1358,747,344
22,69901,ROCKSPRINGS ISD,15,english,4,20,9,11,5,1,20,12,8,2,0
22,69902,NUECES CANYON C,15,english,4,22,3,19,13,3,22,10,12,3,0
22,70801,WAXAHACHIE FAIT,10,english,4,143,87,56,29,13,147,101,46,17,7
22,70901,AVALON ISD,10,english,4,35,13,22,11,4,35,20,15,3,2
22,70903,ENNIS ISD,10,english,4,419,97,322,210,78,419,114,305,185,98
22,70905,FERRIS ISD,10,english,4,153,49,104,70,29,165,57,108,52,21
22,70907,ITALY ISD,10,english,4,37,16,21,10,4,37,18,19,10,4
22,70908,MIDLOTHIAN ISD,10,english,4,743,111,632,456,256,754,135,619,438,259
22,70909,MILFORD ISD,10,english,4,13,6,7,2,0,13,10,3,2,1
22,70910,PALMER ISD,10,english,4,112,18,94,70,37,112,18,94,65,31
22,70911,RED OAK ISD,10,english,4,429,82,347,239,110,438,113,325,198,99
22,70912,WAXAHACHIE ISD,10,english,4,679,153,526,350,174,699,232,467,254,118
22,70915,MAYPEARL ISD,10,english,4,78,10,68,52,24,77,16,61,33,14
22,71801,BURNHAM WOOD CH,19,english,4,76,7,69,52,21,77,27,50,22,7
22,71806,HARMONY PUBLIC,19,english,4,348,86,262,194,93,349,116,233,109,49
22,71807,LA FE PREPARATO,19,english,4,9,1,8,7,3,9,2,7,4,1
22,71809,VISTA DEL FUTUR,19,english,4,47,6,41,28,14,47,11,36,14,8
22,71901,CLINT ISD,19,english,4,656,218,438,225,94,664,288,376,152,61
22,71902,EL PASO ISD,19,english,4,2847,529,2318,1644,865,2882,824,2058,1161,590
22,71903,FABENS ISD,19,english,4,72,12,60,38,20,79,14,65,41,19
22,71904,SAN ELIZARIO IS,19,english,4,163,49,114,74,38,206,73,133,61,21
22,71905,YSLETA ISD,19,english,4,2216,501,1715,1132,512,2298,571,1727,1039,538
22,71906,ANTHONY ISD,19,english,4,52,14,38,21,7,52,24,28,9,4
22,71907,CANUTILLO ISD,19,english,4,357,60,297,207,115,365,109,256,162,85
22,71908,TORNILLO ISD,19,english,4,32,8,24,13,5,54,11,43,25,13
22,71909,SOCORRO ISD,19,english,4,3086,652,2434,1650,785,3097,953,2144,1156,532
22,72901,THREE WAY ISD,11,english,4,10,2,8,5,0,10,5,5,2,0
22,72902,DUBLIN ISD,11,english,4,81,2,79,62,28,81,5,76,56,30
22,72903,STEPHENVILLE IS,11,english,4,240,27,213,162,91,253,30,223,187,124
22,72904,BLUFF DALE ISD,11,english,4,19,2,17,11,6,19,6,13,8,5
22,72908,HUCKABAY ISD,11,english,4,32,6,26,17,6,32,14,18,7,3
22,72909,LINGLEVILLE ISD,11,english,4,20,2,18,10,4,20,3,17,7,3
22,72910,MORGAN MILL ISD,11,english,4,8,0,8,4,1,8,1,7,4,1
22,73901,CHILTON ISD,12,english,4,39,9,30,20,13,39,10,29,14,5
22,73903,MARLIN ISD,12,english,4,70,27,43,23,13,70,36,34,10,4
22,73904,WESTPHALIA ISD,12,english,4,14,0,14,10,6,14,0,14,10,6
22,73905,ROSEBUD-LOTT IS,12,english,4,57,18,39,22,9,57,26,31,17,9
22,74903,BONHAM ISD,10,english,4,109,19,90,57,28,109,43,66,28,10
22,74904,DODD CITY ISD,10,english,4,23,8,15,12,7,23,8,15,7,3
22,74905,ECTOR ISD,10,english,4,10,2,8,6,3,11,4,7,5,2
22,74907,HONEY GROVE ISD,8,english,4,45,4,41,32,16,45,9,36,21,13
22,74909,LEONARD ISD,10,english,4,56,14,42,26,12,56,13,43,20,9
22,74911,SAVOY ISD,10,english,4,29,3,26,16,6,29,13,16,9,5
22,74912,TRENTON ISD,10,english,4,53,8,45,29,13,53,19,34,21,7
22,74917,SAM RAYBURN ISD,10,english,4,39,4,35,30,12,39,7,32,17,8
22,75901,FLATONIA ISD,13,english,4,31,2,29,21,8,31,2,29,22,16
22,75902,LA GRANGE ISD,13,english,4,127,27,100,66,30,127,43,84,44,16
22,75903,SCHULENBURG ISD,13,english,4,46,11,35,23,8,46,10,36,19,9
22,75906,FAYETTEVILLE IS,13,english,4,12,1,11,8,4,12,1,11,5,2
22,75908,ROUND TOP-CARMI,13,english,4,18,3,15,11,6,18,3,15,13,10
22,76903,ROBY CISD,14,english,4,25,5,20,11,8,25,16,9,3,1
22,76904,ROTAN ISD,14,english,4,14,4,10,6,2,14,5,9,3,1
22,77901,FLOYDADA COLLEG,17,english,4,45,15,30,20,8,45,12,33,18,9
22,77902,LOCKNEY ISD,17,english,4,27,12,15,10,3,27,7,20,7,2
22,78901,CROWELL ISD,9,english,4,19,5,14,8,5,19,7,12,4,2
22,79901,LAMAR CISD,4,english,4,2909,399,2510,1959,1120,2922,551,2371,1629,1019
22,79906,NEEDVILLE ISD,4,english,4,220,24,196,143,90,220,19,201,142,89
22,79907,FORT BEND ISD,4,english,4,5581,1007,4574,3513,2132,5591,1541,4050,2708,1648
22,79910,STAFFORD MSD,4,english,4,245,90,155,95,53,243,98,145,66,39
22,80901,MOUNT VERNON IS,8,english,4,107,19,88,54,27,117,26,91,46,23
22,81902,FAIRFIELD ISD,12,english,4,122,28,94,57,33,122,27,95,50,24
22,81904,TEAGUE ISD,12,english,4,73,8,65,53,23,73,12,61,35,18
22,81905,WORTHAM ISD,12,english,4,44,14,30,14,6,44,12,32,13,5
22,81906,DEW ISD,12,english,4,15,1,14,12,4,15,5,10,6,1
22,82902,DILLEY ISD,20,english,4,70,19,51,35,15,70,24,46,21,12
22,82903,PEARSALL ISD,20,english,4,130,54,76,41,13,130,79,51,17,3
22,83901,SEAGRAVES ISD,17,english,4,37,12,25,13,6,37,19,18,10,6
22,83902,LOOP ISD,17,english,4,12,1,11,4,1,12,1,11,4,1
22,83903,SEMINOLE ISD,17,english,4,212,50,162,116,66,212,40,172,116,72
22,84802,ODYSSEY ACADEMY,4,english,4,115,48,67,38,17,115,65,50,25,16
22,84804,AMBASSADORS PRE,4,english,4,16,2,14,5,3,16,9,7,2,0
22,84901,DICKINSON ISD,4,english,4,842,182,660,436,212,849,267,582,289,138
22,84902,GALVESTON ISD,4,english,4,356,82,274,193,106,375,113,262,177,100
22,84903,HIGH ISLAND ISD,5,english,4,7,0,7,7,2,7,0,7,5,1
22,84906,TEXAS CITY ISD,4,english,4,554,163,391,253,113,552,214,338,193,92
22,84908,HITCHCOCK ISD,4,english,4,117,69,48,20,4,117,72,45,23,8
22,84909,SANTA FE ISD,4,english,4,314,50,264,191,94,314,56,258,193,106
22,84910,CLEAR CREEK ISD,4,english,4,2708,409,2299,1784,1025,2734,614,2120,1400,855
22,84911,FRIENDSWOOD ISD,4,english,4,470,30,440,358,226,471,41,430,359,234
22,85902,POST ISD,17,english,4,52,18,34,17,9,52,5,47,27,11
22,85903,SOUTHLAND ISD,17,english,4,7,2,5,3,3,7,1,6,3,2
22,86024,DOSS CONSOLIDAT,13,english,4,0,,,,,0,,,,
22,86901,FREDERICKSBURG,13,english,4,199,53,146,111,51,199,58,141,101,56
22,86902,HARPER ISD,13,english,4,44,6,38,26,14,44,4,40,30,21
22,87901,GLASSCOCK COUNT,18,english,4,24,0,24,20,10,25,1,24,16,7
22,88902,GOLIAD ISD,3,english,4,82,34,48,29,13,82,34,48,26,10
22,89901,GONZALES ISD,13,english,4,177,55,122,78,35,176,61,115,65,32
22,89903,NIXON-SMILEY CI,13,english,4,77,24,53,37,17,77,22,55,30,16
22,89905,WAELDER ISD,13,english,4,22,13,9,3,2,22,12,10,4,0
22,90902,LEFORS ISD,16,english,4,11,1,10,6,3,11,1,10,6,2
22,90903,MCLEAN ISD,16,english,4,12,6,6,2,0,12,9,3,0,0
22,90904,PAMPA ISD,16,english,4,241,60,181,112,52,241,89,152,67,22
22,90905,GRANDVIEW-HOPKI,16,english,4,7,0,7,3,2,7,2,5,4,3
22,91901,BELLS ISD,10,english,4,49,3,46,32,16,49,4,45,27,14
22,91902,COLLINSVILLE IS,10,english,4,43,10,33,18,5,43,10,33,8,6
22,91903,DENISON ISD,10,english,4,313,70,243,174,85,325,86,239,141,74
22,91905,HOWE ISD,10,english,4,84,22,62,48,20,84,18,66,27,14
22,91906,SHERMAN ISD,10,english,4,563,181,382,248,93,567,271,296,152,69
22,91907,TIOGA ISD,10,english,4,46,9,37,25,11,46,8,38,20,10
22,91908,VAN ALSTYNE ISD,10,english,4,147,6,141,115,60,147,16,131,88,52
22,91909,WHITESBORO ISD,10,english,4,120,29,91,53,25,120,34,86,40,21
22,91910,WHITEWRIGHT ISD,10,english,4,63,9,54,29,13,64,12,52,28,15
22,91913,POTTSBORO ISD,10,english,4,111,14,97,73,52,111,20,91,60,39
22,91914,S AND S CISD,10,english,4,69,17,52,38,18,69,34,35,19,4
22,91917,GUNTER ISD,10,english,4,84,6,78,61,35,84,8,76,56,35
22,91918,TOM BEAN ISD,10,english,4,49,7,42,29,11,49,7,42,32,19
22,92901,GLADEWATER ISD,7,english,4,134,52,82,47,18,135,72,63,30,15
22,92902,KILGORE ISD,7,english,4,291,72,219,136,56,308,127,181,79,34
22,92903,LONGVIEW ISD,7,english,4,540,128,412,294,163,576,135,441,313,190
22,92904,PINE TREE ISD,7,english,4,348,54,294,190,94,348,67,281,177,78
22,92906,SABINE ISD,7,english,4,117,18,99,74,41,117,31,86,48,21
22,92907,SPRING HILL ISD,7,english,4,150,24,126,90,53,150,16,134,107,73
22,92908,WHITE OAK ISD,7,english,4,119,24,95,70,31,119,10,109,75,40
22,93901,ANDERSON-SHIRO,6,english,4,74,7,67,58,32,74,8,66,49,32
22,93903,IOLA ISD,6,english,4,37,4,33,25,11,37,6,31,22,14
22,93904,NAVASOTA ISD,6,english,4,182,58,124,83,32,181,69,112,55,23
22,93905,RICHARDS ISD,6,english,4,18,8,10,4,2,18,12,6,4,1
22,94901,SEGUIN ISD,20,english,4,479,134,345,232,114,493,162,331,191,77
22,94902,SCHERTZ-CIBOLO-,20,english,4,1081,265,816,514,250,1094,364,730,395,197
22,94903,NAVARRO ISD,20,english,4,171,40,131,88,43,171,37,134,89,45
22,94904,MARION ISD,20,english,4,104,17,87,74,43,104,18,86,54,31
22,95901,ABERNATHY ISD,17,english,4,52,5,47,32,18,52,11,41,27,17
22,95902,COTTON CENTER I,17,english,4,9,2,7,7,3,9,3,6,4,3
22,95903,HALE CENTER ISD,17,english,4,33,10,23,14,6,33,16,17,8,4
22,95904,PETERSBURG ISD,17,english,4,22,2,20,14,8,22,0,22,13,6
22,95905,PLAINVIEW ISD,17,english,4,340,111,229,142,63,340,129,211,101,43
22,96904,MEMPHIS ISD,16,english,4,32,7,25,18,11,32,10,22,10,5
22,96905,TURKEY-QUITAQUE,16,english,4,11,2,9,7,2,11,2,9,5,3
22,97902,HAMILTON ISD,12,english,4,70,12,58,40,11,70,29,41,21,9
22,97903,HICO ISD,12,english,4,47,3,44,29,15,47,4,43,22,11
22,98901,GRUVER ISD,16,english,4,26,1,25,14,6,26,0,26,15,5
22,98903,PRINGLE-MORSE C,16,english,4,11,2,9,7,2,11,3,8,4,1
22,98904,SPEARMAN ISD,16,english,4,58,15,43,26,13,58,22,36,21,11
22,99902,CHILLICOTHE ISD,9,english,4,13,6,7,4,2,13,5,8,2,0
22,99903,QUANAH ISD,9,english,4,28,7,21,11,7,28,7,21,8,4
22,100903,KOUNTZE ISD,5,english,4,75,16,59,40,20,75,17,58,37,18
22,100904,SILSBEE ISD,5,english,4,202,76,126,69,28,201,99,102,56,34
22,100905,HARDIN-JEFFERSO,5,english,4,186,41,145,86,38,186,91,95,37,8
22,100907,LUMBERTON ISD,5,english,4,322,72,250,177,87,322,66,256,163,84
22,100908,WEST HARDIN COU,5,english,4,31,3,28,16,3,31,6,25,15,6
22,101802,SER-NINOS CHART,4,english,4,45,8,37,24,13,45,6,39,24,9
22,101803,ARISTOI CLASSIC,4,english,4,104,22,82,67,39,104,34,70,48,31
22,101806,RAUL YZAGUIRRE,4,english,4,89,25,64,51,30,96,18,78,51,30
22,101810,ACADEMY OF ACCE,4,english,4,92,34,58,31,18,92,52,40,18,8
22,101814,THE VARNETT PUB,4,english,4,117,46,71,40,12,117,54,63,23,9
22,101815,ALIEF MONTESSOR,4,english,4,21,0,21,10,4,21,9,12,9,5
22,101819,AMIGOS POR VIDA,4,english,4,49,3,46,36,15,49,3,46,30,18
22,101828,HOUSTON GATEWAY,4,english,4,140,12,128,108,73,142,4,138,123,82
22,101838,SOUTHWEST SCHOO,4,english,4,123,50,73,41,17,123,58,65,30,10
22,101840,TWO DIMENSIONS,4,english,4,34,8,26,16,8,34,27,7,2,0
22,101842,COMQUEST ACADEM,4,english,4,6,4,2,0,0,6,3,3,0,0
22,101846,HARMONY PUBLIC,4,english,4,219,51,168,107,54,219,98,121,59,30
22,101847,BEATRICE MAYES,4,english,4,62,21,41,30,12,62,39,23,12,4
22,101849,ACCELERATED INT,4,english,4,30,7,23,16,6,30,4,26,15,10
22,101853,PROMISE COMMUNI,4,english,4,90,43,47,30,12,90,41,49,14,4
22,101855,MEYERPARK ELEME,4,english,4,38,5,33,25,13,38,24,14,5,3
22,101856,DRAW ACADEMY,4,english,4,62,29,33,15,5,62,42,20,10,2
22,101858,HARMONY PUBLIC,4,english,4,527,142,385,256,146,528,214,314,167,91
22,101859,STEP CHARTER SC,4,english,4,73,18,55,40,20,73,26,47,24,12
22,101861,THE RHODES SCHO,4,english,4,62,24,38,26,15,61,33,28,9,4
22,101862,HARMONY PUBLIC,4,english,4,262,31,231,195,115,262,37,225,167,97
22,101868,THE PRO-VISION,4,english,4,14,10,4,1,0,14,13,1,0,0
22,101870,BETA ACADEMY,4,english,4,129,19,110,76,36,129,35,94,49,23
22,101876,REVE PREPARATOR,4,english,4,15,8,7,5,3,15,8,7,1,0
22,101902,ALDINE ISD,4,english,4,4001,1580,2421,1365,534,4041,2044,1997,890,406
22,101903,ALIEF ISD,4,english,4,2653,847,1806,1117,559,2907,1208,1699,887,455
22,101905,CHANNELVIEW ISD,4,english,4,584,141,443,294,127,657,216,441,264,122
22,101906,CROSBY ISD,4,english,4,462,79,383,270,140,463,138,325,193,102
22,101907,CYPRESS-FAIRBAN,4,english,4,8030,1571,6459,4719,2668,8032,2486,5546,3197,1673
22,101908,DEER PARK ISD,4,english,4,773,168,605,404,201,773,198,575,367,182
22,101910,GALENA PARK ISD,4,english,4,1166,276,890,593,285,1203,352,851,470,226
22,101911,GOOSE CREEK CIS,4,english,4,1619,440,1179,808,402,1620,581,1039,583,285
22,101912,HOUSTON ISD,4,english,4,12813,3526,9287,6400,3514,12913,4536,8377,5094,2933
22,101913,HUMBLE ISD,4,english,4,3408,771,2637,1813,940,3409,1236,2173,1193,619
22,101914,KATY ISD,4,english,4,6421,881,5540,4380,2649,6504,1269,5235,3699,2402
22,101915,KLEIN ISD,4,english,4,3696,587,3109,2250,1280,3693,904,2789,1789,954
22,101916,LA PORTE ISD,4,english,4,473,82,391,274,120,473,93,380,218,116
22,101917,PASADENA ISD,4,english,4,3154,778,2376,1488,671,3102,1082,2020,1000,450
22,101919,SPRING ISD,4,english,4,2131,693,1438,896,409,2220,908,1312,683,310
22,101920,SPRING BRANCH I,4,english,4,2112,395,1717,1274,732,2225,547,1678,1133,681
22,101921,TOMBALL ISD,4,english,4,1536,153,1383,1181,776,1579,200,1379,1014,656
22,101924,SHELDON ISD,4,english,4,708,219,489,293,144,708,296,412,208,101
22,101925,HUFFMAN ISD,4,english,4,260,70,190,131,68,260,95,165,91,51
22,102901,KARNACK ISD,7,english,4,12,5,7,4,1,12,2,10,6,4
22,102902,MARSHALL ISD,7,english,4,316,98,218,136,64,328,148,180,110,66
22,102903,WASKOM ISD,7,english,4,55,11,44,24,12,55,9,46,27,9
22,102904,HALLSVILLE ISD,7,english,4,692,224,468,291,150,693,317,376,250,151
22,102905,HARLETON ISD,7,english,4,48,6,42,29,12,48,9,39,19,7
22,102906,ELYSIAN FIELDS,7,english,4,64,16,48,30,13,64,16,48,27,11
22,103901,CHANNING ISD,16,english,4,14,7,7,4,1,14,12,2,1,0
22,103902,HARTLEY ISD,16,english,4,15,2,13,10,5,15,4,11,5,4
22,104901,HASKELL CISD,14,english,4,41,9,32,14,5,41,9,32,19,8
22,104903,RULE ISD,14,english,4,8,2,6,5,1,8,4,4,3,1
22,104907,PAINT CREEK ISD,14,english,4,5,1,4,3,2,5,0,5,3,1
22,105802,TEXAS PREPARATO,13,english,4,10,5,5,5,3,10,5,5,3,1
22,105803,KI CHARTER ACAD,13,english,4,23,22,1,1,0,22,21,1,0,0
22,105902,SAN MARCOS CISD,13,english,4,534,144,390,253,116,552,242,310,153,77
22,105904,DRIPPING SPRING,13,english,4,607,54,553,455,285,595,62,533,388,223
22,105905,WIMBERLEY ISD,13,english,4,167,25,142,95,55,167,50,117,68,28
22,105906,HAYS CISD,13,english,4,1445,293,1152,789,390,1447,422,1025,599,323
22,106901,CANADIAN ISD,16,english,4,56,8,48,32,12,56,13,43,24,16
22,107901,ATHENS ISD,10,english,4,210,48,162,102,46,210,63,147,88,47
22,107902,BROWNSBORO ISD,7,english,4,186,53,133,78,41,186,46,140,78,39
22,107904,CROSS ROADS ISD,7,english,4,28,6,22,14,7,28,2,26,18,11
22,107905,EUSTACE ISD,7,english,4,129,17,112,84,49,129,29,100,69,37
22,107906,MALAKOFF ISD,7,english,4,110,9,101,71,33,110,19,91,45,21
22,107907,TRINIDAD ISD,7,english,4,11,8,3,2,1,11,9,2,0,0
22,107908,MURCHISON ISD,7,english,4,19,4,15,8,1,19,6,13,8,5
22,107910,LAPOYNOR ISD,7,english,4,28,5,23,12,4,28,15,13,4,1
22,108802,HORIZON MONTESS,1,english,4,141,29,112,67,35,142,61,81,41,20
22,108807,IDEA PUBLIC SCH,1,english,4,4760,1004,3756,2616,1362,4766,1575,3191,1695,844
22,108808,VANGUARD ACADEM,1,english,4,440,91,349,241,130,443,120,323,198,106
22,108809,EXCELLENCE IN L,1,english,4,34,8,26,17,4,35,10,25,13,4
22,108902,DONNA ISD,1,english,4,690,240,450,229,81,830,351,479,188,68
22,108903,EDCOUCH-ELSA IS,1,english,4,285,106,179,95,38,286,154,132,63,25
22,108904,EDINBURG CISD,1,english,4,2093,412,1681,1101,511,2117,488,1629,1029,542
22,108905,HIDALGO ISD,1,english,4,144,12,132,88,44,177,41,136,96,58
22,108906,MCALLEN ISD,1,english,4,1318,254,1064,776,407,1358,310,1048,716,419
22,108907,MERCEDES ISD,1,english,4,252,93,159,92,38,267,102,165,72,24
22,108908,MISSION CISD,1,english,4,780,198,582,363,162,978,389,589,327,157
22,108909,PHARR-SAN JUAN-,1,english,4,1529,405,1124,698,312,1859,646,1213,707,367
22,108910,PROGRESO ISD,1,english,4,80,20,60,32,13,96,36,60,29,18
22,108911,SHARYLAND ISD,1,english,4,567,97,470,360,183,574,158,416,247,133
22,108912,LA JOYA ISD,1,english,4,903,176,727,473,249,1679,537,1142,687,334
22,108913,WESLACO ISD,1,english,4,1112,273,839,552,208,1114,408,706,368,172
22,108914,LA VILLA ISD,1,english,4,33,8,25,13,6,33,15,18,11,3
22,108915,MONTE ALTO ISD,1,english,4,53,15,38,19,8,53,15,38,19,9
22,108916,VALLEY VIEW ISD,1,english,4,241,26,215,150,74,249,36,213,135,64
22,109901,ABBOTT ISD,12,english,4,19,3,16,12,9,19,3,16,10,7
22,109902,BYNUM ISD,12,english,4,13,1,12,9,6,13,3,10,7,5
22,109903,COVINGTON ISD,12,english,4,18,3,15,5,3,18,8,10,4,0
22,109904,HILLSBORO ISD,12,english,4,127,27,100,66,23,127,40,87,37,16
22,109905,HUBBARD ISD,12,english,4,25,9,16,10,5,25,13,12,6,4
22,109907,ITASCA ISD,12,english,4,45,11,34,20,7,44,27,17,4,0
22,109908,MALONE ISD,12,english,4,9,6,3,2,2,9,7,2,0,0
22,109910,MOUNT CALM ISD,12,english,4,10,5,5,2,1,10,5,5,3,1
22,109911,WHITNEY ISD,12,english,4,94,29,65,42,16,94,32,62,42,25
22,109912,AQUILLA ISD,12,english,4,17,0,17,13,8,17,0,17,14,6
22,109913,BLUM ISD,12,english,4,26,7,19,11,6,26,10,16,8,4
22,109914,PENELOPE ISD,12,english,4,11,3,8,6,0,11,3,8,6,1
22,110901,ANTON ISD,17,english,4,11,4,7,2,0,11,7,4,0,0
22,110902,LEVELLAND ISD,17,english,4,196,81,115,62,26,196,106,90,36,18
22,110905,ROPES ISD,17,english,4,42,6,36,25,11,42,5,37,21,10
22,110906,SMYER ISD,17,english,4,23,3,20,16,8,23,3,20,14,11
22,110907,SUNDOWN ISD,17,english,4,41,4,37,31,17,41,1,40,33,18
22,110908,WHITHARRAL ISD,17,english,4,19,4,15,10,5,19,5,14,9,2
22,111901,GRANBURY ISD,11,english,4,509,81,428,314,151,510,78,432,276,166
22,111902,LIPAN ISD,11,english,4,25,5,20,16,7,25,7,18,9,6
22,111903,TOLAR ISD,11,english,4,42,9,33,27,11,42,8,34,22,11
22,112901,SULPHUR SPRINGS,8,english,4,269,54,215,151,84,299,92,207,132,74
22,112905,CUMBY ISD,8,english,4,25,6,19,12,5,25,17,8,3,0
22,112906,NORTH HOPKINS I,8,english,4,36,3,33,21,13,36,5,31,18,8
22,112907,MILLER GROVE IS,8,english,4,18,1,17,11,9,18,3,15,8,5
22,112908,COMO-PICKTON CI,8,english,4,51,14,37,19,10,51,24,27,11,4
22,112909,SALTILLO ISD,8,english,4,17,1,16,7,2,17,0,17,15,3
22,112910,SULPHUR BLUFF I,8,english,4,11,2,9,7,0,11,1,10,3,0
22,113901,CROCKETT ISD,6,english,4,75,35,40,21,10,75,51,24,6,2
22,113902,GRAPELAND ISD,6,english,4,42,13,29,13,6,42,13,29,15,3
22,113903,LOVELADY ISD,6,english,4,33,4,29,20,11,33,4,29,23,7
22,113905,LATEXO ISD,6,english,4,29,7,22,15,0,29,10,19,9,3
22,113906,KENNARD ISD,6,english,4,16,2,14,8,3,16,2,14,9,4
22,114901,BIG SPRING ISD,18,english,4,220,63,157,99,37,221,49,172,113,63
22,114902,COAHOMA ISD,18,english,4,74,15,59,40,24,74,21,53,27,11
22,114904,FORSAN ISD,18,english,4,56,10,46,29,18,56,14,42,21,10
22,115901,FT HANCOCK ISD,19,english,4,18,1,17,13,4,18,6,12,5,3
22,115902,SIERRA BLANCA I,19,english,4,8,3,5,4,1,8,3,5,4,1
22,115903,DELL CITY ISD,19,english,4,0,,,,,0,,,,
22,116901,CADDO MILLS ISD,10,english,4,179,25,154,116,54,179,22,157,111,49
22,116902,CELESTE ISD,10,english,4,33,6,27,16,11,33,15,18,10,8
22,116903,COMMERCE ISD,10,english,4,101,49,52,30,15,101,59,42,17,7
22,116905,GREENVILLE ISD,10,english,4,337,139,198,118,50,373,194,179,75,31
22,116906,LONE OAK ISD,10,english,4,65,8,57,47,25,65,6,59,31,10
22,116908,QUINLAN ISD,10,english,4,170,59,111,68,27,170,63,107,59,32
22,116909,WOLFE CITY ISD,10,english,4,44,10,34,21,11,44,15,29,13,5
22,116910,CAMPBELL ISD,10,english,4,12,11,1,1,0,12,11,1,0,0
22,116915,BLAND ISD,10,english,4,65,9,56,36,24,65,6,59,39,24
22,116916,BOLES ISD,10,english,4,33,7,26,19,9,33,8,25,12,6
22,117901,BORGER ISD,16,english,4,180,41,139,86,44,186,56,130,78,44
22,117903,SANFORD-FRITCH,16,english,4,41,7,34,19,9,41,16,25,13,4
22,117904,PLEMONS-STINNET,16,english,4,39,6,33,24,14,39,13,26,17,8
22,117907,SPRING CREEK IS,16,english,4,16,2,14,8,3,15,1,14,8,4
22,118902,IRION COUNTY IS,15,english,4,24,5,19,18,12,24,5,19,14,12
22,119901,BRYSON ISD,9,english,4,21,1,20,16,9,21,4,17,10,6
22,119902,JACKSBORO ISD,9,english,4,79,20,59,41,18,79,39,40,16,7
22,119903,PERRIN-WHITT CI,9,english,4,26,6,20,12,5,26,7,19,10,3
22,120901,EDNA ISD,3,english,4,99,25,74,53,24,99,30,69,43,20
22,120902,GANADO ISD,3,english,4,48,5,43,30,12,48,9,39,27,18
22,120905,INDUSTRIAL ISD,3,english,4,86,5,81,67,39,86,9,77,58,31
22,121902,BROOKELAND ISD,5,english,4,19,3,16,8,3,19,4,15,4,0
22,121903,BUNA ISD,5,english,4,91,14,77,55,28,91,21,70,43,26
22,121904,JASPER ISD,5,english,4,168,88,80,47,12,168,123,45,19,7
22,121905,KIRBYVILLE CISD,5,english,4,111,44,67,35,12,111,34,77,33,14
22,121906,EVADALE ISD,5,english,4,31,3,28,22,12,31,8,23,13,7
22,122901,FT DAVIS ISD,18,english,4,11,4,7,6,3,11,5,6,2,1
22,122902,VALENTINE ISD,18,english,4,0,,,,,0,,,,
22,123803,TEKOA ACADEMY O,5,english,4,18,10,8,1,0,18,16,2,0,0
22,123805,EHRHART SCHOOL,5,english,4,56,14,42,27,17,56,25,31,16,6
22,123807,BOB HOPE SCHOOL,5,english,4,96,24,72,48,29,97,33,64,44,23
22,123905,NEDERLAND ISD,5,english,4,352,37,315,256,126,351,24,327,251,152
22,123907,PORT ARTHUR ISD,5,english,4,572,177,395,227,94,572,230,342,165,85
22,123908,PORT NECHES-GRO,5,english,4,365,55,310,218,105,364,109,255,155,65
22,123910,BEAUMONT ISD,5,english,4,1083,453,630,353,151,1086,633,453,219,103
22,123913,SABINE PASS ISD,5,english,4,23,5,18,14,4,23,6,17,5,1
22,123914,HAMSHIRE-FANNET,5,english,4,153,29,124,84,42,153,36,117,71,37
22,124901,JIM HOGG COUNTY,1,english,4,87,17,70,41,15,86,11,75,46,20
22,125901,ALICE ISD,2,english,4,301,105,196,102,49,301,137,164,91,43
22,125902,BEN BOLT-PALITO,2,english,4,43,6,37,31,15,43,13,30,14,5
22,125903,ORANGE GROVE IS,2,english,4,101,25,76,59,27,101,19,82,63,36
22,125905,PREMONT ISD,2,english,4,45,20,25,16,6,43,23,20,9,1
22,125906,LA GLORIA ISD,2,english,4,14,1,13,8,4,14,7,7,2,0
22,126901,ALVARADO ISD,11,english,4,211,78,133,78,33,238,88,150,60,27
22,126902,BURLESON ISD,11,english,4,913,141,772,556,286,914,196,718,418,226
22,126903,CLEBURNE ISD,11,english,4,453,115,338,220,93,465,135,330,189,87
22,126904,GRANDVIEW ISD,11,english,4,98,8,90,67,32,98,9,89,66,43
22,126905,JOSHUA ISD,11,english,4,416,80,336,246,122,423,77,346,238,125
22,126906,KEENE ISD,11,english,4,67,12,55,32,18,67,23,44,18,3
22,126907,RIO VISTA ISD,11,english,4,52,12,40,29,12,52,8,44,25,14
22,126908,VENUS ISD,11,english,4,159,49,110,55,25,159,68,91,43,18
22,126911,GODLEY ISD,11,english,4,196,46,150,79,43,196,56,140,82,43
22,127901,ANSON ISD,14,english,4,60,21,39,23,8,60,28,32,14,4
22,127903,HAMLIN COLLEGIA,14,english,4,22,10,12,9,2,22,12,10,5,1
22,127904,HAWLEY ISD,14,english,4,59,18,41,23,9,59,30,29,17,6
22,127905,LUEDERS-AVOCA I,14,english,4,6,0,6,4,0,6,0,6,2,1
22,127906,STAMFORD ISD,14,english,4,47,9,38,22,8,47,15,32,15,8
22,128901,KARNES CITY ISD,20,english,4,76,30,46,21,8,75,33,42,25,15
22,128902,KENEDY ISD,3,english,4,48,9,39,24,13,48,11,37,14,2
22,128903,RUNGE ISD,3,english,4,11,6,5,2,1,11,9,2,2,1
22,128904,FALLS CITY ISD,20,english,4,34,0,34,27,17,34,2,32,26,15
22,129901,CRANDALL ISD,10,english,4,415,97,318,205,105,423,132,291,162,83
22,129902,FORNEY ISD,10,english,4,1050,221,829,605,338,1070,327,743,469,280
22,129903,KAUFMAN ISD,10,english,4,278,70,208,135,69,278,78,200,119,64
22,129904,KEMP ISD,10,english,4,119,24,95,68,30,119,27,92,54,26
22,129905,MABANK ISD,10,english,4,295,56,239,158,68,295,56,239,155,93
22,129906,TERRELL ISD,10,english,4,336,121,215,124,50,337,148,189,89,40
22,129910,SCURRY-ROSSER I,10,english,4,70,12,58,44,20,70,8,62,42,18
22,130801,MEADOWLAND CHAR,20,english,4,0,,,,,0,,,,
22,130901,BOERNE ISD,20,english,4,781,104,677,541,311,787,138,649,451,279
22,130902,COMFORT ISD,13,english,4,78,28,50,37,17,78,31,47,21,9
22,131001,KENEDY COUNTY W,2,english,4,11,1,10,6,2,11,2,9,7,2
22,132902,JAYTON-GIRARD I,17,english,4,13,0,13,11,3,13,3,10,6,2
22,133901,CENTER POINT IS,20,english,4,27,5,22,10,2,27,6,21,8,2
22,133902,HUNT ISD,20,english,4,22,4,18,14,7,22,5,17,10,7
22,133903,KERRVILLE ISD,20,english,4,332,46,286,214,96,332,78,254,153,90
22,133904,INGRAM ISD,20,english,4,65,12,53,32,11,65,9,56,39,18
22,133905,DIVIDE ISD,20,english,4,0,,,,,0,,,,
22,134901,JUNCTION ISD,15,english,4,37,13,24,19,8,37,13,24,10,6
22,135001,GUTHRIE CSD,17,english,4,12,0,12,10,3,12,3,9,7,1
22,136901,BRACKETT ISD,20,english,4,33,4,29,20,9,33,8,25,17,10
22,137901,KINGSVILLE ISD,2,english,4,193,70,123,73,30,193,86,107,49,20
22,137902,RICARDO ISD,2,english,4,66,12,54,36,16,66,23,43,34,16
22,137903,RIVIERA ISD,2,english,4,27,3,24,21,7,27,9,18,9,4
22,137904,SANTA GERTRUDIS,2,english,4,39,2,37,32,21,39,9,30,23,16
22,138902,KNOX CITY-O'BRI,9,english,4,16,3,13,10,5,16,3,13,12,8
22,138903,MUNDAY CISD,9,english,4,30,6,24,15,8,30,3,27,17,9
22,138904,BENJAMIN ISD,9,english,4,14,2,12,9,2,14,1,13,8,7
22,139905,CHISUM ISD,8,english,4,88,16,72,56,32,88,22,66,37,14
22,139909,PARIS ISD,8,english,4,268,80,188,117,57,274,104,170,91,47
22,139911,NORTH LAMAR ISD,8,english,4,162,49,113,75,36,160,64,96,46,19
22,139912,PRAIRILAND ISD,8,english,4,90,9,81,54,28,90,15,75,44,21
22,140901,AMHERST ISD,17,english,4,13,4,9,4,0,13,12,1,0,0
22,140904,LITTLEFIELD ISD,17,english,4,96,15,81,50,20,96,44,52,14,4
22,140905,OLTON ISD,17,english,4,42,6,36,20,8,42,9,33,15,3
22,140907,SPRINGLAKE-EART,17,english,4,20,1,19,9,1,20,2,18,9,4
22,140908,SUDAN ISD,17,english,4,32,7,25,17,7,32,4,28,19,9
22,141901,LAMPASAS ISD,12,english,4,248,48,200,145,81,248,59,189,118,60
22,141902,LOMETA ISD,12,english,4,19,8,11,5,3,19,14,5,1,0
22,142901,COTULLA ISD,20,english,4,77,16,61,35,13,77,20,57,36,21
22,143901,HALLETTSVILLE I,3,english,4,72,14,58,40,18,72,9,63,42,25
22,143902,MOULTON ISD,3,english,4,14,1,13,11,5,14,0,14,9,5
22,143903,SHINER ISD,3,english,4,57,5,52,40,25,57,8,49,39,24
22,143904,VYSEHRAD ISD,3,english,4,10,1,9,5,5,10,0,10,7,4
22,143905,SWEET HOME ISD,3,english,4,18,1,17,11,6,18,0,18,12,8
22,143906,EZZELL ISD,3,english,4,5,0,5,5,3,5,0,5,5,3
22,144901,GIDDINGS ISD,13,english,4,114,32,82,48,26,114,29,85,50,24
22,144902,LEXINGTON ISD,13,english,4,70,17,53,40,24,70,11,59,35,18
22,144903,DIME BOX ISD,13,english,4,8,3,5,5,0,8,5,3,1,0
22,145901,BUFFALO ISD,6,english,4,77,4,73,55,27,77,15,62,32,13
22,145902,CENTERVILLE ISD,6,english,4,55,3,52,43,22,55,15,40,20,9
22,145906,NORMANGEE ISD,6,english,4,47,14,33,25,13,47,15,32,18,8
22,145907,OAKWOOD ISD,6,english,4,15,3,12,6,4,15,6,9,2,0
22,145911,LEON ISD,6,english,4,52,11,41,25,11,52,17,35,15,7
22,146901,CLEVELAND ISD,4,english,4,670,216,454,255,98,799,379,420,180,75
22,146902,DAYTON ISD,4,english,4,399,137,262,159,71,399,186,213,121,53
22,146903,DEVERS ISD,4,english,4,23,1,22,21,10,23,1,22,21,16
22,146904,HARDIN ISD,5,english,4,101,30,71,51,21,101,45,56,23,8
22,146905,HULL-DAISETTA I,5,english,4,32,14,18,4,3,32,14,18,8,4
22,146906,LIBERTY ISD,5,english,4,140,35,105,53,23,140,49,91,44,19
22,146907,TARKINGTON ISD,4,english,4,122,25,97,59,32,124,19,105,67,33
22,147901,COOLIDGE ISD,12,english,4,18,4,14,11,3,18,6,12,7,4
22,147902,GROESBECK ISD,12,english,4,116,31,85,56,27,116,37,79,44,23
22,147903,MEXIA ISD,12,english,4,124,47,77,43,14,124,64,60,23,12
22,148901,BOOKER ISD,16,english,4,23,0,23,17,7,23,0,23,19,8
22,148902,FOLLETT ISD,16,english,4,6,2,4,2,1,6,3,3,1,0
22,148905,DARROUZETT ISD,16,english,4,7,3,4,2,1,7,5,2,0,0
22,149901,GEORGE WEST ISD,2,english,4,87,12,75,52,23,87,11,76,48,22
22,149902,THREE RIVERS IS,2,english,4,28,4,24,17,4,28,5,23,12,9
22,150901,LLANO ISD,13,english,4,131,24,107,61,31,131,22,109,71,36
22,152504,TEXAS TECH UNIV,17,english,4,0,,,,,0,,,,
22,152802,RISE ACADEMY,17,english,4,14,1,13,12,2,14,0,14,9,1
22,152806,BETTY M CONDRA,17,english,4,28,14,14,6,2,27,20,7,0,0
22,152901,LUBBOCK ISD,17,english,4,1617,374,1243,850,447,1648,509,1139,653,353
22,152902,NEW DEAL ISD,17,english,4,48,11,37,27,10,48,19,29,13,7
22,152903,SLATON ISD,17,english,4,84,23,61,46,23,84,31,53,18,9
22,152906,LUBBOCK-COOPER,17,english,4,516,67,449,362,218,528,66,462,348,196
22,152907,FRENSHIP ISD,17,english,4,766,95,671,488,271,783,161,622,379,206
22,152908,ROOSEVELT ISD,17,english,4,85,39,46,25,13,85,50,35,13,4
22,152909,SHALLOWATER ISD,17,english,4,128,11,117,97,51,128,11,117,76,53
22,152910,IDALOU ISD,17,english,4,72,13,59,48,25,72,11,61,40,24
22,153903,O'DONNELL ISD,17,english,4,15,3,12,6,4,15,4,11,3,1
22,153904,TAHOKA ISD,17,english,4,48,9,39,22,7,48,5,43,28,10
22,153905,NEW HOME ISD,17,english,4,48,0,48,39,23,48,0,48,35,22
22,153907,WILSON ISD,17,english,4,9,2,7,5,1,9,2,7,3,1
22,154901,MADISONVILLE CI,6,english,4,157,10,147,104,45,157,33,124,79,46
22,154903,NORTH ZULCH ISD,6,english,4,19,2,17,12,4,19,8,11,5,2
22,155901,JEFFERSON ISD,8,english,4,80,34,46,24,8,80,35,45,23,7
22,156902,STANTON ISD,18,english,4,69,12,57,42,17,69,14,55,33,18
22,156905,GRADY ISD,18,english,4,19,0,19,16,11,19,1,18,8,3
22,157901,MASON ISD,15,english,4,61,4,57,45,19,61,4,57,41,23
22,158901,BAY CITY ISD,3,english,4,253,94,159,95,40,253,106,147,85,31
22,158902,TIDEHAVEN ISD,3,english,4,70,8,62,47,22,70,15,55,40,25
22,158904,MATAGORDA ISD,3,english,4,9,2,7,1,1,9,5,4,2,1
22,158905,PALACIOS ISD,3,english,4,84,11,73,51,22,84,9,75,47,26
22,158906,VAN VLECK ISD,3,english,4,85,21,64,44,22,85,28,57,33,22
22,159901,EAGLE PASS ISD,20,english,4,883,237,646,415,190,885,305,580,325,150
22,160901,BRADY ISD,15,english,4,91,23,68,49,23,91,23,68,33,12
22,160904,ROCHELLE ISD,15,english,4,13,1,12,7,2,13,3,10,6,2
22,160905,LOHN ISD,15,english,4,8,5,3,0,0,8,7,1,0,0
22,161801,WACO CHARTER SC,12,english,4,28,7,21,13,3,28,15,13,6,0
22,161802,RAPOPORT ACADEM,12,english,4,63,17,46,28,13,63,32,31,12,5
22,161807,HARMONY PUBLIC,12,english,4,688,190,498,335,155,688,270,418,207,92
22,161901,CRAWFORD ISD,12,english,4,37,0,37,28,12,37,8,29,25,15
22,161903,MIDWAY ISD,12,english,4,621,85,536,450,280,621,115,506,381,257
22,161906,LA VEGA ISD,12,english,4,186,55,131,74,29,186,80,106,40,18
22,161907,LORENA ISD,12,english,4,123,9,114,85,47,124,12,112,86,54
22,161908,MART ISD,12,english,4,42,14,28,16,5,42,13,29,11,6
22,161909,MCGREGOR ISD,12,english,4,101,21,80,61,26,101,36,65,29,11
22,161910,MOODY ISD,12,english,4,44,10,34,25,10,44,12,32,15,9
22,161912,RIESEL ISD,12,english,4,43,8,35,28,13,43,11,32,18,9
22,161914,WACO ISD,12,english,4,1010,370,640,352,137,1011,553,458,179,70
22,161916,WEST ISD,12,english,4,79,14,65,48,27,79,11,68,50,29
22,161918,AXTELL ISD,12,english,4,46,6,40,28,15,46,1,45,26,6
22,161919,BRUCEVILLE-EDDY,12,english,4,39,14,25,13,6,39,12,27,11,7
22,161920,CHINA SPRING IS,12,english,4,217,36,181,135,78,217,48,169,115,61
22,161921,CONNALLY ISD,12,english,4,188,98,90,44,21,188,126,62,24,11
22,161922,ROBINSON ISD,12,english,4,183,35,148,106,55,183,35,148,77,41
22,161923,BOSQUEVILLE ISD,12,english,4,56,4,52,44,21,56,7,49,31,14
22,161924,HALLSBURG ISD,12,english,4,18,6,12,8,3,18,8,10,2,0
22,161925,GHOLSON ISD,12,english,4,15,4,11,5,2,15,7,8,2,1
22,162904,MCMULLEN COUNTY,2,english,4,20,2,18,13,5,20,1,19,16,10
22,163901,DEVINE ISD,20,english,4,145,29,116,78,36,147,30,117,62,30
22,163902,D'HANIS ISD,20,english,4,16,1,15,15,9,16,0,16,12,6
22,163903,NATALIA ISD,20,english,4,73,23,50,35,12,74,22,52,26,13
22,163904,HONDO ISD,20,english,4,113,33,80,49,22,114,53,61,34,18
22,163908,MEDINA VALLEY I,20,english,4,511,61,450,339,189,514,103,411,262,147
22,164901,MENARD ISD,15,english,4,26,4,22,11,2,27,11,16,7,3
22,165802,MIDLAND ACADEMY,18,english,4,37,3,34,26,10,37,5,32,20,11
22,165901,MIDLAND ISD,18,english,4,1799,432,1367,892,430,1801,550,1251,746,393
22,165902,GREENWOOD ISD,18,english,4,263,45,218,153,69,263,62,201,125,75
22,166901,CAMERON ISD,6,english,4,106,36,70,46,22,106,34,72,38,21
22,166902,GAUSE ISD,6,english,4,17,3,14,10,2,17,8,9,5,2
22,166903,MILANO ISD,6,english,4,26,1,25,23,14,26,0,26,14,10
22,166904,ROCKDALE ISD,6,english,4,104,21,83,51,24,104,30,74,41,23
22,166905,THORNDALE ISD,13,english,4,42,11,31,22,7,42,14,28,11,4
22,166907,BUCKHOLTS ISD,12,english,4,8,5,3,1,0,8,7,1,0,0
22,167901,GOLDTHWAITE ISD,12,english,4,40,1,39,34,22,40,5,35,29,17
22,167902,MULLIN ISD,12,english,4,6,6,0,0,0,6,3,3,0,0
22,167904,PRIDDY ISD,12,english,4,9,2,7,5,0,9,5,4,1,1
22,168901,COLORADO ISD,14,english,4,61,21,40,19,10,62,21,41,15,3
22,168902,LORAINE ISD,14,english,4,5,0,5,3,2,5,0,5,1,0
22,168903,WESTBROOK ISD,14,english,4,16,5,11,6,1,16,4,12,9,5
22,169901,BOWIE ISD,9,english,4,115,25,90,52,18,115,43,72,27,6
22,169902,NOCONA ISD,9,english,4,50,8,42,24,8,50,7,43,28,17
22,169906,GOLD BURG ISD,9,english,4,0,,,,,0,,,,
22,169908,MONTAGUE ISD,9,english,4,9,2,7,6,3,9,2,7,5,2
22,169909,PRAIRIE VALLEY,9,english,4,12,1,11,6,2,12,4,8,4,2
22,169910,FORESTBURG ISD,9,english,4,15,1,14,8,6,15,6,9,3,2
22,169911,SAINT JO ISD,9,english,4,24,1,23,16,7,24,5,19,12,5
22,170801,TEXAS SERENITY,6,english,4,32,16,16,7,2,32,26,6,1,0
22,170902,CONROE ISD,6,english,4,4626,658,3968,3082,1828,4714,811,3903,2788,1734
22,170903,MONTGOMERY ISD,6,english,4,685,77,608,468,278,686,109,577,418,258
22,170904,WILLIS ISD,6,english,4,600,131,469,305,142,610,189,421,236,104
22,170906,MAGNOLIA ISD,6,english,4,880,150,730,562,304,928,253,675,460,277
22,170907,SPLENDORA ISD,6,english,4,326,105,221,113,51,325,97,228,111,47
22,170908,NEW CANEY ISD,6,english,4,1190,326,864,551,252,1198,497,701,367,163
22,171901,DUMAS ISD,16,english,4,292,43,249,162,75,292,56,236,153,83
22,171902,SUNRAY COLLEGIA,16,english,4,34,9,25,14,6,34,5,29,19,7
22,172902,DAINGERFIELD-LO,8,english,4,59,10,49,27,13,59,9,50,28,14
22,172905,PEWITT CISD,8,english,4,56,6,50,35,14,56,17,39,24,14
22,173901,MOTLEY COUNTY I,17,english,4,6,0,6,3,1,6,4,2,0,0
22,174801,STEPHEN F AUSTI,7,english,4,41,1,40,36,26,41,0,41,38,29
22,174901,CHIRENO ISD,7,english,4,35,13,22,14,4,35,18,17,4,2
22,174902,CUSHING ISD,7,english,4,38,10,28,17,9,38,18,20,8,4
22,174903,GARRISON ISD,7,english,4,47,4,43,37,17,47,4,43,27,10
22,174904,NACOGDOCHES ISD,7,english,4,369,110,259,163,72,373,165,208,103,48
22,174906,WODEN ISD,7,english,4,58,13,45,31,16,58,28,30,11,6
22,174908,CENTRAL HEIGHTS,7,english,4,61,8,53,44,24,61,8,53,39,23
22,174909,MARTINSVILLE IS,7,english,4,28,5,23,14,5,28,11,17,3,0
22,174910,ETOILE ISD,7,english,4,8,1,7,5,3,8,4,4,1,1
22,174911,DOUGLASS ISD,7,english,4,27,3,24,16,5,27,8,19,12,4
22,175902,BLOOMING GROVE,12,english,4,54,11,43,34,20,54,6,48,32,18
22,175903,CORSICANA ISD,12,english,4,428,97,331,215,98,439,103,336,231,116
22,175904,DAWSON ISD,12,english,4,22,1,21,16,8,22,9,13,6,2
22,175905,FROST ISD,12,english,4,35,4,31,17,10,35,5,30,24,12
22,175907,KERENS ISD,12,english,4,39,9,30,15,6,39,14,25,15,7
22,175910,MILDRED ISD,12,english,4,61,5,56,34,14,61,22,39,20,11
22,175911,RICE ISD,12,english,4,72,24,48,35,20,72,35,37,23,7
22,176901,BURKEVILLE ISD,5,english,4,20,9,11,6,4,20,7,13,4,1
22,176902,NEWTON ISD,5,english,4,78,17,61,38,18,79,32,47,19,8
22,176903,DEWEYVILLE ISD,5,english,4,41,8,33,22,12,41,12,29,13,8
22,177901,ROSCOE COLLEGIA,14,english,4,734,429,305,150,61,734,606,128,45,15
22,177902,SWEETWATER ISD,14,english,4,129,44,85,43,16,129,58,71,36,16
22,177903,BLACKWELL CISD,14,english,4,6,0,6,3,2,6,1,5,2,1
22,177905,HIGHLAND ISD,14,english,4,14,1,13,8,6,14,2,12,7,5
22,178801,DR M L GARZA-GO,2,english,4,15,3,12,8,5,15,8,7,4,0
22,178807,CORPUS CHRISTI,2,english,4,11,2,9,7,4,11,4,7,5,3
22,178808,SEASHORE CHARTE,2,english,4,53,8,45,35,14,53,10,43,24,14
22,178901,AGUA DULCE ISD,2,english,4,26,8,18,12,4,26,16,10,2,0
22,178902,BISHOP CISD,2,english,4,93,7,86,60,32,94,5,89,72,50
22,178903,CALALLEN ISD,2,english,4,261,54,207,135,71,261,52,209,116,50
22,178904,CORPUS CHRISTI,2,english,4,2278,495,1783,1199,591,2286,637,1649,984,525
22,178905,DRISCOLL ISD,2,english,4,33,6,27,19,10,33,5,28,12,5
22,178906,LONDON ISD,2,english,4,103,8,95,80,48,103,6,97,78,50
22,178908,PORT ARANSAS IS,2,english,4,24,2,22,13,10,24,5,19,15,8
22,178909,ROBSTOWN ISD,2,english,4,155,70,85,46,21,155,84,71,34,14
22,178912,TULOSO-MIDWAY I,2,english,4,285,41,244,175,83,284,78,206,124,58
22,178913,BANQUETE ISD,2,english,4,63,14,49,34,16,63,13,50,24,10
22,178914,FLOUR BLUFF ISD,2,english,4,374,44,330,231,128,374,78,296,180,97
22,178915,WEST OSO ISD,2,english,4,135,34,101,54,16,135,36,99,51,23
22,179901,PERRYTON ISD,16,english,4,131,20,111,82,34,132,32,100,60,27
22,180901,BOYS RANCH ISD,16,english,4,10,1,9,7,4,10,3,7,4,2
22,180902,VEGA ISD,16,english,4,17,2,15,12,5,17,0,17,14,8
22,180903,ADRIAN ISD,16,english,4,5,0,5,2,1,5,0,5,4,2
22,180904,WILDORADO ISD,16,english,4,10,1,9,6,3,10,1,9,4,2
22,181901,BRIDGE CITY ISD,5,english,4,231,35,196,135,76,231,42,189,111,68
22,181905,ORANGEFIELD ISD,5,english,4,128,20,108,70,35,128,22,106,58,28
22,181906,WEST ORANGE-COV,5,english,4,176,78,98,53,26,177,123,54,16,8
22,181907,VIDOR ISD,5,english,4,296,72,224,146,63,296,74,222,135,75
22,181908,LITTLE CYPRESS-,5,english,4,228,59,169,107,45,228,91,137,70,31
22,182901,GORDON ISD,11,english,4,18,3,15,8,5,18,8,10,3,1
22,182902,GRAFORD ISD,11,english,4,18,8,10,3,1,18,7,11,6,2
22,182903,MINERAL WELLS I,11,english,4,229,58,171,106,53,237,62,175,103,63
22,182904,SANTO ISD,11,english,4,40,1,39,31,23,40,0,40,31,20
22,182905,STRAWN ISD,11,english,4,11,1,10,7,6,11,3,8,4,2
22,182906,PALO PINTO ISD,11,english,4,12,1,11,10,8,12,0,12,9,4
22,183901,BECKVILLE ISD,7,english,4,57,6,51,34,21,57,10,47,25,14
22,183902,CARTHAGE ISD,7,english,4,200,73,127,83,35,199,90,109,51,24
22,183904,GARY ISD,7,english,4,29,6,23,13,7,29,8,21,12,3
22,184901,POOLVILLE ISD,11,english,4,52,5,47,29,20,52,14,38,18,11
22,184902,SPRINGTOWN ISD,11,english,4,306,52,254,177,75,307,79,228,144,87
22,184903,WEATHERFORD ISD,11,english,4,562,133,429,290,136,567,176,391,230,122
22,184904,MILLSAP ISD,11,english,4,85,22,63,39,18,85,34,51,25,11
22,184907,ALEDO ISD,11,english,4,573,47,526,440,283,579,43,536,407,270
22,184908,PEASTER ISD,11,english,4,143,24,119,84,40,143,37,106,69,39
22,184909,BROCK ISD,11,english,4,156,15,141,107,55,156,20,136,93,50
22,184911,GARNER ISD,11,english,4,27,8,19,10,3,27,8,19,6,4
22,185901,BOVINA ISD,16,english,4,41,12,29,14,4,41,9,32,16,6
22,185902,FARWELL ISD,16,english,4,43,5,38,29,15,43,5,38,28,15
22,185903,FRIONA ISD,16,english,4,71,19,52,30,9,71,30,41,17,7
22,185904,LAZBUDDIE ISD,16,english,4,0,,,,,0,,,,
22,186901,BUENA VISTA ISD,18,english,4,19,1,18,10,5,19,6,13,8,3
22,186902,FORT STOCKTON I,18,english,4,159,51,108,62,35,159,54,105,54,30
22,186903,IRAAN-SHEFFIELD,18,english,4,28,16,12,3,3,28,11,17,5,0
22,187901,BIG SANDY ISD,6,english,4,40,10,30,18,6,40,7,33,18,5
22,187903,GOODRICH ISD,6,english,4,15,3,12,5,2,15,10,5,1,0
22,187904,CORRIGAN-CAMDEN,6,english,4,55,12,43,21,13,55,12,43,20,13
22,187906,LEGGETT ISD,6,english,4,13,4,9,3,1,13,11,2,1,0
22,187907,LIVINGSTON ISD,6,english,4,277,48,229,145,72,277,56,221,132,71
22,187910,ONALASKA ISD,6,english,4,73,12,61,45,17,73,19,54,38,18
22,188901,AMARILLO ISD,16,english,4,2066,363,1703,1160,566,2157,482,1675,993,513
22,188902,RIVER ROAD ISD,16,english,4,100,23,77,41,22,100,39,61,30,15
22,188903,HIGHLAND PARK I,16,english,4,66,13,53,28,12,67,21,46,26,12
22,188904,BUSHLAND ISD,16,english,4,112,17,95,73,47,112,18,94,58,27
22,189901,MARFA ISD,18,english,4,24,4,20,13,8,23,11,12,5,1
22,189902,PRESIDIO ISD,18,english,4,52,25,27,11,5,52,28,24,14,3
22,190903,RAINS ISD,7,english,4,128,50,78,48,19,128,67,61,18,4
22,191901,CANYON ISD,16,english,4,810,91,719,520,286,811,127,684,491,287
22,192901,REAGAN COUNTY I,18,english,4,44,15,29,20,12,44,26,18,12,4
22,193801,BIG SPRINGS CHA,20,english,4,10,7,3,2,0,10,9,1,1,0
22,193902,LEAKEY ISD,20,english,4,24,5,19,14,6,24,8,16,8,3
22,194902,AVERY ISD,8,english,4,18,3,15,12,6,18,3,15,8,3
22,194903,RIVERCREST ISD,8,english,4,55,12,43,23,10,55,15,40,24,11
22,194904,CLARKSVILLE ISD,8,english,4,32,10,22,10,3,32,22,10,1,0
22,194905,DETROIT ISD,8,english,4,39,17,22,14,6,39,11,28,12,5
22,195901,PECOS-BARSTOW-T,18,english,4,171,46,125,69,19,172,77,95,39,17
22,195902,BALMORHEA ISD,18,english,4,12,6,6,3,1,12,8,4,0,0
22,196901,AUSTWELL-TIVOLI,3,english,4,5,1,4,3,1,5,0,5,2,1
22,196902,WOODSBORO ISD,3,english,4,32,6,26,16,6,32,7,25,16,9
22,196903,REFUGIO ISD,3,english,4,45,12,33,18,7,45,13,32,18,7
22,197902,MIAMI ISD,16,english,4,15,1,14,8,5,15,2,13,6,3
22,198901,BREMOND ISD,6,english,4,32,3,29,21,9,32,3,29,16,10
22,198902,CALVERT ISD,6,english,4,8,1,7,5,1,8,2,6,2,1
22,198903,FRANKLIN ISD,6,english,4,91,10,81,66,36,91,11,80,59,27
22,198905,HEARNE ISD,6,english,4,55,24,31,16,9,55,34,21,7,3
22,198906,MUMFORD ISD,6,english,4,40,4,36,30,22,40,6,34,19,13
22,199901,ROCKWALL ISD,10,english,4,1271,173,1098,851,482,1273,278,995,662,392
22,199902,ROYSE CITY ISD,10,english,4,562,96,466,338,169,560,92,468,338,192
22,200901,BALLINGER ISD,15,english,4,56,11,45,35,15,56,13,43,25,10
22,200902,MILES ISD,15,english,4,40,2,38,30,18,40,5,35,29,21
22,200904,WINTERS ISD,15,english,4,28,5,23,12,6,28,5,23,16,7
22,200906,OLFEN ISD,15,english,4,6,2,4,3,2,6,3,3,2,1
22,201902,HENDERSON ISD,7,english,4,244,85,159,87,36,244,138,106,45,20
22,201903,LANEVILLE ISD,7,english,4,5,0,5,3,0,5,0,5,4,0
22,201904,LEVERETTS CHAPE,7,english,4,18,1,17,11,1,18,7,11,2,1
22,201907,MOUNT ENTERPRIS,7,english,4,39,4,35,23,11,39,6,33,21,12
22,201908,OVERTON ISD,7,english,4,34,6,28,15,6,34,9,25,16,8
22,201910,TATUM ISD,7,english,4,117,25,92,61,24,117,28,89,47,26
22,201913,CARLISLE ISD,7,english,4,46,13,33,18,11,46,7,39,23,11
22,201914,WEST RUSK COUNT,7,english,4,64,15,49,32,13,64,19,45,20,9
22,202903,HEMPHILL ISD,7,english,4,55,9,46,29,14,55,14,41,22,10
22,202905,WEST SABINE ISD,7,english,4,41,6,35,22,8,41,7,34,17,7
22,203901,SAN AUGUSTINE I,7,english,4,43,23,20,12,4,43,29,14,4,2
22,203902,BROADDUS ISD,7,english,4,26,5,21,11,5,26,12,14,9,5
22,204901,COLDSPRING-OAKH,6,english,4,102,39,63,36,11,102,40,62,32,18
22,204904,SHEPHERD ISD,6,english,4,126,48,78,48,21,126,48,78,34,15
22,205901,ARANSAS PASS IS,2,english,4,117,30,87,52,28,116,58,58,28,9
22,205902,GREGORY-PORTLAN,2,english,4,369,61,308,216,116,370,91,279,183,103
22,205903,INGLESIDE ISD,2,english,4,129,23,106,69,33,129,32,97,59,25
22,205904,MATHIS ISD,2,english,4,119,18,101,56,30,119,30,89,55,23
22,205905,ODEM-EDROY ISD,2,english,4,60,18,42,24,10,60,23,37,16,4
22,205906,SINTON ISD,2,english,4,118,24,94,52,25,118,29,89,44,26
22,205907,TAFT ISD,2,english,4,63,16,47,22,10,63,18,45,25,10
22,206901,SAN SABA ISD,15,english,4,59,12,47,29,12,59,16,43,27,15
22,206902,RICHLAND SPRING,15,english,4,12,1,11,8,2,12,3,9,4,1
22,206903,CHEROKEE ISD,15,english,4,7,3,4,3,0,7,3,4,1,0
22,207901,SCHLEICHER ISD,15,english,4,38,9,29,13,4,38,8,30,15,7
22,208901,HERMLEIGH ISD,14,english,4,14,3,11,3,2,14,5,9,4,1
22,208902,SNYDER ISD,14,english,4,169,46,123,74,36,185,55,130,75,37
22,208903,IRA ISD,14,english,4,18,1,17,12,8,18,0,18,15,12
22,209901,ALBANY ISD,14,english,4,33,7,26,18,10,33,6,27,23,17
22,209902,MORAN ISD,14,english,4,11,7,4,2,1,11,9,2,1,0
22,210901,CENTER ISD,7,english,4,146,31,115,70,31,146,53,93,41,15
22,210902,JOAQUIN ISD,7,english,4,40,10,30,20,10,40,9,31,20,11
22,210903,SHELBYVILLE ISD,7,english,4,47,3,44,34,19,47,5,42,31,19
22,210904,TENAHA ISD,7,english,4,30,15,15,11,1,30,18,12,4,2
22,210905,TIMPSON ISD,7,english,4,40,16,24,10,5,40,22,18,4,2
22,210906,EXCELSIOR ISD,7,english,4,10,2,8,4,3,10,5,5,1,1
22,211901,TEXHOMA ISD,16,english,4,18,3,15,10,3,18,2,16,9,5
22,211902,STRATFORD ISD,16,english,4,36,8,28,20,10,37,9,28,14,11
22,212801,CUMBERLAND ACAD,7,english,4,127,40,87,55,26,127,56,71,41,14
22,212804,UT TYLER UNIVER,7,english,4,60,4,56,44,26,60,11,49,36,21
22,212901,ARP ISD,7,english,4,76,25,51,34,23,75,24,51,23,10
22,212902,BULLARD ISD,7,english,4,188,13,175,139,76,188,16,172,129,77
22,212903,LINDALE ISD,7,english,4,302,26,276,213,124,303,38,265,192,115
22,212904,TROUP ISD,7,english,4,80,7,73,63,43,80,11,69,49,29
22,212905,TYLER ISD,7,english,4,1201,291,910,617,309,1286,394,892,521,293
22,212906,WHITEHOUSE ISD,7,english,4,346,35,311,253,142,345,36,309,235,148
22,212909,CHAPEL HILL ISD,7,english,4,206,53,153,100,40,220,131,89,36,15
22,212910,WINONA ISD,7,english,4,83,16,67,43,18,83,28,55,38,19
22,213801,BRAZOS RIVER CH,11,english,4,6,3,3,1,0,6,3,3,1,0
22,213901,GLEN ROSE ISD,11,english,4,141,14,127,91,49,141,32,109,75,43
22,214901,RIO GRANDE CITY,1,english,4,583,227,356,205,81,583,277,306,155,72
22,214902,SAN ISIDRO ISD,1,english,4,15,6,9,6,2,15,5,10,4,2
22,214903,ROMA ISD,1,english,4,377,37,340,267,165,384,44,340,284,175
22,215901,BRECKENRIDGE IS,14,english,4,87,27,60,44,17,87,17,70,38,17
22,216901,STERLING CITY I,15,english,4,15,2,13,9,4,15,3,12,8,3
22,217901,ASPERMONT ISD,14,english,4,10,1,9,9,4,10,2,8,4,2
22,218901,SONORA ISD,15,english,4,36,8,28,15,5,36,11,25,18,5
22,219901,HAPPY ISD,16,english,4,17,6,11,5,2,17,6,11,5,2
22,219903,TULIA ISD,16,english,4,67,38,29,11,4,67,54,13,4,1
22,219905,KRESS ISD,16,english,4,16,5,11,5,2,16,9,7,6,2
22,220801,TREETOPS SCHOOL,11,english,4,29,5,24,19,12,29,7,22,15,5
22,220802,ARLINGTON CLASS,11,english,4,174,16,158,125,66,174,39,135,82,47
22,220809,FORT WORTH ACAD,11,english,4,63,2,61,50,31,63,6,57,39,16
22,220810,WESTLAKE ACADEM,11,english,4,57,3,54,45,28,57,3,54,44,30
22,220811,EAST FORT WORTH,11,english,4,21,4,17,11,5,21,13,8,0,0
22,220814,TEXAS SCHOOL OF,11,english,4,34,1,33,22,7,34,5,29,19,10
22,220815,CHAPEL HILL ACA,11,english,4,75,30,45,24,9,75,46,29,11,4
22,220817,NEWMAN INTERNAT,11,english,4,179,41,138,83,37,180,83,97,39,16
22,220819,HIGH POINT ACAD,11,english,4,144,42,102,70,37,144,50,94,48,27
22,220901,ARLINGTON ISD,11,english,4,3409,997,2412,1598,789,3532,1521,2011,1047,522
22,220902,BIRDVILLE ISD,11,english,4,1466,301,1165,800,418,1491,437,1054,609,302
22,220904,EVERMAN ISD,11,english,4,335,91,244,150,66,360,113,247,138,67
22,220905,FORT WORTH ISD,11,english,4,4631,1478,3153,1978,946,5149,2331,2818,1472,724
22,220906,GRAPEVINE-COLLE,11,english,4,872,115,757,612,381,868,172,696,496,287
22,220907,KELLER ISD,11,english,4,2346,360,1986,1514,880,2280,548,1732,1163,691
22,220908,MANSFIELD ISD,11,english,4,2515,413,2102,1508,817,2524,591,1933,1252,714
22,220910,LAKE WORTH ISD,11,english,4,189,79,110,56,23,211,136,75,27,10
22,220912,CROWLEY ISD,11,english,4,986,300,686,447,214,1062,430,632,337,177
22,220914,KENNEDALE ISD,11,english,4,223,63,160,121,61,223,71,152,76,33
22,220915,AZLE ISD,11,english,4,503,90,413,288,161,503,108,395,256,149
22,220916,HURST-EULESS-BE,11,english,4,1573,278,1295,955,499,1585,369,1216,798,438
22,220917,CASTLEBERRY ISD,11,english,4,194,54,140,70,32,219,92,127,57,35
22,220918,EAGLE MT-SAGINA,11,english,4,1524,352,1172,779,387,1566,566,1000,516,238
22,220919,CARROLL ISD,11,english,4,597,7,590,548,430,597,14,583,512,411
22,220920,WHITE SETTLEMEN,11,english,4,480,76,404,296,169,480,102,378,237,130
22,221801,TEXAS COLLEGE P,14,english,4,1233,221,1012,694,366,1236,367,869,453,254
22,221901,ABILENE ISD,14,english,4,1090,371,719,440,205,1095,449,646,336,166
22,221904,MERKEL ISD,14,english,4,67,19,48,32,13,67,25,42,28,12
22,221905,TRENT ISD,14,english,4,8,3,5,3,0,8,4,4,1,1
22,221911,JIM NED CISD,14,english,4,124,10,114,93,49,124,17,107,71,37
22,221912,WYLIE ISD,14,english,4,382,40,342,264,147,382,51,331,241,145
22,222901,TERRELL COUNTY,18,english,4,10,4,6,5,2,10,2,8,4,2
22,223901,BROWNFIELD ISD,17,english,4,122,63,59,25,10,122,69,53,26,10
22,223902,MEADOW ISD,17,english,4,16,4,12,10,4,16,4,12,5,3
22,223904,WELLMAN-UNION C,17,english,4,28,3,25,14,5,28,5,23,16,10
22,224901,THROCKMORTON CO,9,english,4,8,3,5,3,1,8,4,4,1,0
22,224902,WOODSON ISD,9,english,4,8,4,4,1,0,8,5,3,1,0
22,225902,MOUNT PLEASANT,8,english,4,230,42,188,132,76,333,63,270,181,104
22,225906,CHAPEL HILL ISD,8,english,4,65,8,57,42,21,65,12,53,36,21
22,225907,HARTS BLUFF ISD,8,english,4,53,7,46,37,14,67,18,49,34,22
22,226801,TEXAS LEADERSHI,15,english,4,293,93,200,117,43,293,168,125,42,16
22,226901,CHRISTOVAL ISD,15,english,4,39,2,37,27,9,39,6,33,16,6
22,226903,SAN ANGELO ISD,15,english,4,981,308,673,445,214,982,397,585,304,129
22,226905,WATER VALLEY IS,15,english,4,30,1,29,19,4,30,1,29,18,9
22,226906,WALL ISD,15,english,4,112,8,104,84,52,112,8,104,74,43
22,226907,GRAPE CREEK ISD,15,english,4,88,27,61,36,18,88,25,63,33,12
22,226908,VERIBEST ISD,15,english,4,13,3,10,8,5,13,3,10,4,3
22,227803,WAYSIDE SCHOOLS,13,english,4,131,33,98,61,31,138,57,81,46,19
22,227804,NYOS CHARTER SC,13,english,4,90,9,81,62,38,90,24,66,35,22
22,227805,TEXAS EMPOWERME,13,english,4,36,15,21,12,5,35,22,13,4,2
22,227806,UNIVERSITY OF T,13,english,4,13,10,3,2,1,13,11,2,1,0
22,227814,CHAPARRAL STAR,13,english,4,30,0,30,27,16,30,2,28,21,12
22,227816,HARMONY PUBLIC,13,english,4,341,73,268,191,112,341,101,240,142,96
22,227817,CEDARS INTERNAT,13,english,4,27,7,20,9,7,27,15,12,5,1
22,227819,UNIVERSITY OF T,13,english,4,44,12,32,20,11,44,21,23,15,8
22,227820,KIPP TEXAS PUBL,4,english,4,2109,612,1497,921,424,2107,977,1130,576,274
22,227821,AUSTIN DISCOVER,13,english,4,70,7,63,50,24,70,26,44,15,8
22,227824,VALERE PUBLIC S,13,english,4,47,9,38,27,13,47,17,30,17,6
22,227825,AUSTIN ACHIEVE,13,english,4,133,66,67,42,22,133,58,75,38,16
22,227826,MONTESSORI FOR,13,english,4,47,10,37,26,13,46,20,26,10,8
22,227829,VALOR PUBLIC SC,13,english,4,128,22,106,87,52,128,20,108,68,36
22,227901,AUSTIN ISD,13,english,4,4614,774,3840,2933,1818,5037,1520,3517,2266,1316
22,227904,PFLUGERVILLE IS,13,english,4,1546,355,1191,869,506,1711,567,1144,729,395
22,227905,TEXAS SCH FOR T,13,english,4,0,,,,,0,,,,
22,227906,TEXAS SCH FOR T,13,english,4,25,17,8,4,1,25,19,6,2,0
22,227907,MANOR ISD,13,english,4,598,185,413,253,118,613,304,309,132,66
22,227909,EANES ISD,13,english,4,513,27,486,414,286,513,35,478,381,273
22,227910,DEL VALLE ISD,13,english,4,429,141,288,177,62,675,310,365,191,84
22,227912,LAGO VISTA ISD,13,english,4,118,21,97,67,38,118,35,83,51,28
22,227913,LAKE TRAVIS ISD,13,english,4,772,90,682,532,304,816,152,664,465,307
22,228901,GROVETON ISD,6,english,4,49,12,37,31,21,49,20,29,14,8
22,228903,TRINITY ISD,6,english,4,68,21,47,31,13,68,28,40,21,9
22,228904,CENTERVILLE ISD,6,english,4,8,2,6,4,4,8,3,5,2,2
22,228905,APPLE SPRINGS I,6,english,4,14,4,10,5,1,14,5,9,5,4
22,229901,COLMESNEIL ISD,5,english,4,34,6,28,21,9,34,10,24,14,8
22,229903,WOODVILLE ISD,5,english,4,85,28,57,32,11,85,38,47,23,11
22,229904,WARREN ISD,5,english,4,93,28,65,48,21,93,44,49,29,14
22,229905,SPURGER ISD,5,english,4,29,3,26,16,7,29,5,24,13,4
22,229906,CHESTER ISD,5,english,4,17,8,9,4,2,17,4,13,4,1
22,230901,BIG SANDY ISD,7,english,4,49,9,40,26,12,49,22,27,10,3
22,230902,GILMER ISD,7,english,4,192,43,149,92,47,192,53,139,85,39
22,230903,ORE CITY ISD,7,english,4,64,16,48,34,18,64,29,35,18,5
22,230904,UNION HILL ISD,7,english,4,21,4,17,10,7,21,8,13,7,5
22,230905,HARMONY ISD,7,english,4,80,10,70,52,28,80,13,67,28,13
22,230906,NEW DIANA ISD,7,english,4,82,5,77,62,32,82,12,70,47,23
22,230908,UNION GROVE ISD,7,english,4,55,14,41,33,13,55,18,37,21,10
22,231901,MCCAMEY ISD,18,english,4,35,8,27,18,11,35,11,24,14,6
22,231902,RANKIN ISD,18,english,4,22,2,20,15,4,22,1,21,11,5
22,232901,KNIPPA ISD,20,english,4,26,0,26,19,8,26,1,25,16,8
22,232902,SABINAL ISD,20,english,4,32,7,25,14,8,32,6,26,17,11
22,232903,UVALDE CISD,20,english,4,242,78,164,107,44,240,121,119,54,17
22,232904,UTOPIA ISD,20,english,4,12,1,11,4,1,12,3,9,2,1
22,233901,SAN FELIPE-DEL,15,english,4,652,168,484,302,127,652,192,460,248,106
22,233903,COMSTOCK ISD,15,english,4,20,0,20,15,6,20,2,18,13,5
22,234902,CANTON ISD,10,english,4,178,32,146,100,56,177,35,142,86,46
22,234903,EDGEWOOD ISD,7,english,4,63,9,54,36,18,63,14,49,22,13
22,234904,GRAND SALINE IS,7,english,4,90,19,71,43,19,90,20,70,39,18
22,234905,MARTINS MILL IS,7,english,4,38,8,30,16,8,38,12,26,11,7
22,234906,VAN ISD,7,english,4,152,28,124,85,38,152,32,120,84,50
22,234907,WILLS POINT ISD,10,english,4,182,70,112,68,30,182,85,97,59,29
22,234909,FRUITVALE ISD,7,english,4,32,12,20,6,5,32,18,14,5,1
22,235901,BLOOMINGTON ISD,3,english,4,66,25,41,26,9,68,29,39,21,5
22,235902,VICTORIA ISD,3,english,4,899,276,623,397,187,901,342,559,299,163
22,235904,NURSERY ISD,3,english,4,18,1,17,15,9,18,1,17,15,11
22,236802,SAM HOUSTON STA,6,english,4,71,11,60,43,23,71,16,55,35,15
22,236901,NEW WAVERLY ISD,6,english,4,75,9,66,50,16,75,14,61,29,15
22,236902,HUNTSVILLE ISD,6,english,4,1410,472,938,617,311,1408,764,644,306,145
22,237902,HEMPSTEAD ISD,4,english,4,101,52,49,29,7,101,60,41,18,8
22,237904,WALLER ISD,4,english,4,597,164,433,263,112,595,204,391,225,109
22,237905,ROYAL ISD,4,english,4,179,69,110,74,35,178,68,110,58,16
22,238902,MONAHANS-WICKET,18,english,4,128,30,98,63,33,128,40,88,51,30
22,238904,GRANDFALLS-ROYA,18,english,4,10,6,4,3,2,10,8,2,2,0
22,239901,BRENHAM ISD,6,english,4,337,83,254,174,88,340,88,252,146,79
22,239903,BURTON ISD,6,english,4,30,1,29,26,12,30,1,29,24,17
22,240901,LAREDO ISD,1,english,4,1384,298,1086,703,391,1389,408,981,559,273
22,240903,UNITED ISD,1,english,4,2709,516,2193,1570,872,2706,715,1991,1249,646
22,240904,WEBB CISD,1,english,4,25,11,14,6,2,25,19,6,4,2
22,241901,BOLING ISD,3,english,4,82,26,56,32,16,82,20,62,37,21
22,241902,EAST BERNARD IS,3,english,4,74,10,64,40,20,74,13,61,38,25
22,241903,EL CAMPO ISD,3,english,4,203,51,152,93,50,203,44,159,102,59
22,241904,WHARTON ISD,3,english,4,126,52,74,49,18,126,85,41,20,10
22,241906,LOUISE ISD,3,english,4,31,2,29,22,10,31,3,28,18,8
22,242902,SHAMROCK ISD,16,english,4,24,5,19,15,7,24,5,19,10,3
22,242903,WHEELER ISD,16,english,4,33,4,29,21,7,33,1,32,25,11
22,242905,KELTON ISD,16,english,4,7,3,4,2,0,7,1,6,1,1
22,242906,FORT ELLIOTT CI,16,english,4,10,2,8,6,2,10,1,9,6,4
22,243901,BURKBURNETT ISD,9,english,4,243,77,166,98,50,243,86,157,92,44
22,243902,ELECTRA ISD,9,english,4,33,8,25,16,6,33,9,24,16,9
22,243903,IOWA PARK CISD,9,english,4,144,9,135,101,49,144,16,128,107,60
22,243905,WICHITA FALLS I,9,english,4,954,316,638,370,165,962,361,601,320,153
22,243906,CITY VIEW ISD,9,english,4,85,13,72,47,20,85,19,66,27,9
22,244901,HARROLD ISD,9,english,4,9,1,8,4,1,9,3,6,2,1
22,244903,VERNON ISD,9,english,4,139,60,79,43,12,139,49,90,36,18
22,244905,NORTHSIDE ISD,9,english,4,18,5,13,8,2,18,4,14,4,2
22,245901,LASARA ISD,1,english,4,13,6,7,3,2,13,10,3,1,1
22,245902,LYFORD CISD,1,english,4,90,27,63,37,21,90,38,52,25,9
22,245903,RAYMONDVILLE IS,1,english,4,115,13,102,69,28,116,27,89,56,33
22,245904,SAN PERLITA ISD,1,english,4,17,3,14,9,5,17,4,13,11,5
22,246801,MERIDIAN WORLD,13,english,4,150,11,139,113,73,150,20,130,92,65
22,246802,GOODWATER MONTE,13,english,4,38,16,22,16,6,38,23,15,7,1
22,246902,FLORENCE ISD,13,english,4,68,9,59,35,18,68,10,58,39,23
22,246904,GEORGETOWN ISD,13,english,4,823,205,618,400,208,866,366,500,272,136
22,246905,GRANGER ISD,13,english,4,35,9,26,15,8,36,8,28,13,6
22,246906,HUTTO ISD,13,english,4,601,145,456,301,137,628,247,381,210,95
22,246907,JARRELL ISD,13,english,4,220,103,117,66,26,222,120,102,47,19
22,246908,LIBERTY HILL IS,13,english,4,562,94,468,369,215,563,123,440,306,174
22,246909,ROUND ROCK ISD,13,english,4,3248,529,2719,2177,1403,3293,799,2494,1748,1195
22,246911,TAYLOR ISD,13,english,4,191,86,105,64,31,202,143,59,26,14
22,246912,THRALL ISD,13,english,4,45,3,42,35,17,45,11,34,23,9
22,246913,LEANDER ISD,13,english,4,2871,442,2429,1862,1110,2917,797,2120,1374,837
22,246914,COUPLAND ISD,13,english,4,33,11,22,11,6,33,17,16,10,5
22,247901,FLORESVILLE ISD,20,english,4,276,76,200,135,55,285,102,183,91,47
22,247903,LA VERNIA ISD,20,english,4,269,50,219,155,82,272,48,224,145,82
22,247904,POTH ISD,20,english,4,80,13,67,47,25,80,14,66,37,20
22,247906,STOCKDALE ISD,20,english,4,59,11,48,32,19,59,12,47,33,17
22,248901,KERMIT ISD,18,english,4,92,43,49,24,11,91,33,58,32,12
22,248902,WINK-LOVING ISD,18,english,4,23,3,20,9,4,23,3,20,18,11
22,249901,ALVORD ISD,11,english,4,63,9,54,39,20,63,15,48,29,17
22,249902,BOYD ISD,11,english,4,84,38,46,30,12,84,45,39,20,9
22,249903,BRIDGEPORT ISD,11,english,4,130,36,94,73,32,140,53,87,45,20
22,249904,CHICO ISD,11,english,4,37,9,28,18,5,37,9,28,16,4
22,249905,DECATUR ISD,11,english,4,240,40,200,148,66,256,68,188,114,53
22,249906,PARADISE ISD,11,english,4,80,9,71,45,25,80,11,69,54,26
22,249908,SLIDELL ISD,11,english,4,20,6,14,10,5,20,13,7,2,0
22,250902,HAWKINS ISD,7,english,4,56,14,42,26,12,56,20,36,19,9
22,250903,MINEOLA ISD,7,english,4,104,24,80,56,22,104,28,76,43,24
22,250904,QUITMAN ISD,7,english,4,94,13,81,62,31,94,21,73,39,22
22,250905,YANTIS ISD,7,english,4,21,3,18,13,5,21,4,17,9,5
22,250906,ALBA-GOLDEN ISD,7,english,4,60,17,43,28,12,60,16,44,23,8
22,250907,WINNSBORO ISD,7,english,4,118,38,80,51,18,118,51,67,37,15
22,251901,DENVER CITY ISD,17,english,4,97,23,74,42,21,97,42,55,17,5
22,251902,PLAINS ISD,17,english,4,31,9,22,13,6,31,8,23,14,6
22,252901,GRAHAM ISD,9,english,4,158,32,126,83,38,158,39,119,83,53
22,252902,NEWCASTLE ISD,9,english,4,14,1,13,7,3,14,3,11,5,4
22,252903,OLNEY ISD,9,english,4,52,9,43,27,13,52,17,35,19,7
22,253901,ZAPATA COUNTY I,1,english,4,224,83,141,82,32,224,81,143,78,34
22,254901,CRYSTAL CITY IS,20,english,4,118,63,55,33,15,117,55,62,28,15
22,254902,LA PRYOR ISD,20,english,4,36,19,17,9,2,36,21,15,7,2
22,1908,WESTWOOD ISD,7,spanish,4,0,,,,,0,,,,
22,2901,ANDREWS ISD,18,spanish,4,12,8,4,1,1,11,9,2,0,0
22,3903,LUFKIN ISD,7,spanish,4,0,,,,,0,,,,
22,4901,ARANSAS COUNTY,2,spanish,4,0,,,,,0,,,,
22,7906,POTEET ISD,20,spanish,4,0,,,,,0,,,,
22,8902,SEALY ISD,6,spanish,4,6,3,3,1,0,5,3,2,0,0
22,9901,MULESHOE ISD,17,spanish,4,0,,,,,0,,,,
22,11901,BASTROP ISD,13,spanish,4,13,12,1,0,0,8,7,1,0,0
22,11902,ELGIN ISD,13,spanish,4,73,49,24,14,3,12,10,2,0,0
22,11904,SMITHVILLE ISD,13,spanish,4,0,,,,,0,,,,
22,13901,BEEVILLE ISD,2,spanish,4,0,,,,,0,,,,
22,14803,PRIORITY CHARTE,12,spanish,4,0,,,,,0,,,,
22,14903,BELTON ISD,12,spanish,4,9,5,4,2,2,8,6,2,0,0
22,14906,KILLEEN ISD,12,spanish,4,42,29,13,10,5,35,20,15,2,0
22,14909,TEMPLE ISD,12,spanish,4,51,33,18,9,5,13,11,2,1,0
22,15802,GEORGE GERVIN A,20,spanish,4,11,4,7,2,2,11,4,7,2,2
22,15822,JUBILEE ACADEMI,20,spanish,4,10,6,4,2,1,10,7,3,1,1
22,15827,SCHOOL OF SCIEN,20,spanish,4,0,,,,,0,,,,
22,15828,HARMONY PUBLIC,20,spanish,4,17,8,9,6,1,16,8,8,2,1
22,15830,BROOKS ACADEMIE,20,spanish,4,5,3,2,1,0,5,5,0,0,0
22,15838,COMPASS ROSE PU,20,spanish,4,0,,,,,0,,,,
22,15901,ALAMO HEIGHTS I,20,spanish,4,15,6,9,5,3,13,5,8,1,0
22,15904,HARLANDALE ISD,20,spanish,4,115,55,60,43,22,125,54,71,30,10
22,15905,EDGEWOOD ISD,20,spanish,4,137,79,58,30,19,16,11,5,0,0
22,15907,SAN ANTONIO ISD,20,spanish,4,492,260,232,137,77,412,214,198,86,39
22,15908,SOUTH SAN ANTON,20,spanish,4,88,58,30,18,8,62,36,26,12,3
22,15909,SOMERSET ISD,20,spanish,4,30,10,20,15,8,11,3,8,2,2
22,15910,NORTH EAST ISD,20,spanish,4,532,190,342,238,131,512,155,357,198,113
22,15911,EAST CENTRAL IS,20,spanish,4,67,41,26,18,6,27,16,11,4,2
22,15912,SOUTHWEST ISD,20,spanish,4,34,17,17,12,8,27,11,16,6,2
22,15913,LACKLAND ISD,20,spanish,4,0,,,,,0,,,,
22,15915,NORTHSIDE ISD,20,spanish,4,214,118,96,60,29,220,118,102,44,19
22,15916,JUDSON ISD,20,spanish,4,24,15,9,6,3,24,16,8,3,1
22,15917,SOUTHSIDE ISD,20,spanish,4,81,34,47,33,17,12,9,3,0,0
22,16901,JOHNSON CITY IS,13,spanish,4,0,,,,,0,,,,
22,19902,HOOKS ISD,8,spanish,4,0,,,,,0,,,,
22,19907,TEXARKANA ISD,8,spanish,4,18,10,8,4,3,0,,,,
22,20901,ALVIN ISD,4,spanish,4,31,24,7,4,2,23,19,4,1,1
22,20902,ANGLETON ISD,4,spanish,4,0,,,,,0,,,,
22,20905,BRAZOSPORT ISD,4,spanish,4,14,4,10,2,2,10,5,5,2,0
22,20908,PEARLAND ISD,4,spanish,4,6,4,2,1,0,0,,,,
22,21901,COLLEGE STATION,6,spanish,4,28,11,17,6,1,27,14,13,3,1
22,21902,BRYAN ISD,6,spanish,4,15,7,8,6,4,13,5,8,2,1
22,25905,MAY ISD,15,spanish,4,0,,,,,0,,,,
22,26901,CALDWELL ISD,6,spanish,4,0,,,,,0,,,,
22,27903,BURNET CISD,13,spanish,4,0,,,,,0,,,,
22,27904,MARBLE FALLS IS,13,spanish,4,24,12,12,6,1,11,6,5,1,0
22,28902,LOCKHART ISD,13,spanish,4,14,9,5,2,1,14,8,6,1,0
22,29901,CALHOUN COUNTY,3,spanish,4,0,,,,,0,,,,
22,31901,BROWNSVILLE ISD,1,spanish,4,85,42,43,21,15,81,45,36,13,5
22,31903,HARLINGEN CISD,1,spanish,4,14,7,7,3,0,14,10,4,0,0
22,31905,LA FERIA ISD,1,spanish,4,0,,,,,0,,,,
22,31906,LOS FRESNOS CIS,1,spanish,4,13,6,7,3,1,12,7,5,1,1
22,31909,POINT ISABEL IS,1,spanish,4,0,,,,,0,,,,
22,31912,SAN BENITO CISD,1,spanish,4,16,8,8,2,1,16,12,4,0,0
22,31913,SANTA MARIA ISD,1,spanish,4,0,,,,,0,,,,
22,31914,SANTA ROSA ISD,1,spanish,4,0,,,,,0,,,,
22,36902,BARBERS HILL IS,4,spanish,4,0,,,,,0,,,,
22,37901,ALTO ISD,7,spanish,4,0,,,,,0,,,,
22,37904,JACKSONVILLE IS,7,spanish,4,89,27,62,45,16,0,,,,
22,40901,MORTON ISD,17,spanish,4,0,,,,,0,,,,
22,40902,WHITEFACE CISD,17,spanish,4,0,,,,,0,,,,
22,41901,BRONTE ISD,15,spanish,4,0,,,,,0,,,,
22,43802,LONE STAR LANGU,10,spanish,4,0,,,,,0,,,,
22,43901,ALLEN ISD,10,spanish,4,13,4,9,4,0,9,2,7,1,0
22,43902,ANNA ISD,10,spanish,4,0,,,,,0,,,,
22,43903,CELINA ISD,10,spanish,4,6,5,1,1,1,0,,,,
22,43904,FARMERSVILLE IS,10,spanish,4,0,,,,,0,,,,
22,43905,FRISCO ISD,10,spanish,4,28,11,17,9,5,21,9,12,6,3
22,43907,MCKINNEY ISD,10,spanish,4,65,42,23,11,7,47,28,19,3,2
22,43910,PLANO ISD,10,spanish,4,212,125,87,50,22,197,132,65,14,5
22,43912,PROSPER ISD,10,spanish,4,0,,,,,0,,,,
22,43914,WYLIE ISD,10,spanish,4,38,13,25,16,12,8,4,4,1,1
22,43918,COMMUNITY ISD,10,spanish,4,36,18,18,7,3,0,,,,
22,45902,COLUMBUS ISD,3,spanish,4,0,,,,,0,,,,
22,46901,NEW BRAUNFELS I,13,spanish,4,11,6,5,1,1,0,,,,
22,46902,COMAL ISD,20,spanish,4,0,,,,,0,,,,
22,49901,GAINESVILLE ISD,11,spanish,4,22,10,12,5,3,0,,,,
22,49903,VALLEY VIEW ISD,11,spanish,4,0,,,,,0,,,,
22,50910,COPPERAS COVE I,12,spanish,4,6,2,4,2,1,0,,,,
22,57803,UPLIFT EDUCATIO,10,spanish,4,5,3,2,1,1,5,4,1,0,0
22,57807,LIFE SCHOOL,10,spanish,4,0,,,,,0,,,,
22,57835,GOLDEN RULE CHA,10,spanish,4,0,,,,,0,,,,
22,57841,CITYSCAPE SCHOO,10,spanish,4,22,11,11,6,2,5,4,1,0,0
22,57846,LEGACY PREPARAT,10,spanish,4,0,,,,,0,,,,
22,57848,INTERNATIONAL L,10,spanish,4,54,36,18,9,4,31,22,9,4,0
22,57903,CARROLLTON-FARM,10,spanish,4,320,131,189,110,58,47,39,8,1,0
22,57904,CEDAR HILL ISD,10,spanish,4,6,4,2,1,0,0,,,,
22,57905,DALLAS ISD,10,spanish,4,3593,1578,2015,1293,769,250,173,77,24,9
22,57906,DESOTO ISD,10,spanish,4,14,11,3,2,1,0,,,,
22,57907,DUNCANVILLE ISD,10,spanish,4,132,67,65,36,21,6,6,0,0,0
22,57909,GARLAND ISD,10,spanish,4,740,342,398,233,108,85,60,25,6,2
22,57910,GRAND PRAIRIE I,10,spanish,4,399,185,214,119,64,28,18,10,3,0
22,57912,IRVING ISD,10,spanish,4,157,103,54,28,12,152,121,31,4,1
22,57913,LANCASTER ISD,10,spanish,4,0,,,,,0,,,,
22,57914,MESQUITE ISD,10,spanish,4,211,115,96,49,25,178,97,81,28,14
22,57916,RICHARDSON ISD,10,spanish,4,50,33,17,10,4,28,20,8,2,1
22,57922,COPPELL ISD,10,spanish,4,15,7,8,5,5,15,8,7,5,4
22,58905,KLONDIKE ISD,17,spanish,4,0,,,,,0,,,,
22,61901,DENTON ISD,11,spanish,4,132,67,65,37,25,55,39,16,4,2
22,61902,LEWISVILLE ISD,11,spanish,4,159,93,66,37,12,141,102,39,16,3
22,61903,PILOT POINT ISD,11,spanish,4,0,,,,,0,,,,
22,61911,NORTHWEST ISD,11,spanish,4,7,4,3,2,1,0,,,,
22,61912,LAKE DALLAS ISD,11,spanish,4,0,,,,,0,,,,
22,61914,LITTLE ELM ISD,11,spanish,4,37,27,10,4,1,10,8,2,0,0
22,68901,ECTOR COUNTY IS,18,spanish,4,227,149,78,36,14,161,99,62,19,4
22,70801,WAXAHACHIE FAIT,10,spanish,4,35,31,4,1,0,32,31,1,0,0
22,70903,ENNIS ISD,10,spanish,4,5,3,2,1,0,5,5,0,0,0
22,70905,FERRIS ISD,10,spanish,4,15,9,6,3,1,0,,,,
22,70908,MIDLOTHIAN ISD,10,spanish,4,11,8,3,2,1,0,,,,
22,70911,RED OAK ISD,10,spanish,4,12,10,2,2,1,0,,,,
22,70912,WAXAHACHIE ISD,10,spanish,4,21,12,9,6,1,0,,,,
22,70915,MAYPEARL ISD,10,spanish,4,0,,,,,0,,,,
22,71801,BURNHAM WOOD CH,19,spanish,4,5,1,4,3,2,5,2,3,1,0
22,71806,HARMONY PUBLIC,19,spanish,4,12,4,8,5,4,11,6,5,1,0
22,71807,LA FE PREPARATO,19,spanish,4,12,9,3,0,0,12,5,7,0,0
22,71901,CLINT ISD,19,spanish,4,63,27,36,20,12,55,32,23,5,1
22,71902,EL PASO ISD,19,spanish,4,534,200,334,188,96,495,225,270,94,27
22,71903,FABENS ISD,19,spanish,4,48,19,29,14,9,41,14,27,12,7
22,71904,SAN ELIZARIO IS,19,spanish,4,53,27,26,12,3,9,3,6,2,1
22,71905,YSLETA ISD,19,spanish,4,347,130,217,129,74,265,77,188,113,63
22,71906,ANTHONY ISD,19,spanish,4,0,,,,,0,,,,
22,71907,CANUTILLO ISD,19,spanish,4,85,35,50,29,15,78,36,42,18,9
22,71908,TORNILLO ISD,19,spanish,4,22,5,17,10,7,0,,,,
22,71909,SOCORRO ISD,19,spanish,4,56,25,31,17,7,50,29,21,3,1
22,72902,DUBLIN ISD,11,spanish,4,0,,,,,0,,,,
22,72903,STEPHENVILLE IS,11,spanish,4,14,8,6,4,2,0,,,,
22,73905,ROSEBUD-LOTT IS,12,spanish,4,0,,,,,0,,,,
22,74903,BONHAM ISD,10,spanish,4,0,,,,,0,,,,
22,79901,LAMAR CISD,4,spanish,4,55,23,32,18,7,43,25,18,8,2
22,79907,FORT BEND ISD,4,spanish,4,35,23,12,8,4,31,23,8,2,0
22,79910,STAFFORD MSD,4,spanish,4,0,,,,,0,,,,
22,80901,MOUNT VERNON IS,8,spanish,4,10,0,10,7,6,0,,,,
22,83903,SEMINOLE ISD,17,spanish,4,0,,,,,0,,,,
22,84901,DICKINSON ISD,4,spanish,4,37,26,11,4,3,30,24,6,0,0
22,84902,GALVESTON ISD,4,spanish,4,42,20,22,11,3,20,9,11,4,1
22,84906,TEXAS CITY ISD,4,spanish,4,0,,,,,0,,,,
22,84908,HITCHCOCK ISD,4,spanish,4,0,,,,,0,,,,
22,84909,SANTA FE ISD,4,spanish,4,0,,,,,0,,,,
22,84910,CLEAR CREEK ISD,4,spanish,4,135,66,69,40,25,114,57,57,19,8
22,86901,FREDERICKSBURG,13,spanish,4,0,,,,,0,,,,
22,87901,GLASSCOCK COUNT,18,spanish,4,0,,,,,0,,,,
22,90904,PAMPA ISD,16,spanish,4,0,,,,,0,,,,
22,91902,COLLINSVILLE IS,10,spanish,4,0,,,,,0,,,,
22,91903,DENISON ISD,10,spanish,4,15,11,4,2,2,0,,,,
22,91905,HOWE ISD,10,spanish,4,0,,,,,0,,,,
22,91906,SHERMAN ISD,10,spanish,4,5,4,1,0,0,0,,,,
22,91910,WHITEWRIGHT ISD,10,spanish,4,0,,,,,0,,,,
22,92902,KILGORE ISD,7,spanish,4,19,15,4,3,1,0,,,,
22,92903,LONGVIEW ISD,7,spanish,4,40,13,27,19,6,0,,,,
22,92904,PINE TREE ISD,7,spanish,4,0,,,,,0,,,,
22,93904,NAVASOTA ISD,6,spanish,4,5,3,2,1,0,5,4,1,1,0
22,94901,SEGUIN ISD,20,spanish,4,20,13,7,1,1,6,6,0,0,0
22,94902,SCHERTZ-CIBOLO-,20,spanish,4,22,11,11,6,4,8,3,5,3,1
22,95905,PLAINVIEW ISD,17,spanish,4,0,,,,,0,,,,
22,96904,MEMPHIS ISD,16,spanish,4,0,,,,,0,,,,
22,101802,SER-NINOS CHART,4,spanish,4,56,25,31,18,8,56,21,35,15,4
22,101806,RAUL YZAGUIRRE,4,spanish,4,8,0,8,6,4,0,,,,
22,101814,THE VARNETT PUB,4,spanish,4,0,,,,,0,,,,
22,101828,HOUSTON GATEWAY,4,spanish,4,0,,,,,0,,,,
22,101853,PROMISE COMMUNI,4,spanish,4,0,,,,,0,,,,
22,101902,ALDINE ISD,4,spanish,4,309,203,106,43,19,270,211,59,14,3
22,101903,ALIEF ISD,4,spanish,4,264,105,159,120,79,8,7,1,0,0
22,101905,CHANNELVIEW ISD,4,spanish,4,93,41,52,25,12,25,10,15,3,2
22,101906,CROSBY ISD,4,spanish,4,10,7,3,3,0,10,5,5,0,0
22,101907,CYPRESS-FAIRBAN,4,spanish,4,37,27,10,4,2,37,31,6,1,1
22,101908,DEER PARK ISD,4,spanish,4,30,10,20,13,11,30,4,26,17,6
22,101910,GALENA PARK ISD,4,spanish,4,243,113,130,59,35,202,78,124,33,7
22,101911,GOOSE CREEK CIS,4,spanish,4,21,10,11,5,4,20,9,11,4,2
22,101912,HOUSTON ISD,4,spanish,4,1877,958,919,518,276,1792,773,1019,485,224
22,101913,HUMBLE ISD,4,spanish,4,59,41,18,9,5,56,39,17,4,0
22,101914,KATY ISD,4,spanish,4,251,104,147,92,49,180,102,78,31,13
22,101915,KLEIN ISD,4,spanish,4,61,26,35,23,11,54,32,22,14,5
22,101916,LA PORTE ISD,4,spanish,4,5,4,1,1,1,5,2,3,1,0
22,101917,PASADENA ISD,4,spanish,4,186,70,116,67,35,240,80,160,83,47
22,101919,SPRING ISD,4,spanish,4,253,144,109,80,49,163,93,70,39,19
22,101920,SPRING BRANCH I,4,spanish,4,176,116,60,28,13,79,58,21,5,1
22,101921,TOMBALL ISD,4,spanish,4,55,15,40,25,13,10,5,5,2,1
22,101924,SHELDON ISD,4,spanish,4,14,6,8,1,1,14,8,6,3,1
22,101925,HUFFMAN ISD,4,spanish,4,0,,,,,0,,,,
22,102902,MARSHALL ISD,7,spanish,4,19,12,7,4,1,7,3,4,3,2
22,105902,SAN MARCOS CISD,13,spanish,4,33,21,12,5,4,11,8,3,2,0
22,105904,DRIPPING SPRING,13,spanish,4,7,7,0,0,0,0,,,,
22,105906,HAYS CISD,13,spanish,4,18,11,7,3,1,15,11,4,0,0
22,108802,HORIZON MONTESS,1,spanish,4,0,,,,,0,,,,
22,108807,IDEA PUBLIC SCH,1,spanish,4,14,10,4,2,1,14,10,4,1,0
22,108808,VANGUARD ACADEM,1,spanish,4,11,2,9,8,2,8,2,6,3,1
22,108809,EXCELLENCE IN L,1,spanish,4,0,,,,,0,,,,
22,108902,DONNA ISD,1,spanish,4,185,128,57,29,13,47,34,13,4,2
22,108903,EDCOUCH-ELSA IS,1,spanish,4,5,3,2,1,0,0,,,,
22,108904,EDINBURG CISD,1,spanish,4,55,36,19,7,1,39,24,15,3,3
22,108905,HIDALGO ISD,1,spanish,4,48,12,36,25,11,15,5,10,1,1
22,108906,MCALLEN ISD,1,spanish,4,80,30,50,33,19,40,20,20,12,6
22,108907,MERCEDES ISD,1,spanish,4,17,10,7,2,0,0,,,,
22,108908,MISSION CISD,1,spanish,4,214,126,88,46,22,17,13,4,3,1
22,108909,PHARR-SAN JUAN-,1,spanish,4,371,193,178,103,56,40,25,15,8,2
22,108910,PROGRESO ISD,1,spanish,4,16,10,6,3,1,0,,,,
22,108911,SHARYLAND ISD,1,spanish,4,65,29,36,23,14,59,31,28,6,1
22,108912,LA JOYA ISD,1,spanish,4,797,438,359,188,89,21,15,6,2,2
22,108913,WESLACO ISD,1,spanish,4,9,7,2,0,0,7,6,1,0,0
22,108916,VALLEY VIEW ISD,1,spanish,4,24,9,15,8,4,16,9,7,1,0
22,111901,GRANBURY ISD,11,spanish,4,0,,,,,0,,,,
22,112901,SULPHUR SPRINGS,8,spanish,4,30,19,11,5,3,0,,,,
22,114901,BIG SPRING ISD,18,spanish,4,0,,,,,0,,,,
22,115901,FT HANCOCK ISD,19,spanish,4,8,4,4,3,3,8,5,3,0,0
22,116901,CADDO MILLS ISD,10,spanish,4,0,,,,,0,,,,
22,116905,GREENVILLE ISD,10,spanish,4,37,23,14,8,3,0,,,,
22,116908,QUINLAN ISD,10,spanish,4,0,,,,,0,,,,
22,116910,CAMPBELL ISD,10,spanish,4,0,,,,,0,,,,
22,117901,BORGER ISD,16,spanish,4,7,1,6,5,1,0,,,,
22,120905,INDUSTRIAL ISD,3,spanish,4,0,,,,,0,,,,
22,123807,BOB HOPE SCHOOL,5,spanish,4,14,4,10,7,4,13,0,13,6,4
22,123905,NEDERLAND ISD,5,spanish,4,0,,,,,0,,,,
22,123907,PORT ARTHUR ISD,5,spanish,4,23,16,7,3,2,23,13,10,3,1
22,123908,PORT NECHES-GRO,5,spanish,4,0,,,,,0,,,,
22,123910,BEAUMONT ISD,5,spanish,4,23,16,7,1,0,22,16,6,1,0
22,126901,ALVARADO ISD,11,spanish,4,39,30,9,2,2,13,10,3,0,0
22,126902,BURLESON ISD,11,spanish,4,0,,,,,0,,,,
22,126903,CLEBURNE ISD,11,spanish,4,28,11,17,10,6,16,4,12,7,4
22,126905,JOSHUA ISD,11,spanish,4,7,6,1,0,0,0,,,,
22,126908,VENUS ISD,11,spanish,4,0,,,,,0,,,,
22,127906,STAMFORD ISD,14,spanish,4,0,,,,,0,,,,
22,129901,CRANDALL ISD,10,spanish,4,12,10,2,0,0,0,,,,
22,129902,FORNEY ISD,10,spanish,4,24,8,16,11,4,6,5,1,0,0
22,129903,KAUFMAN ISD,10,spanish,4,0,,,,,0,,,,
22,129904,KEMP ISD,10,spanish,4,0,,,,,0,,,,
22,129905,MABANK ISD,10,spanish,4,0,,,,,0,,,,
22,129906,TERRELL ISD,10,spanish,4,0,,,,,0,,,,
22,130901,BOERNE ISD,20,spanish,4,18,14,4,4,2,12,9,3,3,1
22,130902,COMFORT ISD,13,spanish,4,0,,,,,0,,,,
22,133901,CENTER POINT IS,20,spanish,4,0,,,,,0,,,,
22,139905,CHISUM ISD,8,spanish,4,0,,,,,0,,,,
22,139909,PARIS ISD,8,spanish,4,6,1,5,2,1,0,,,,
22,142901,COTULLA ISD,20,spanish,4,0,,,,,0,,,,
22,144902,LEXINGTON ISD,13,spanish,4,0,,,,,0,,,,
22,146901,CLEVELAND ISD,4,spanish,4,140,103,37,13,3,11,11,0,0,0
22,146902,DAYTON ISD,4,spanish,4,0,,,,,0,,,,
22,146906,LIBERTY ISD,5,spanish,4,0,,,,,0,,,,
22,149901,GEORGE WEST ISD,2,spanish,4,0,,,,,0,,,,
22,150901,LLANO ISD,13,spanish,4,0,,,,,0,,,,
22,152901,LUBBOCK ISD,17,spanish,4,62,25,37,21,13,31,14,17,9,2
22,152906,LUBBOCK-COOPER,17,spanish,4,12,2,10,5,2,0,,,,
22,152907,FRENSHIP ISD,17,spanish,4,19,6,13,8,4,0,,,,
22,152908,ROOSEVELT ISD,17,spanish,4,0,,,,,0,,,,
22,154901,MADISONVILLE CI,6,spanish,4,0,,,,,0,,,,
22,157901,MASON ISD,15,spanish,4,0,,,,,0,,,,
22,158905,PALACIOS ISD,3,spanish,4,0,,,,,0,,,,
22,159901,EAGLE PASS ISD,20,spanish,4,38,24,14,11,8,35,21,14,8,2
22,161807,HARMONY PUBLIC,12,spanish,4,0,,,,,0,,,,
22,161906,LA VEGA ISD,12,spanish,4,6,4,2,0,0,5,3,2,0,0
22,161912,RIESEL ISD,12,spanish,4,0,,,,,0,,,,
22,161914,WACO ISD,12,spanish,4,14,11,3,1,0,14,12,2,0,0
22,161921,CONNALLY ISD,12,spanish,4,0,,,,,0,,,,
22,163908,MEDINA VALLEY I,20,spanish,4,0,,,,,0,,,,
22,165901,MIDLAND ISD,18,spanish,4,107,58,49,27,9,106,56,50,22,5
22,165902,GREENWOOD ISD,18,spanish,4,0,,,,,0,,,,
22,166904,ROCKDALE ISD,6,spanish,4,0,,,,,0,,,,
22,170902,CONROE ISD,6,spanish,4,319,160,159,95,50,239,128,111,40,15
22,170903,MONTGOMERY ISD,6,spanish,4,0,,,,,0,,,,
22,170904,WILLIS ISD,6,spanish,4,16,8,8,2,0,5,3,2,1,0
22,170906,MAGNOLIA ISD,6,spanish,4,57,29,28,15,6,9,4,5,2,1
22,170908,NEW CANEY ISD,6,spanish,4,61,40,21,10,4,52,31,21,8,4
22,171901,DUMAS ISD,16,spanish,4,7,5,2,1,0,7,5,2,0,0
22,171902,SUNRAY COLLEGIA,16,spanish,4,0,,,,,0,,,,
22,174904,NACOGDOCHES ISD,7,spanish,4,0,,,,,0,,,,
22,175903,CORSICANA ISD,12,spanish,4,10,1,9,6,4,0,,,,
22,175905,FROST ISD,12,spanish,4,0,,,,,0,,,,
22,175911,RICE ISD,12,spanish,4,0,,,,,0,,,,
22,177901,ROSCOE COLLEGIA,14,spanish,4,0,,,,,0,,,,
22,178904,CORPUS CHRISTI,2,spanish,4,12,6,6,4,1,13,5,8,4,3
22,178912,TULOSO-MIDWAY I,2,spanish,4,0,,,,,0,,,,
22,178914,FLOUR BLUFF ISD,2,spanish,4,0,,,,,0,,,,
22,179901,PERRYTON ISD,16,spanish,4,0,,,,,0,,,,
22,181906,WEST ORANGE-COV,5,spanish,4,0,,,,,0,,,,
22,181908,LITTLE CYPRESS-,5,spanish,4,0,,,,,0,,,,
22,182903,MINERAL WELLS I,11,spanish,4,10,9,1,1,0,0,,,,
22,184902,SPRINGTOWN ISD,11,spanish,4,0,,,,,0,,,,
22,184903,WEATHERFORD ISD,11,spanish,4,10,3,7,2,1,5,2,3,1,0
22,184907,ALEDO ISD,11,spanish,4,0,,,,,0,,,,
22,188901,AMARILLO ISD,16,spanish,4,98,34,64,45,21,8,6,2,0,0
22,189902,PRESIDIO ISD,18,spanish,4,5,3,2,1,1,5,3,2,2,0
22,191901,CANYON ISD,16,spanish,4,0,,,,,0,,,,
22,195901,PECOS-BARSTOW-T,18,spanish,4,6,3,3,1,1,5,4,1,0,0
22,199901,ROCKWALL ISD,10,spanish,4,6,3,3,2,1,0,,,,
22,199902,ROYSE CITY ISD,10,spanish,4,0,,,,,0,,,,
22,201902,HENDERSON ISD,7,spanish,4,0,,,,,0,,,,
22,205901,ARANSAS PASS IS,2,spanish,4,0,,,,,0,,,,
22,205902,GREGORY-PORTLAN,2,spanish,4,0,,,,,0,,,,
22,205903,INGLESIDE ISD,2,spanish,4,0,,,,,0,,,,
22,208902,SNYDER ISD,14,spanish,4,17,10,7,5,2,0,,,,
22,209901,ALBANY ISD,14,spanish,4,0,,,,,0,,,,
22,210901,CENTER ISD,7,spanish,4,0,,,,,0,,,,
22,212801,CUMBERLAND ACAD,7,spanish,4,0,,,,,0,,,,
22,212905,TYLER ISD,7,spanish,4,91,34,57,42,22,6,2,4,2,0
22,212909,CHAPEL HILL ISD,7,spanish,4,15,7,8,3,1,0,,,,
22,214901,RIO GRANDE CITY,1,spanish,4,17,8,9,6,3,16,11,5,3,0
22,214903,ROMA ISD,1,spanish,4,16,4,12,8,4,9,2,7,5,2
22,219903,TULIA ISD,16,spanish,4,0,,,,,0,,,,
22,220901,ARLINGTON ISD,11,spanish,4,292,194,98,41,22,172,114,58,14,2
22,220902,BIRDVILLE ISD,11,spanish,4,57,34,23,9,6,41,31,10,2,0
22,220904,EVERMAN ISD,11,spanish,4,30,18,12,8,4,5,4,1,1,1
22,220905,FORT WORTH ISD,11,spanish,4,586,374,212,111,57,69,49,20,6,2
22,220906,GRAPEVINE-COLLE,11,spanish,4,8,1,7,3,2,7,3,4,0,0
22,220907,KELLER ISD,11,spanish,4,75,28,47,22,11,5,1,4,3,1
22,220908,MANSFIELD ISD,11,spanish,4,44,19,25,10,5,35,19,16,7,3
22,220910,LAKE WORTH ISD,11,spanish,4,22,14,8,3,1,0,,,,
22,220912,CROWLEY ISD,11,spanish,4,79,28,51,35,18,0,,,,
22,220915,AZLE ISD,11,spanish,4,0,,,,,0,,,,
22,220916,HURST-EULESS-BE,11,spanish,4,21,3,18,7,3,11,5,6,2,0
22,220917,CASTLEBERRY ISD,11,spanish,4,28,11,17,11,8,0,,,,
22,220918,EAGLE MT-SAGINA,11,spanish,4,45,25,20,10,5,0,,,,
22,220920,WHITE SETTLEMEN,11,spanish,4,57,21,36,23,16,57,21,36,21,11
22,221801,TEXAS COLLEGE P,14,spanish,4,9,4,5,1,0,8,5,3,0,0
22,221901,ABILENE ISD,14,spanish,4,12,5,7,3,2,8,6,2,0,0
22,221904,MERKEL ISD,14,spanish,4,0,,,,,0,,,,
22,223901,BROWNFIELD ISD,17,spanish,4,0,,,,,0,,,,
22,225902,MOUNT PLEASANT,8,spanish,4,106,29,77,45,20,0,,,,
22,225907,HARTS BLUFF ISD,8,spanish,4,14,10,4,2,2,0,,,,
22,226903,SAN ANGELO ISD,15,spanish,4,0,,,,,0,,,,
22,227803,WAYSIDE SCHOOLS,13,spanish,4,16,7,9,5,3,8,4,4,0,0
22,227816,HARMONY PUBLIC,13,spanish,4,12,12,0,0,0,12,12,0,0,0
22,227820,KIPP TEXAS PUBL,4,spanish,4,5,2,3,3,0,0,,,,
22,227901,AUSTIN ISD,13,spanish,4,706,397,309,167,84,275,211,64,10,0
22,227904,PFLUGERVILLE IS,13,spanish,4,211,108,103,64,36,55,32,23,10,3
22,227907,MANOR ISD,13,spanish,4,45,29,16,6,0,30,27,3,0,0
22,227910,DEL VALLE ISD,13,spanish,4,290,163,127,66,34,46,40,6,3,2
22,227912,LAGO VISTA ISD,13,spanish,4,0,,,,,0,,,,
22,227913,LAKE TRAVIS ISD,13,spanish,4,47,40,7,3,2,0,,,,
22,230902,GILMER ISD,7,spanish,4,0,,,,,0,,,,
22,230905,HARMONY ISD,7,spanish,4,0,,,,,0,,,,
22,231901,MCCAMEY ISD,18,spanish,4,0,,,,,0,,,,
22,232903,UVALDE CISD,20,spanish,4,16,9,7,3,2,19,8,11,5,2
22,233901,SAN FELIPE-DEL,15,spanish,4,0,,,,,0,,,,
22,234907,WILLS POINT ISD,10,spanish,4,0,,,,,0,,,,
22,235901,BLOOMINGTON ISD,3,spanish,4,0,,,,,0,,,,
22,235902,VICTORIA ISD,3,spanish,4,19,8,11,9,3,18,8,10,4,0
22,236902,HUNTSVILLE ISD,6,spanish,4,0,,,,,0,,,,
22,237902,HEMPSTEAD ISD,4,spanish,4,0,,,,,0,,,,
22,237904,WALLER ISD,4,spanish,4,8,4,4,1,0,8,6,2,0,0
22,237905,ROYAL ISD,4,spanish,4,0,,,,,0,,,,
22,238902,MONAHANS-WICKET,18,spanish,4,7,2,5,2,2,7,4,3,1,0
22,239901,BRENHAM ISD,6,spanish,4,0,,,,,0,,,,
22,240901,LAREDO ISD,1,spanish,4,38,27,11,4,2,33,22,11,3,0
22,240903,UNITED ISD,1,spanish,4,34,20,14,9,5,33,19,14,4,2
22,241903,EL CAMPO ISD,3,spanish,4,0,,,,,0,,,,
22,243905,WICHITA FALLS I,9,spanish,4,20,15,5,4,1,12,9,3,1,0
22,244903,VERNON ISD,9,spanish,4,0,,,,,0,,,,
22,245902,LYFORD CISD,1,spanish,4,0,,,,,0,,,,
22,245903,RAYMONDVILLE IS,1,spanish,4,0,,,,,0,,,,
22,246902,FLORENCE ISD,13,spanish,4,0,,,,,0,,,,
22,246904,GEORGETOWN ISD,13,spanish,4,48,32,16,10,3,8,8,0,0,0
22,246906,HUTTO ISD,13,spanish,4,31,16,15,13,8,0,,,,
22,246907,JARRELL ISD,13,spanish,4,0,,,,,0,,,,
22,246908,LIBERTY HILL IS,13,spanish,4,0,,,,,0,,,,
22,246909,ROUND ROCK ISD,13,spanish,4,115,74,41,21,9,73,58,15,2,1
22,246911,TAYLOR ISD,13,spanish,4,12,11,1,0,0,0,,,,
22,246913,LEANDER ISD,13,spanish,4,57,31,26,16,8,12,10,2,0,0
22,247901,FLORESVILLE ISD,20,spanish,4,9,9,0,0,0,0,,,,
22,247903,LA VERNIA ISD,20,spanish,4,0,,,,,0,,,,
22,248901,KERMIT ISD,18,spanish,4,0,,,,,0,,,,
22,249903,BRIDGEPORT ISD,11,spanish,4,13,7,6,2,0,0,,,,
22,249905,DECATUR ISD,11,spanish,4,18,9,9,4,0,0,,,,
22,250902,HAWKINS ISD,7,spanish,4,0,,,,,0,,,,
22,250907,WINNSBORO ISD,7,spanish,4,0,,,,,0,,,,
22,251901,DENVER CITY ISD,17,spanish,4,0,,,,,0,,,,
22,1902,CAYUGA ISD,7,english,5,49,6,43,33,23,49,3,46,34,21
22,1903,ELKHART ISD,7,english,5,86,8,78,61,38,86,4,82,54,35
22,1904,FRANKSTON ISD,7,english,5,48,3,45,34,18,48,3,45,33,20
22,1906,NECHES ISD,7,english,5,23,3,20,17,10,23,3,20,9,2
22,1907,PALESTINE ISD,7,english,5,213,44,169,106,59,213,33,180,102,53
22,1908,WESTWOOD ISD,7,english,5,95,27,68,46,26,96,25,71,36,18
22,1909,SLOCUM ISD,7,english,5,27,5,22,16,10,27,3,24,10,1
22,2901,ANDREWS ISD,18,english,5,288,39,249,167,104,289,53,236,129,61
22,3801,PINEYWOODS COMM,7,english,5,76,9,67,54,34,76,7,69,52,34
22,3902,HUDSON ISD,7,english,5,210,38,172,119,86,210,21,189,130,74
22,3903,LUFKIN ISD,7,english,5,466,88,378,265,157,466,122,344,208,111
22,3904,HUNTINGTON ISD,7,english,5,131,25,106,73,38,130,37,93,38,20
22,3905,DIBOLL ISD,7,english,5,110,10,100,76,42,110,15,95,65,31
22,3906,ZAVALLA ISD,7,english,5,25,8,17,11,6,25,7,18,8,3
22,3907,CENTRAL ISD,7,english,5,111,27,84,55,32,111,30,81,36,12
22,4901,ARANSAS COUNTY,2,english,5,210,69,141,83,41,209,76,133,47,17
22,5901,ARCHER CITY ISD,9,english,5,28,0,28,25,20,28,0,28,24,12
22,5902,HOLLIDAY ISD,9,english,5,85,9,76,59,42,85,10,75,60,44
22,5904,WINDTHORST ISD,9,english,5,43,1,42,40,32,43,1,42,39,23
22,6902,CLAUDE ISD,16,english,5,24,1,23,17,14,24,0,24,15,10
22,7901,CHARLOTTE ISD,20,english,5,21,7,14,9,4,21,1,20,14,6
22,7902,JOURDANTON ISD,20,english,5,111,32,79,56,34,111,35,76,43,19
22,7904,LYTLE ISD,20,english,5,113,33,80,45,20,112,47,65,26,12
22,7905,PLEASANTON ISD,20,english,5,273,86,187,128,79,273,96,177,90,37
22,7906,POTEET ISD,20,english,5,123,32,91,56,24,124,56,68,22,7
22,8901,BELLVILLE ISD,6,english,5,155,40,115,83,50,155,56,99,52,12
22,8902,SEALY ISD,6,english,5,200,41,159,107,64,200,30,170,111,54
22,8903,BRAZOS ISD,6,english,5,44,6,38,31,14,44,0,44,33,17
22,9901,MULESHOE ISD,17,english,5,102,25,77,46,32,102,33,69,34,17
22,10901,MEDINA ISD,20,english,5,20,2,18,13,7,20,5,15,11,6
22,10902,BANDERA ISD,20,english,5,159,37,122,78,47,159,35,124,72,28
22,11901,BASTROP ISD,13,english,5,841,303,538,313,172,842,359,483,215,80
22,11902,ELGIN ISD,13,english,5,298,96,202,104,58,322,156,166,55,20
22,11904,SMITHVILLE ISD,13,english,5,120,29,91,63,34,120,31,89,48,28
22,11905,MCDADE ISD,13,english,5,26,7,19,11,8,26,5,21,13,5
22,12901,SEYMOUR ISD,9,english,5,41,3,38,28,15,41,3,38,24,10
22,13801,ST MARY'S ACADE,2,english,5,48,6,42,28,19,48,8,40,19,7
22,13901,BEEVILLE ISD,2,english,5,171,29,142,83,47,172,28,144,80,26
22,13902,PAWNEE ISD,2,english,5,15,3,12,8,3,15,9,6,2,1
22,13903,PETTUS ISD,2,english,5,33,9,24,16,10,33,15,18,9,4
22,13905,SKIDMORE-TYNAN,2,english,5,53,8,45,33,20,53,9,44,25,7
22,14803,PRIORITY CHARTE,12,english,5,55,10,45,30,14,55,17,38,24,15
22,14804,ORENDA CHARTER,12,english,5,150,13,137,106,66,151,20,131,82,36
22,14901,ACADEMY ISD,12,english,5,126,14,112,87,61,126,25,101,64,23
22,14902,BARTLETT ISD,13,english,5,24,12,12,5,3,24,14,10,3,2
22,14903,BELTON ISD,12,english,5,946,196,750,519,324,947,238,709,395,198
22,14905,HOLLAND ISD,12,english,5,49,1,48,38,16,49,2,47,34,15
22,14906,KILLEEN ISD,12,english,5,3045,659,2386,1555,937,3055,857,2198,1189,524
22,14907,ROGERS ISD,12,english,5,50,7,43,32,19,50,10,40,22,11
22,14908,SALADO ISD,12,english,5,177,34,143,108,66,178,33,145,82,41
22,14909,TEMPLE ISD,12,english,5,565,150,415,252,135,576,194,382,182,78
22,14910,TROY ISD,12,english,5,108,18,90,55,32,108,13,95,70,43
22,15802,GEORGE GERVIN A,20,english,5,29,16,13,10,6,29,16,13,8,4
22,15806,LEGACY TRADITIO,20,english,5,30,12,18,8,3,30,16,14,3,1
22,15807,SOUTHWEST PREPA,20,english,5,63,26,37,20,13,63,26,37,17,8
22,15808,INSPIRE ACADEMI,20,english,5,28,10,18,9,3,28,25,3,2,1
22,15809,BEXAR COUNTY AC,20,english,5,17,13,4,1,1,17,14,3,1,0
22,15815,HERITAGE ACADEM,20,english,5,40,17,23,15,9,40,13,27,16,8
22,15822,JUBILEE ACADEMI,20,english,5,461,172,289,167,100,462,198,264,128,63
22,15825,LIGHTHOUSE PUBL,20,english,5,27,11,16,6,1,27,19,8,2,1
22,15827,SCHOOL OF SCIEN,20,english,5,357,59,298,215,140,355,90,265,167,86
22,15828,HARMONY PUBLIC,20,english,5,267,93,174,90,44,270,128,142,57,16
22,15830,BROOKS ACADEMIE,20,english,5,243,48,195,129,80,242,103,139,68,24
22,15831,SCHOOL OF SCIEN,20,english,5,493,62,431,305,184,493,126,367,195,94
22,15834,BASIS TEXAS,20,english,5,345,12,333,302,250,344,8,336,288,205
22,15835,GREAT HEARTS TE,20,english,5,775,78,697,515,315,779,106,673,420,205
22,15836,ELEANOR KOLITZ,20,english,5,47,3,44,41,33,47,2,45,29,15
22,15838,COMPASS ROSE PU,20,english,5,160,64,96,49,24,160,105,55,19,5
22,15840,SAN ANTONIO PRE,20,english,5,25,9,16,9,6,25,15,10,4,0
22,15901,ALAMO HEIGHTS I,20,english,5,329,22,307,244,184,341,36,305,212,107
22,15904,HARLANDALE ISD,20,english,5,762,193,569,343,183,768,266,502,245,88
22,15905,EDGEWOOD ISD,20,english,5,564,221,343,198,97,571,261,310,139,43
22,15906,RANDOLPH FIELD,20,english,5,107,9,98,74,42,108,5,103,71,37
22,15907,SAN ANTONIO ISD,20,english,5,2535,861,1674,986,524,2587,1165,1422,671,288
22,15908,SOUTH SAN ANTON,20,english,5,490,205,285,154,74,498,238,260,106,50
22,15909,SOMERSET ISD,20,english,5,243,45,198,137,88,253,52,201,122,59
22,15910,NORTH EAST ISD,20,english,5,3768,604,3164,2389,1658,3662,724,2938,1924,1108
22,15911,EAST CENTRAL IS,20,english,5,626,191,435,271,147,680,287,393,172,67
22,15912,SOUTHWEST ISD,20,english,5,888,183,705,458,268,893,264,629,330,134
22,15913,LACKLAND ISD,20,english,5,67,3,64,48,28,67,10,57,33,15
22,15914,FT SAM HOUSTON,20,english,5,119,10,109,93,70,119,10,109,78,44
22,15915,NORTHSIDE ISD,20,english,5,7355,1468,5887,4064,2529,7355,2035,5320,3057,1449
22,15916,JUDSON ISD,20,english,5,1616,369,1247,836,511,1623,529,1094,565,232
22,15917,SOUTHSIDE ISD,20,english,5,258,75,183,117,57,331,92,239,148,74
22,16901,JOHNSON CITY IS,13,english,5,47,6,41,24,14,47,8,39,21,7
22,16902,BLANCO ISD,13,english,5,76,20,56,38,25,76,22,54,28,12
22,17901,BORDEN COUNTY I,17,english,5,12,0,12,8,6,12,0,12,11,5
22,18901,CLIFTON ISD,12,english,5,81,14,67,48,30,81,11,70,32,18
22,18902,MERIDIAN ISD,12,english,5,25,7,18,10,7,25,9,16,9,5
22,18903,MORGAN ISD,12,english,5,8,1,7,5,3,8,3,5,4,1
22,18904,VALLEY MILLS IS,12,english,5,39,8,31,22,11,39,1,38,24,9
22,18905,WALNUT SPRINGS,12,english,5,6,4,2,1,1,6,4,2,1,0
22,18906,IREDELL ISD,12,english,5,5,1,4,4,2,5,1,4,1,0
22,18907,KOPPERL ISD,12,english,5,9,4,5,2,1,9,6,3,0,0
22,18908,CRANFILLS GAP I,12,english,5,7,0,7,6,5,7,1,6,4,1
22,19901,DEKALB ISD,8,english,5,55,11,44,27,17,55,5,50,28,11
22,19902,HOOKS ISD,8,english,5,65,7,58,41,32,65,11,54,31,9
22,19903,MAUD ISD,8,english,5,30,1,29,22,19,30,0,30,21,13
22,19905,NEW BOSTON ISD,8,english,5,72,24,48,20,8,72,25,47,25,12
22,19906,REDWATER ISD,8,english,5,74,16,58,39,24,74,5,69,45,20
22,19907,TEXARKANA ISD,8,english,5,511,143,368,262,173,518,145,373,221,98
22,19908,LIBERTY-EYLAU I,8,english,5,144,69,75,47,23,144,73,71,30,8
22,19909,SIMMS ISD,8,english,5,35,5,30,22,11,35,6,29,18,8
22,19910,MALTA ISD,8,english,5,24,1,23,20,11,24,0,24,15,5
22,19911,RED LICK ISD,8,english,5,49,2,47,42,30,50,5,45,33,16
22,19912,PLEASANT GROVE,8,english,5,139,7,132,116,87,139,3,136,116,74
22,19913,HUBBARD ISD,8,english,5,5,2,3,3,2,5,2,3,2,2
22,19914,LEARY ISD,8,english,5,6,0,6,6,2,6,3,3,1,0
22,20901,ALVIN ISD,4,english,5,2009,304,1705,1245,824,1365,424,941,449,152
22,20902,ANGLETON ISD,4,english,5,497,66,431,308,188,499,52,447,307,182
22,20904,DANBURY ISD,4,english,5,46,5,41,32,19,46,2,44,25,11
22,20905,BRAZOSPORT ISD,4,english,5,793,170,623,412,253,793,194,599,333,119
22,20906,SWEENY ISD,4,english,5,134,26,108,77,53,135,30,105,65,22
22,20907,COLUMBIA-BRAZOR,4,english,5,203,40,163,110,68,203,43,160,94,47
22,20908,PEARLAND ISD,4,english,5,1559,170,1389,1117,820,1490,213,1277,889,539
22,20910,DAMON ISD,4,english,5,13,4,9,5,4,13,2,11,7,6
22,21803,BRAZOS SCHOOL F,6,english,5,21,1,20,10,4,21,5,16,9,2
22,21805,ARROW ACADEMY,6,english,5,80,16,64,47,29,80,13,67,36,19
22,21901,COLLEGE STATION,6,english,5,1024,188,836,633,445,969,182,787,511,266
22,21902,BRYAN ISD,6,english,5,1041,343,698,406,245,1046,396,650,420,230
22,22004,TERLINGUA CSD,18,english,5,9,7,2,1,0,9,7,2,0,0
22,22901,ALPINE ISD,18,english,5,57,5,52,35,25,57,11,46,23,9
22,22902,MARATHON ISD,18,english,5,0,,,,,0,,,,
22,23902,SILVERTON ISD,16,english,5,15,3,12,11,4,15,2,13,11,6
22,24901,BROOKS COUNTY I,1,english,5,86,37,49,27,13,86,50,36,10,4
22,25901,BANGS ISD,15,english,5,64,13,51,39,26,65,10,55,30,15
22,25902,BROWNWOOD ISD,15,english,5,227,57,170,124,78,227,49,178,120,68
22,25904,BLANKET ISD,15,english,5,15,4,11,6,4,15,5,10,6,3
22,25905,MAY ISD,15,english,5,9,0,9,8,5,9,0,9,5,2
22,25906,ZEPHYR ISD,15,english,5,13,3,10,6,4,13,1,12,7,3
22,25908,BROOKESMITH ISD,15,english,5,19,5,14,12,7,19,6,13,6,1
22,25909,EARLY ISD,15,english,5,72,7,65,53,37,73,7,66,49,22
22,26901,CALDWELL ISD,6,english,5,130,29,101,67,34,132,23,109,63,29
22,26902,SOMERVILLE ISD,6,english,5,31,19,12,6,3,31,13,18,9,2
22,26903,SNOOK ISD,6,english,5,41,10,31,24,18,41,11,30,23,14
22,27903,BURNET CISD,13,english,5,237,64,173,117,72,235,91,144,63,27
22,27904,MARBLE FALLS IS,13,english,5,250,63,187,128,76,259,69,190,92,47
22,28902,LOCKHART ISD,13,english,5,423,102,321,224,135,423,104,319,190,85
22,28903,LULING ISD,13,english,5,100,23,77,50,25,100,31,69,30,11
22,28906,PRAIRIE LEA ISD,13,english,5,19,13,6,3,2,19,18,1,0,0
22,29901,CALHOUN COUNTY,3,english,5,253,37,216,143,93,253,40,213,138,73
22,30901,CROSS PLAINS IS,14,english,5,18,0,18,10,7,18,4,14,11,7
22,30902,CLYDE CISD,14,english,5,97,10,87,61,37,96,25,71,41,19
22,30903,BAIRD ISD,14,english,5,16,5,11,4,3,16,3,13,7,3
22,30906,EULA ISD,14,english,5,33,3,30,24,17,33,5,28,18,5
22,31901,BROWNSVILLE ISD,1,english,5,2579,494,2085,1473,909,2591,428,2163,1393,669
22,31903,HARLINGEN CISD,1,english,5,1215,271,944,634,358,1216,339,877,455,180
22,31905,LA FERIA ISD,1,english,5,195,39,156,102,58,194,64,130,60,18
22,31906,LOS FRESNOS CIS,1,english,5,750,99,651,497,334,749,104,645,459,236
22,31909,POINT ISABEL IS,1,english,5,136,19,117,74,40,136,26,110,58,19
22,31911,RIO HONDO ISD,1,english,5,108,20,88,61,25,108,18,90,52,23
22,31912,SAN BENITO CISD,1,english,5,624,168,456,298,177,625,184,441,241,116
22,31913,SANTA MARIA ISD,1,english,5,46,15,31,21,10,46,14,32,17,6
22,31914,SANTA ROSA ISD,1,english,5,64,14,50,35,20,64,12,52,34,18
22,32902,PITTSBURG ISD,8,english,5,152,4,148,110,69,152,3,149,127,69
22,33901,GROOM ISD,16,english,5,15,0,15,14,12,15,1,14,8,4
22,33902,PANHANDLE ISD,16,english,5,42,5,37,34,24,42,2,40,38,29
22,33904,WHITE DEER ISD,16,english,5,28,8,20,12,8,28,11,17,4,1
22,34901,ATLANTA ISD,8,english,5,116,22,94,68,43,116,17,99,58,27
22,34902,AVINGER ISD,8,english,5,6,1,5,3,3,6,2,4,3,2
22,34903,HUGHES SPRINGS,8,english,5,85,14,71,53,28,85,17,68,47,20
22,34905,LINDEN-KILDARE,8,english,5,41,8,33,24,13,41,7,34,16,8
22,34906,MCLEOD ISD,8,english,5,29,7,22,17,9,29,0,29,22,11
22,34907,QUEEN CITY ISD,8,english,5,68,16,52,33,18,68,13,55,25,7
22,34909,BLOOMBURG ISD,8,english,5,18,3,15,12,6,18,5,13,9,4
22,35901,DIMMITT ISD,16,english,5,80,24,56,26,17,80,26,54,19,4
22,35902,HART ISD,16,english,5,8,0,8,8,6,8,0,8,7,4
22,35903,NAZARETH ISD,16,english,5,15,1,14,12,9,15,1,14,12,7
22,36901,ANAHUAC ISD,4,english,5,102,24,78,50,30,102,26,76,41,20
22,36902,BARBERS HILL IS,4,english,5,510,36,474,416,293,510,17,493,415,293
22,36903,EAST CHAMBERS I,5,english,5,126,20,106,73,52,126,27,99,53,21
22,37901,ALTO ISD,7,english,5,37,8,29,22,11,36,3,33,20,8
22,37904,JACKSONVILLE IS,7,english,5,295,84,211,140,84,337,111,226,115,33
22,37907,RUSK ISD,7,english,5,125,26,99,74,45,125,25,100,59,27
22,37908,NEW SUMMERFIELD,7,english,5,31,5,26,18,9,31,2,29,19,2
22,37909,WELLS ISD,7,english,5,11,1,10,4,2,11,2,9,5,3
22,38901,CHILDRESS ISD,16,english,5,69,1,68,56,30,69,2,67,51,24
22,39902,HENRIETTA ISD,9,english,5,69,12,57,37,24,69,12,57,37,12
22,39903,PETROLIA CISD,9,english,5,33,8,25,14,8,33,12,21,11,6
22,39904,BELLEVUE ISD,9,english,5,7,0,7,4,3,7,1,6,3,1
22,39905,MIDWAY ISD,9,english,5,8,1,7,5,3,8,1,7,5,3
22,40901,MORTON ISD,17,english,5,25,12,13,4,3,24,6,18,5,0
22,40902,WHITEFACE CISD,17,english,5,24,1,23,17,10,24,3,21,15,7
22,41901,BRONTE ISD,15,english,5,9,1,8,6,2,9,1,8,3,1
22,41902,ROBERT LEE ISD,15,english,5,26,4,22,17,12,26,6,20,12,9
22,42901,COLEMAN ISD,15,english,5,59,15,44,31,19,58,12,46,21,11
22,42903,SANTA ANNA ISD,15,english,5,15,4,11,6,2,15,5,10,4,2
22,42905,PANTHER CREEK C,15,english,5,9,0,9,7,6,9,2,7,4,3
22,43801,IMAGINE INTERNA,10,english,5,125,4,121,103,78,125,6,119,92,66
22,43802,LONE STAR LANGU,10,english,5,6,0,6,4,1,6,1,5,5,2
22,43901,ALLEN ISD,10,english,5,1592,132,1460,1189,890,1593,186,1407,1098,741
22,43902,ANNA ISD,10,english,5,324,67,257,170,109,326,97,229,114,45
22,43903,CELINA ISD,10,english,5,283,26,257,209,148,286,27,259,177,91
22,43904,FARMERSVILLE IS,10,english,5,129,27,102,68,44,129,32,97,56,20
22,43905,FRISCO ISD,10,english,5,4929,341,4588,3958,3091,4932,526,4406,3432,2364
22,43907,MCKINNEY ISD,10,english,5,1606,187,1419,1087,723,1618,290,1328,852,486
22,43908,MELISSA ISD,10,english,5,366,28,338,273,186,366,40,326,249,145
22,43910,PLANO ISD,10,english,5,3333,384,2949,2408,1758,3343,607,2736,1971,1254
22,43911,PRINCETON ISD,10,english,5,483,71,412,291,175,483,72,411,285,138
22,43912,PROSPER ISD,10,english,5,1802,131,1671,1345,942,1802,176,1626,1155,665
22,43914,WYLIE ISD,10,english,5,1340,136,1204,975,697,1340,117,1223,907,576
22,43917,BLUE RIDGE ISD,10,english,5,71,9,62,45,31,71,15,56,34,19
22,43918,COMMUNITY ISD,10,english,5,246,50,196,133,80,291,90,201,111,50
22,43919,LOVEJOY ISD,10,english,5,331,12,319,282,213,275,5,270,239,168
22,44902,WELLINGTON ISD,16,english,5,46,11,35,25,15,46,8,38,20,5
22,45902,COLUMBUS ISD,3,english,5,99,26,73,50,32,99,38,61,29,10
22,45903,RICE CISD,3,english,5,87,20,67,44,23,87,14,73,45,25
22,45905,WEIMAR ISD,3,english,5,46,5,41,31,16,46,7,39,27,10
22,46802,TRINITY CHARTER,20,english,5,8,3,5,3,1,8,5,3,0,0
22,46901,NEW BRAUNFELS I,13,english,5,696,81,615,472,328,696,114,582,397,213
22,46902,COMAL ISD,20,english,5,2121,199,1922,1614,1133,2123,236,1887,1403,892
22,47901,COMANCHE ISD,14,english,5,100,16,84,55,30,100,17,83,54,22
22,47902,DE LEON ISD,14,english,5,52,9,43,34,18,52,9,43,29,15
22,47903,GUSTINE ISD,14,english,5,12,5,7,4,1,12,2,10,5,1
22,47905,SIDNEY ISD,14,english,5,7,0,7,5,2,7,0,7,3,1
22,48901,EDEN CISD,15,english,5,17,7,10,5,5,17,7,10,5,2
22,48903,PAINT ROCK ISD,15,english,5,21,3,18,11,8,21,2,19,8,3
22,49901,GAINESVILLE ISD,11,english,5,207,79,128,66,31,206,77,129,47,13
22,49902,MUENSTER ISD,11,english,5,37,0,37,33,25,37,2,35,26,15
22,49903,VALLEY VIEW ISD,11,english,5,64,22,42,29,11,64,32,32,11,5
22,49905,CALLISBURG ISD,11,english,5,86,22,64,39,24,86,25,61,35,15
22,49906,ERA ISD,11,english,5,33,6,27,17,12,33,8,25,12,8
22,49907,LINDSAY ISD,11,english,5,27,1,26,21,14,27,4,23,18,12
22,49908,WALNUT BEND ISD,11,english,5,7,0,7,4,1,7,1,6,1,0
22,49909,SIVELLS BEND IS,11,english,5,8,0,8,5,4,8,1,7,2,0
22,50901,EVANT ISD,12,english,5,13,7,6,2,1,13,8,5,2,1
22,50902,GATESVILLE ISD,12,english,5,204,40,164,98,58,205,46,159,88,34
22,50904,OGLESBY ISD,12,english,5,9,0,9,6,3,9,2,7,3,1
22,50909,JONESBORO ISD,12,english,5,24,9,15,3,1,24,18,6,1,0
22,50910,COPPERAS COVE I,12,english,5,584,100,484,352,232,584,100,484,321,169
22,51901,PADUCAH ISD,17,english,5,11,5,6,5,3,11,1,10,4,0
22,52901,CRANE ISD,15,english,5,81,20,61,41,25,81,21,60,37,19
22,53001,CROCKETT COUNTY,15,english,5,49,13,36,23,14,49,11,38,21,10
22,54901,CROSBYTON CISD,17,english,5,23,9,14,8,6,23,8,15,7,3
22,54902,LORENZO ISD,17,english,5,17,2,15,9,8,17,6,11,4,1
22,54903,RALLS ISD,17,english,5,36,17,19,5,4,36,15,21,8,2
22,55901,CULBERSON COUNT,18,english,5,21,4,17,14,9,21,4,17,12,8
22,56901,DALHART ISD,16,english,5,108,43,65,40,23,108,53,55,17,5
22,56902,TEXLINE ISD,16,english,5,21,2,19,16,11,21,1,20,12,8
22,57802,PEGASUS SCHOOL,10,english,5,28,9,19,16,7,28,12,16,8,3
22,57803,UPLIFT EDUCATIO,10,english,5,1647,395,1252,788,474,1647,539,1108,622,283
22,57806,ADVANTAGE ACADE,10,english,5,74,33,41,20,12,74,47,27,7,4
22,57807,LIFE SCHOOL,10,english,5,453,113,340,201,124,453,153,300,163,76
22,57808,UNIVERSAL ACADE,10,english,5,188,25,163,131,98,188,34,154,105,74
22,57810,ACADEMY OF DALL,10,english,5,13,9,4,1,0,13,12,1,1,0
22,57813,TRINITY BASIN P,10,english,5,306,76,230,131,56,306,108,198,89,31
22,57814,ACADEMY FOR ACA,10,english,5,0,,,,,0,,,,
22,57816,A W BROWN LEADE,10,english,5,76,19,57,29,14,76,38,38,15,5
22,57819,JEAN MASSIEU AC,10,english,5,20,5,15,11,6,20,6,14,5,2
22,57827,NOVA ACADEMY SO,10,english,5,45,8,37,26,20,46,14,32,17,5
22,57829,A+ ACADEMY,10,english,5,95,39,56,28,8,96,40,56,20,3
22,57830,INSPIRED VISION,10,english,5,84,39,45,18,10,84,52,32,9,3
22,57831,GATEWAY CHARTER,10,english,5,26,11,15,9,3,26,12,14,1,0
22,57833,EDUCATION CENTE,10,english,5,45,9,36,19,11,45,21,24,6,4
22,57835,GOLDEN RULE CHA,10,english,5,112,24,88,46,25,112,30,82,34,18
22,57836,ST ANTHONY SCHO,10,english,5,28,6,22,17,10,28,5,23,12,5
22,57839,LA ACADEMIA DE,10,english,5,84,25,59,43,28,84,36,48,21,8
22,57841,CITYSCAPE SCHOO,10,english,5,98,36,62,28,15,101,48,53,23,7
22,57844,MANARA ACADEMY,10,english,5,40,9,31,23,14,40,13,27,16,6
22,57845,UME PREPARATORY,10,english,5,99,9,90,66,42,98,15,83,48,19
22,57846,LEGACY PREPARAT,10,english,5,127,43,84,41,14,127,69,58,29,16
22,57847,VILLAGE TECH SC,10,english,5,106,29,77,50,26,106,50,56,29,9
22,57848,INTERNATIONAL L,10,english,5,1847,529,1318,851,505,1855,765,1090,543,221
22,57850,PIONEER TECHNOL,10,english,5,143,23,120,75,45,143,46,97,49,17
22,57851,BRIDGEWAY PREPA,10,english,5,6,4,2,2,0,6,2,4,1,0
22,57903,CARROLLTON-FARM,10,english,5,1499,320,1179,839,548,1634,444,1190,723,412
22,57904,CEDAR HILL ISD,10,english,5,496,145,351,222,129,497,196,301,129,58
22,57905,DALLAS ISD,10,english,5,6366,1445,4921,3438,2252,9510,2389,7121,4456,2266
22,57906,DESOTO ISD,10,english,5,462,117,345,201,108,461,208,253,114,55
22,57907,DUNCANVILLE ISD,10,english,5,660,235,425,251,138,713,275,438,231,88
22,57909,GARLAND ISD,10,english,5,3049,533,2516,1787,1172,3602,906,2696,1770,921
22,57910,GRAND PRAIRIE I,10,english,5,1528,284,1244,880,549,1863,478,1385,823,429
22,57911,HIGHLAND PARK I,10,english,5,456,13,443,379,292,379,21,358,264,140
22,57912,IRVING ISD,10,english,5,2019,631,1388,844,475,2022,769,1253,584,228
22,57913,LANCASTER ISD,10,english,5,481,125,356,207,123,481,172,309,153,56
22,57914,MESQUITE ISD,10,english,5,2560,619,1941,1253,721,2612,759,1853,1033,453
22,57916,RICHARDSON ISD,10,english,5,2631,623,2008,1495,1023,2637,707,1930,1275,748
22,57919,SUNNYVALE ISD,10,english,5,155,14,141,98,72,155,17,138,87,36
22,57922,COPPELL ISD,10,english,5,1056,67,989,865,678,1056,104,952,758,535
22,58902,DAWSON ISD,17,english,5,16,4,12,6,5,16,8,8,4,0
22,58905,KLONDIKE ISD,17,english,5,17,0,17,15,11,17,0,17,14,9
22,58906,LAMESA ISD,17,english,5,95,35,60,27,14,95,38,57,21,6
22,58909,SANDS CISD,17,english,5,19,1,18,15,9,19,1,18,14,5
22,59901,HEREFORD ISD,16,english,5,287,75,212,132,83,287,62,225,139,79
22,59902,WALCOTT ISD,16,english,5,17,2,15,12,4,17,0,17,10,3
22,60902,COOPER ISD,8,english,5,48,9,39,23,12,48,17,31,15,6
22,60914,FANNINDEL ISD,8,english,5,11,4,7,5,3,11,3,8,4,2
22,61802,NORTH TEXAS COL,11,english,5,47,17,30,21,13,47,19,28,10,3
22,61804,LEADERSHIP PREP,10,english,5,143,22,121,90,56,143,46,97,47,18
22,61805,TRIVIUM ACADEMY,11,english,5,68,5,63,52,41,68,7,61,53,34
22,61901,DENTON ISD,11,english,5,2213,432,1781,1282,803,2257,611,1646,911,444
22,61902,LEWISVILLE ISD,11,english,5,3280,389,2891,2331,1671,3289,513,2776,1892,1116
22,61903,PILOT POINT ISD,11,english,5,93,17,76,59,36,99,19,80,49,26
22,61905,KRUM ISD,11,english,5,154,32,122,101,66,155,30,125,90,50
22,61906,PONDER ISD,11,english,5,112,18,94,65,34,112,26,86,38,15
22,61907,AUBREY ISD,11,english,5,266,26,240,179,122,266,44,222,148,75
22,61908,SANGER ISD,11,english,5,203,27,176,128,72,203,45,158,90,41
22,61910,ARGYLE ISD,11,english,5,336,12,324,300,234,336,5,331,293,223
22,61911,NORTHWEST ISD,11,english,5,2101,301,1800,1382,954,2098,412,1686,1077,542
22,61912,LAKE DALLAS ISD,11,english,5,268,51,217,138,74,268,65,203,91,31
22,61914,LITTLE ELM ISD,11,english,5,569,136,433,286,179,576,198,378,191,84
22,62901,CUERO ISD,3,english,5,124,23,101,77,52,124,30,94,45,29
22,62902,NORDHEIM ISD,3,english,5,15,5,10,8,7,15,2,13,9,4
22,62903,YOAKUM ISD,3,english,5,75,9,66,49,35,75,4,71,52,33
22,62904,YORKTOWN ISD,3,english,5,30,10,20,6,4,30,5,25,14,5
22,62905,WESTHOFF ISD,3,english,5,6,0,6,4,2,6,0,6,5,3
22,62906,MEYERSVILLE ISD,3,english,5,7,1,6,5,5,7,1,6,5,4
22,63903,SPUR ISD,17,english,5,7,1,6,5,3,7,0,7,4,1
22,63906,PATTON SPRINGS,17,english,5,8,2,6,4,2,8,2,6,5,1
22,64903,CARRIZO SPRINGS,20,english,5,133,27,106,60,27,133,41,92,49,18
22,65901,CLARENDON ISD,16,english,5,23,3,20,13,10,23,4,19,10,2
22,65902,HEDLEY ISD,16,english,5,16,6,10,7,5,16,8,8,5,0
22,66005,RAMIREZ CSD,2,english,5,0,,,,,0,,,,
22,66901,BENAVIDES ISD,2,english,5,13,1,12,7,6,13,7,6,4,2
22,66902,SAN DIEGO ISD,2,english,5,99,30,69,41,20,99,35,64,35,18
22,66903,FREER ISD,2,english,5,59,21,38,22,9,59,16,43,19,7
22,67902,CISCO ISD,14,english,5,48,6,42,31,21,48,14,34,16,8
22,67903,EASTLAND ISD,14,english,5,74,11,63,39,26,74,5,69,53,21
22,67904,GORMAN ISD,14,english,5,14,2,12,8,7,14,2,12,10,3
22,67907,RANGER ISD,14,english,5,28,7,21,13,7,28,7,21,11,2
22,67908,RISING STAR ISD,14,english,5,14,4,10,6,3,14,5,9,6,2
22,68802,COMPASS ACADEMY,18,english,5,119,21,98,66,47,119,32,87,42,10
22,68803,UTPB STEM ACADE,18,english,5,67,12,55,33,17,67,15,52,26,17
22,68901,ECTOR COUNTY IS,18,english,5,2097,600,1497,907,518,2122,650,1472,795,344
22,69901,ROCKSPRINGS ISD,15,english,5,12,6,6,3,2,12,7,5,0,0
22,69902,NUECES CANYON C,15,english,5,15,3,12,10,4,15,4,11,5,2
22,70801,WAXAHACHIE FAIT,10,english,5,171,83,88,48,24,180,99,81,29,14
22,70901,AVALON ISD,10,english,5,14,5,9,4,0,14,2,12,4,1
22,70903,ENNIS ISD,10,english,5,394,86,308,190,112,394,86,308,187,98
22,70905,FERRIS ISD,10,english,5,167,34,133,78,43,169,30,139,69,31
22,70907,ITALY ISD,10,english,5,41,9,32,22,12,41,18,23,9,3
22,70908,MIDLOTHIAN ISD,10,english,5,771,112,659,502,339,771,128,643,421,219
22,70909,MILFORD ISD,10,english,5,19,4,15,8,6,19,9,10,5,0
22,70910,PALMER ISD,10,english,5,97,21,76,49,32,97,22,75,46,17
22,70911,RED OAK ISD,10,english,5,470,82,388,255,158,478,109,369,241,125
22,70912,WAXAHACHIE ISD,10,english,5,701,110,591,407,244,716,172,544,295,129
22,70915,MAYPEARL ISD,10,english,5,84,14,70,54,33,84,16,68,37,10
22,71801,BURNHAM WOOD CH,19,english,5,65,5,60,44,27,65,5,60,45,20
22,71806,HARMONY PUBLIC,19,english,5,380,68,312,202,127,384,104,280,145,58
22,71807,LA FE PREPARATO,19,english,5,9,1,8,6,6,9,0,9,8,6
22,71809,VISTA DEL FUTUR,19,english,5,38,2,36,29,22,38,2,36,26,15
22,71901,CLINT ISD,19,english,5,726,220,506,290,165,732,240,492,269,106
22,71902,EL PASO ISD,19,english,5,2906,441,2465,1783,1116,2956,621,2335,1416,643
22,71903,FABENS ISD,19,english,5,97,20,77,48,22,103,17,86,57,20
22,71904,SAN ELIZARIO IS,19,english,5,152,27,125,76,35,191,43,148,72,23
22,71905,YSLETA ISD,19,english,5,2354,446,1908,1283,794,2387,434,1953,1223,582
22,71906,ANTHONY ISD,19,english,5,55,15,40,25,13,55,10,45,17,4
22,71907,CANUTILLO ISD,19,english,5,443,65,378,259,160,447,103,344,203,98
22,71908,TORNILLO ISD,19,english,5,35,11,24,11,4,58,20,38,18,5
22,71909,SOCORRO ISD,19,english,5,3224,555,2669,1821,1127,3237,632,2605,1546,706
22,72901,THREE WAY ISD,11,english,5,17,5,12,5,3,17,8,9,2,1
22,72902,DUBLIN ISD,11,english,5,77,5,72,48,27,77,4,73,49,22
22,72903,STEPHENVILLE IS,11,english,5,275,55,220,163,112,278,53,225,132,69
22,72904,BLUFF DALE ISD,11,english,5,25,6,19,16,9,25,5,20,12,5
22,72908,HUCKABAY ISD,11,english,5,19,1,18,17,12,19,0,19,12,9
22,72909,LINGLEVILLE ISD,11,english,5,23,4,19,15,7,23,5,18,9,3
22,72910,MORGAN MILL ISD,11,english,5,10,1,9,7,2,10,2,8,5,4
22,73901,CHILTON ISD,12,english,5,32,7,25,16,10,32,2,30,15,6
22,73903,MARLIN ISD,12,english,5,59,18,41,25,17,59,11,48,34,15
22,73904,WESTPHALIA ISD,12,english,5,17,0,17,15,8,17,0,17,16,10
22,73905,ROSEBUD-LOTT IS,12,english,5,45,16,29,19,13,45,18,27,17,8
22,74903,BONHAM ISD,10,english,5,116,25,91,68,33,116,13,103,65,27
22,74904,DODD CITY ISD,10,english,5,28,3,25,14,8,28,3,25,17,8
22,74905,ECTOR ISD,10,english,5,17,8,9,2,1,17,4,13,2,1
22,74907,HONEY GROVE ISD,8,english,5,46,6,40,31,20,46,3,43,33,20
22,74909,LEONARD ISD,10,english,5,66,17,49,33,14,65,15,50,20,9
22,74911,SAVOY ISD,10,english,5,27,3,24,20,15,27,5,22,11,5
22,74912,TRENTON ISD,10,english,5,57,17,40,22,10,57,21,36,16,3
22,74917,SAM RAYBURN ISD,10,english,5,38,6,32,24,12,38,6,32,20,8
22,75901,FLATONIA ISD,13,english,5,47,4,43,30,21,47,3,44,26,12
22,75902,LA GRANGE ISD,13,english,5,146,35,111,73,48,146,61,85,37,13
22,75903,SCHULENBURG ISD,13,english,5,41,12,29,23,8,41,5,36,22,10
22,75906,FAYETTEVILLE IS,13,english,5,19,2,17,14,7,19,4,15,5,2
22,75908,ROUND TOP-CARMI,13,english,5,20,0,20,15,13,20,0,20,19,11
22,76903,ROBY CISD,14,english,5,26,9,17,11,5,26,14,12,5,1
22,76904,ROTAN ISD,14,english,5,19,4,15,7,2,19,6,13,5,2
22,77901,FLOYDADA COLLEG,17,english,5,48,7,41,27,15,48,9,39,24,15
22,77902,LOCKNEY ISD,17,english,5,30,4,26,19,12,30,6,24,13,6
22,78901,CROWELL ISD,9,english,5,12,2,10,8,2,12,5,7,4,3
22,79901,LAMAR CISD,4,english,5,2939,326,2613,2033,1400,2944,365,2579,1824,1014
22,79906,NEEDVILLE ISD,4,english,5,269,14,255,203,138,269,18,251,183,114
22,79907,FORT BEND ISD,4,english,5,5642,817,4825,3794,2753,5645,1022,4623,3273,2101
22,79910,STAFFORD MSD,4,english,5,256,99,157,96,68,259,103,156,76,51
22,80901,MOUNT VERNON IS,8,english,5,103,14,89,58,37,103,23,80,52,26
22,81902,FAIRFIELD ISD,12,english,5,135,28,107,85,53,135,39,96,58,34
22,81904,TEAGUE ISD,12,english,5,61,11,50,28,10,61,12,49,19,9
22,81905,WORTHAM ISD,12,english,5,38,12,26,13,7,38,14,24,13,3
22,81906,DEW ISD,12,english,5,13,1,12,9,5,13,3,10,8,1
22,82902,DILLEY ISD,20,english,5,53,20,33,22,10,53,18,35,24,10
22,82903,PEARSALL ISD,20,english,5,130,47,83,48,23,132,77,55,25,10
22,83901,SEAGRAVES ISD,17,english,5,40,20,20,9,6,40,25,15,9,3
22,83902,LOOP ISD,17,english,5,11,3,8,7,4,11,3,8,2,0
22,83903,SEMINOLE ISD,17,english,5,202,28,174,140,93,203,24,179,144,95
22,84802,ODYSSEY ACADEMY,4,english,5,125,38,87,49,27,126,68,58,12,5
22,84804,AMBASSADORS PRE,4,english,5,17,2,15,12,6,17,3,14,7,3
22,84901,DICKINSON ISD,4,english,5,820,217,603,351,191,817,231,586,304,122
22,84902,GALVESTON ISD,4,english,5,390,118,272,181,88,391,144,247,101,44
22,84903,HIGH ISLAND ISD,5,english,5,11,0,11,7,7,11,0,11,9,3
22,84906,TEXAS CITY ISD,4,english,5,575,180,395,224,131,575,197,378,181,63
22,84908,HITCHCOCK ISD,4,english,5,112,34,78,47,22,112,39,73,27,11
22,84909,SANTA FE ISD,4,english,5,325,36,289,211,134,324,38,286,200,113
22,84910,CLEAR CREEK ISD,4,english,5,2908,329,2579,2046,1415,2921,476,2445,1677,980
22,84911,FRIENDSWOOD ISD,4,english,5,455,27,428,366,269,454,16,438,356,263
22,85902,POST ISD,17,english,5,50,14,36,22,9,50,21,29,14,6
22,85903,SOUTHLAND ISD,17,english,5,17,8,9,6,1,17,10,7,4,1
22,86024,DOSS CONSOLIDAT,13,english,5,0,,,,,0,,,,
22,86901,FREDERICKSBURG,13,english,5,225,64,161,103,61,225,82,143,67,35
22,86902,HARPER ISD,13,english,5,38,8,30,20,12,38,5,33,11,7
22,87901,GLASSCOCK COUNT,18,english,5,18,1,17,16,8,18,1,17,12,7
22,88902,GOLIAD ISD,3,english,5,87,9,78,61,36,87,16,71,35,14
22,89901,GONZALES ISD,13,english,5,182,59,123,72,36,181,45,136,81,33
22,89903,NIXON-SMILEY CI,13,english,5,67,15,52,36,22,67,17,50,32,15
22,89905,WAELDER ISD,13,english,5,21,14,7,5,3,21,12,9,4,1
22,90902,LEFORS ISD,16,english,5,10,2,8,7,4,10,0,10,8,4
22,90903,MCLEAN ISD,16,english,5,8,2,6,4,3,8,1,7,2,0
22,90904,PAMPA ISD,16,english,5,208,57,151,100,59,208,45,163,92,49
22,90905,GRANDVIEW-HOPKI,16,english,5,5,0,5,5,2,5,2,3,1,0
22,91901,BELLS ISD,10,english,5,65,13,52,38,24,65,9,56,44,21
22,91902,COLLINSVILLE IS,10,english,5,35,11,24,15,9,35,15,20,10,4
22,91903,DENISON ISD,10,english,5,336,65,271,177,101,339,76,263,151,80
22,91905,HOWE ISD,10,english,5,100,20,80,60,40,100,16,84,58,26
22,91906,SHERMAN ISD,10,english,5,515,177,338,187,99,519,214,305,140,51
22,91907,TIOGA ISD,10,english,5,58,8,50,34,17,58,6,52,28,14
22,91908,VAN ALSTYNE ISD,10,english,5,161,11,150,113,75,161,11,150,105,57
22,91909,WHITESBORO ISD,10,english,5,111,19,92,64,32,111,24,87,31,14
22,91910,WHITEWRIGHT ISD,10,english,5,50,5,45,28,16,51,4,47,35,22
22,91913,POTTSBORO ISD,10,english,5,107,18,89,62,39,107,31,76,30,5
22,91914,S AND S CISD,10,english,5,86,27,59,36,16,86,28,58,28,15
22,91917,GUNTER ISD,10,english,5,75,7,68,55,33,75,8,67,47,18
22,91918,TOM BEAN ISD,10,english,5,38,5,33,24,15,38,5,33,26,14
22,92901,GLADEWATER ISD,7,english,5,119,35,84,50,23,120,34,86,51,16
22,92902,KILGORE ISD,7,english,5,258,47,211,149,89,280,63,217,129,62
22,92903,LONGVIEW ISD,7,english,5,544,95,449,323,213,588,92,496,357,239
22,92904,PINE TREE ISD,7,english,5,343,70,273,193,110,343,83,260,145,83
22,92906,SABINE ISD,7,english,5,136,11,125,91,55,136,13,123,81,49
22,92907,SPRING HILL ISD,7,english,5,157,21,136,110,76,157,20,137,97,52
22,92908,WHITE OAK ISD,7,english,5,109,13,96,73,39,109,18,91,58,19
22,93901,ANDERSON-SHIRO,6,english,5,75,7,68,47,26,75,9,66,43,27
22,93903,IOLA ISD,6,english,5,41,0,41,31,25,41,6,35,25,18
22,93904,NAVASOTA ISD,6,english,5,206,57,149,94,53,206,62,144,70,28
22,93905,RICHARDS ISD,6,english,5,14,3,11,9,7,14,4,10,4,2
22,94901,SEGUIN ISD,20,english,5,446,114,332,201,117,446,136,310,177,70
22,94902,SCHERTZ-CIBOLO-,20,english,5,1104,204,900,594,355,1111,261,850,476,217
22,94903,NAVARRO ISD,20,english,5,134,26,108,76,46,134,30,104,65,37
22,94904,MARION ISD,20,english,5,102,24,78,52,40,102,19,83,59,32
22,95901,ABERNATHY ISD,17,english,5,55,7,48,35,19,55,8,47,27,13
22,95903,HALE CENTER ISD,17,english,5,50,9,41,23,10,50,10,40,15,7
22,95904,PETERSBURG ISD,17,english,5,20,1,19,11,6,20,3,17,10,4
22,95905,PLAINVIEW ISD,17,english,5,341,94,247,158,81,343,122,221,114,54
22,96904,MEMPHIS ISD,16,english,5,29,6,23,12,4,29,5,24,11,5
22,96905,TURKEY-QUITAQUE,16,english,5,12,1,11,8,2,12,0,12,9,5
22,97902,HAMILTON ISD,12,english,5,59,5,54,37,24,59,6,53,28,13
22,97903,HICO ISD,12,english,5,38,10,28,16,9,38,8,30,11,5
22,98901,GRUVER ISD,16,english,5,22,1,21,19,11,22,0,22,21,15
22,98903,PRINGLE-MORSE C,16,english,5,8,0,8,4,3,8,1,7,2,1
22,98904,SPEARMAN ISD,16,english,5,66,5,61,42,27,66,8,58,38,18
22,99902,CHILLICOTHE ISD,9,english,5,10,6,4,3,1,10,6,4,3,2
22,99903,QUANAH ISD,9,english,5,26,5,21,11,5,26,4,22,12,4
22,100903,KOUNTZE ISD,5,english,5,70,10,60,42,25,70,15,55,26,10
22,100904,SILSBEE ISD,5,english,5,198,71,127,76,44,200,79,121,46,17
22,100905,HARDIN-JEFFERSO,5,english,5,192,27,165,116,59,192,26,166,97,39
22,100907,LUMBERTON ISD,5,english,5,302,43,259,173,103,302,74,228,132,60
22,100908,WEST HARDIN COU,5,english,5,41,10,31,21,6,41,5,36,23,8
22,101802,SER-NINOS CHART,4,english,5,71,20,51,36,22,71,16,55,29,13
22,101803,ARISTOI CLASSIC,4,english,5,111,12,99,80,50,111,21,90,52,23
22,101806,RAUL YZAGUIRRE,4,english,5,100,27,73,41,26,110,26,84,56,22
22,101810,ACADEMY OF ACCE,4,english,5,85,30,55,34,17,85,31,54,27,15
22,101814,THE VARNETT PUB,4,english,5,123,23,100,48,24,122,50,72,43,20
22,101815,ALIEF MONTESSOR,4,english,5,24,4,20,13,6,24,6,18,8,1
22,101819,AMIGOS POR VIDA,4,english,5,43,2,41,33,25,43,3,40,33,16
22,101828,HOUSTON GATEWAY,4,english,5,157,9,148,126,94,157,8,149,116,66
22,101838,SOUTHWEST SCHOO,4,english,5,125,40,85,52,31,124,40,84,54,24
22,101840,TWO DIMENSIONS,4,english,5,25,2,23,13,11,25,11,14,3,1
22,101842,COMQUEST ACADEM,4,english,5,0,,,,,0,,,,
22,101846,HARMONY PUBLIC,4,english,5,219,43,176,127,75,219,57,162,89,46
22,101847,BEATRICE MAYES,4,english,5,50,8,42,31,17,50,15,35,17,8
22,101849,ACCELERATED INT,4,english,5,26,5,21,17,12,26,2,24,20,14
22,101853,PROMISE COMMUNI,4,english,5,89,29,60,26,16,89,28,61,23,4
22,101855,MEYERPARK ELEME,4,english,5,20,7,13,8,3,18,8,10,7,1
22,101856,DRAW ACADEMY,4,english,5,61,27,34,15,7,62,26,36,15,4
22,101858,HARMONY PUBLIC,4,english,5,496,101,395,273,172,496,130,366,238,138
22,101859,STEP CHARTER SC,4,english,5,66,7,59,42,26,66,12,54,35,15
22,101861,THE RHODES SCHO,4,english,5,70,21,49,23,11,70,24,46,23,7
22,101862,HARMONY PUBLIC,4,english,5,285,26,259,204,147,285,33,252,206,132
22,101868,THE PRO-VISION,4,english,5,16,11,5,2,2,16,13,3,1,1
22,101870,BETA ACADEMY,4,english,5,99,8,91,74,51,99,5,94,66,19
22,101872,ETOILE ACADEMY,4,english,5,64,28,36,20,8,64,34,30,17,9
22,101876,REVE PREPARATOR,4,english,5,19,7,12,8,3,19,8,11,5,1
22,101902,ALDINE ISD,4,english,5,4189,1439,2750,1576,823,4211,1730,2481,1172,471
22,101903,ALIEF ISD,4,english,5,2708,932,1776,1109,661,2867,1373,1494,700,316
22,101905,CHANNELVIEW ISD,4,english,5,579,131,448,312,178,616,142,474,289,145
22,101906,CROSBY ISD,4,english,5,430,64,366,254,157,437,68,369,227,102
22,101907,CYPRESS-FAIRBAN,4,english,5,8378,1369,7009,5254,3535,8376,1761,6615,4440,2509
22,101908,DEER PARK ISD,4,english,5,943,159,784,584,369,753,177,576,302,117
22,101910,GALENA PARK ISD,4,english,5,1361,243,1118,767,482,1391,276,1115,695,324
22,101911,GOOSE CREEK CIS,4,english,5,1749,422,1327,900,524,1750,511,1239,678,323
22,101912,HOUSTON ISD,4,english,5,14016,3364,10652,7322,4720,14032,3797,10235,6344,3519
22,101913,HUMBLE ISD,4,english,5,3486,602,2884,2114,1396,3484,989,2495,1422,670
22,101914,KATY ISD,4,english,5,6415,656,5759,4662,3440,6443,870,5573,4165,2685
22,101915,KLEIN ISD,4,english,5,3792,534,3258,2470,1684,3797,674,3123,2027,1085
22,101916,LA PORTE ISD,4,english,5,496,59,437,313,186,499,52,447,292,153
22,101917,PASADENA ISD,4,english,5,3357,891,2466,1522,857,3338,1084,2254,1081,413
22,101919,SPRING ISD,4,english,5,2390,713,1677,1055,600,2400,836,1564,803,373
22,101920,SPRING BRANCH I,4,english,5,2248,424,1824,1371,929,2284,495,1789,1251,714
22,101921,TOMBALL ISD,4,english,5,1527,137,1390,1132,850,1551,158,1393,1033,643
22,101924,SHELDON ISD,4,english,5,736,184,552,353,200,736,231,505,282,144
22,101925,HUFFMAN ISD,4,english,5,290,57,233,169,110,290,87,203,113,47
22,102901,KARNACK ISD,7,english,5,9,5,4,3,2,9,2,7,3,0
22,102902,MARSHALL ISD,7,english,5,312,91,221,131,66,317,102,215,103,33
22,102903,WASKOM ISD,7,english,5,61,9,52,39,22,61,12,49,28,17
22,102904,HALLSVILLE ISD,7,english,5,782,222,560,363,225,780,345,435,263,136
22,102905,HARLETON ISD,7,english,5,51,3,48,34,15,51,6,45,19,6
22,102906,ELYSIAN FIELDS,7,english,5,63,8,55,40,27,63,7,56,46,22
22,103901,CHANNING ISD,16,english,5,15,5,10,10,5,15,3,12,6,0
22,103902,HARTLEY ISD,16,english,5,15,2,13,11,8,15,2,13,11,10
22,104901,HASKELL CISD,14,english,5,33,9,24,17,7,33,4,29,19,11
22,104903,RULE ISD,14,english,5,9,1,8,6,2,9,3,6,4,0
22,104907,PAINT CREEK ISD,14,english,5,6,0,6,2,2,6,0,6,3,1
22,105802,TEXAS PREPARATO,13,english,5,11,3,8,6,3,11,3,8,3,0
22,105803,KI CHARTER ACAD,13,english,5,21,16,5,3,1,21,19,2,1,0
22,105902,SAN MARCOS CISD,13,english,5,515,114,401,270,163,529,198,331,163,65
22,105904,DRIPPING SPRING,13,english,5,610,47,563,452,331,594,67,527,344,182
22,105905,WIMBERLEY ISD,13,english,5,214,21,193,157,99,214,44,170,97,43
22,105906,HAYS CISD,13,english,5,1534,292,1242,898,607,1541,355,1186,705,333
22,106901,CANADIAN ISD,16,english,5,45,4,41,34,27,46,3,43,32,14
22,107901,ATHENS ISD,10,english,5,209,32,177,115,76,209,48,161,96,39
22,107902,BROWNSBORO ISD,7,english,5,190,26,164,118,61,190,24,166,116,56
22,107904,CROSS ROADS ISD,7,english,5,37,6,31,25,15,38,4,34,20,11
22,107905,EUSTACE ISD,7,english,5,133,17,116,77,40,133,21,112,57,19
22,107906,MALAKOFF ISD,7,english,5,99,7,92,68,44,99,10,89,66,28
22,107907,TRINIDAD ISD,7,english,5,8,1,7,4,1,8,6,2,0,0
22,107908,MURCHISON ISD,7,english,5,15,6,9,8,1,15,5,10,6,2
22,107910,LAPOYNOR ISD,7,english,5,35,7,28,16,11,35,15,20,8,1
22,108802,HORIZON MONTESS,1,english,5,103,23,80,58,33,103,47,56,27,7
22,108807,IDEA PUBLIC SCH,1,english,5,3929,602,3327,2436,1572,3939,795,3144,1934,915
22,108808,VANGUARD ACADEM,1,english,5,417,48,369,268,172,424,98,326,183,83
22,108809,EXCELLENCE IN L,1,english,5,35,12,23,18,7,35,12,23,9,3
22,108902,DONNA ISD,1,english,5,789,223,566,315,184,900,285,615,320,141
22,108903,EDCOUCH-ELSA IS,1,english,5,294,110,184,110,55,298,133,165,57,23
22,108904,EDINBURG CISD,1,english,5,2223,399,1824,1287,802,2230,423,1807,1182,589
22,108905,HIDALGO ISD,1,english,5,114,12,102,82,55,129,13,116,86,47
22,108906,MCALLEN ISD,1,english,5,1381,204,1177,914,597,1440,225,1215,789,438
22,108907,MERCEDES ISD,1,english,5,294,78,216,129,67,296,82,214,106,34
22,108908,MISSION CISD,1,english,5,821,185,636,439,262,984,254,730,425,187
22,108909,PHARR-SAN JUAN-,1,english,5,1706,373,1333,879,504,2020,566,1454,849,403
22,108910,PROGRESO ISD,1,english,5,100,20,80,52,27,112,17,95,56,21
22,108911,SHARYLAND ISD,1,english,5,661,88,573,444,293,662,123,539,364,179
22,108912,LA JOYA ISD,1,english,5,921,147,774,567,348,1647,394,1253,753,389
22,108913,WESLACO ISD,1,english,5,1112,190,922,648,392,1113,251,862,483,210
22,108914,LA VILLA ISD,1,english,5,45,11,34,23,11,45,14,31,12,4
22,108915,MONTE ALTO ISD,1,english,5,52,11,41,30,14,52,7,45,28,13
22,108916,VALLEY VIEW ISD,1,english,5,228,32,196,148,94,229,43,186,113,58
22,109901,ABBOTT ISD,12,english,5,23,1,22,20,13,23,0,23,14,8
22,109902,BYNUM ISD,12,english,5,8,1,7,6,2,8,1,7,5,1
22,109903,COVINGTON ISD,12,english,5,24,7,17,14,7,24,6,18,8,4
22,109904,HILLSBORO ISD,12,english,5,141,41,100,52,32,141,62,79,27,8
22,109905,HUBBARD ISD,12,english,5,30,3,27,20,12,30,9,21,12,4
22,109907,ITASCA ISD,12,english,5,52,13,39,18,9,52,25,27,8,0
22,109908,MALONE ISD,12,english,5,7,2,5,2,2,7,5,2,0,0
22,109910,MOUNT CALM ISD,12,english,5,16,3,13,4,3,16,3,13,6,3
22,109911,WHITNEY ISD,12,english,5,97,15,82,52,27,97,21,76,48,26
22,109912,AQUILLA ISD,12,english,5,29,4,25,18,17,29,6,23,16,11
22,109913,BLUM ISD,12,english,5,28,6,22,18,9,28,10,18,10,2
22,109914,PENELOPE ISD,12,english,5,14,3,11,7,6,14,4,10,4,1
22,110901,ANTON ISD,17,english,5,11,4,7,2,1,11,5,6,3,1
22,110902,LEVELLAND ISD,17,english,5,189,53,136,73,42,189,69,120,41,18
22,110905,ROPES ISD,17,english,5,35,6,29,18,7,35,7,28,18,10
22,110906,SMYER ISD,17,english,5,28,3,25,19,11,28,5,23,9,4
22,110907,SUNDOWN ISD,17,english,5,45,1,44,32,20,45,0,45,41,32
22,110908,WHITHARRAL ISD,17,english,5,20,4,16,14,5,20,4,16,13,4
22,111901,GRANBURY ISD,11,english,5,548,81,467,337,225,546,64,482,345,187
22,111902,LIPAN ISD,11,english,5,32,2,30,25,13,32,4,28,20,11
22,111903,TOLAR ISD,11,english,5,66,12,54,37,21,66,14,52,27,9
22,112901,SULPHUR SPRINGS,8,english,5,310,56,254,185,108,308,47,261,155,73
22,112905,CUMBY ISD,8,english,5,25,5,20,13,6,25,11,14,4,3
22,112906,NORTH HOPKINS I,8,english,5,38,4,34,23,13,38,4,34,17,9
22,112907,MILLER GROVE IS,8,english,5,26,3,23,17,8,26,4,22,15,2
22,112908,COMO-PICKTON CI,8,english,5,62,10,52,32,19,62,17,45,18,10
22,112909,SALTILLO ISD,8,english,5,19,2,17,7,3,19,1,18,13,2
22,112910,SULPHUR BLUFF I,8,english,5,9,4,5,3,2,9,3,6,3,1
22,113901,CROCKETT ISD,6,english,5,81,33,48,25,15,81,39,42,20,9
22,113902,GRAPELAND ISD,6,english,5,39,6,33,21,12,39,2,37,19,7
22,113903,LOVELADY ISD,6,english,5,42,7,35,25,14,42,6,36,16,5
22,113905,LATEXO ISD,6,english,5,40,13,27,20,12,40,20,20,7,2
22,113906,KENNARD ISD,6,english,5,17,0,17,14,9,17,2,15,10,5
22,114901,BIG SPRING ISD,18,english,5,258,75,183,114,62,258,80,178,102,46
22,114902,COAHOMA ISD,18,english,5,73,15,58,36,20,73,17,56,29,10
22,114904,FORSAN ISD,18,english,5,57,5,52,41,27,57,8,49,30,12
22,115901,FT HANCOCK ISD,19,english,5,22,4,18,10,4,23,3,20,9,1
22,115902,SIERRA BLANCA I,19,english,5,8,2,6,4,3,8,1,7,4,1
22,115903,DELL CITY ISD,19,english,5,0,,,,,0,,,,
22,116901,CADDO MILLS ISD,10,english,5,177,9,168,135,100,178,13,165,116,58
22,116902,CELESTE ISD,10,english,5,33,12,21,15,5,33,12,21,9,0
22,116903,COMMERCE ISD,10,english,5,101,37,64,36,20,101,34,67,31,13
22,116905,GREENVILLE ISD,10,english,5,346,111,235,150,89,358,112,246,125,58
22,116906,LONE OAK ISD,10,english,5,65,13,52,40,20,65,11,54,32,7
22,116908,QUINLAN ISD,10,english,5,202,71,131,70,50,203,71,132,66,27
22,116909,WOLFE CITY ISD,10,english,5,47,7,40,25,14,47,4,43,20,3
22,116910,CAMPBELL ISD,10,english,5,30,12,18,9,7,30,20,10,2,0
22,116915,BLAND ISD,10,english,5,53,4,49,36,24,53,4,49,37,14
22,116916,BOLES ISD,10,english,5,40,14,26,14,7,40,14,26,9,4
22,117901,BORGER ISD,16,english,5,151,30,121,82,47,151,35,116,73,34
22,117903,SANFORD-FRITCH,16,english,5,40,4,36,28,19,40,5,35,14,4
22,117904,PLEMONS-STINNET,16,english,5,50,7,43,31,15,50,6,44,28,12
22,117907,SPRING CREEK IS,16,english,5,7,1,6,4,1,7,2,5,1,0
22,118902,IRION COUNTY IS,15,english,5,23,4,19,18,15,23,4,19,14,7
22,119901,BRYSON ISD,9,english,5,20,0,20,15,8,20,3,17,12,4
22,119902,JACKSBORO ISD,9,english,5,85,31,54,30,14,85,41,44,17,3
22,119903,PERRIN-WHITT CI,9,english,5,25,4,21,12,7,25,3,22,11,4
22,120901,EDNA ISD,3,english,5,97,20,77,52,28,97,11,86,62,29
22,120902,GANADO ISD,3,english,5,46,3,43,32,16,46,2,44,25,9
22,120905,INDUSTRIAL ISD,3,english,5,81,5,76,69,47,81,2,79,66,33
22,121902,BROOKELAND ISD,5,english,5,27,2,25,17,9,26,3,23,16,4
22,121903,BUNA ISD,5,english,5,110,19,91,64,37,110,26,84,43,18
22,121904,JASPER ISD,5,english,5,126,55,71,42,20,126,63,63,26,9
22,121905,KIRBYVILLE CISD,5,english,5,109,30,79,42,25,109,29,80,39,16
22,121906,EVADALE ISD,5,english,5,29,10,19,14,9,29,8,21,13,6
22,122901,FT DAVIS ISD,18,english,5,18,7,11,10,6,18,5,13,7,1
22,122902,VALENTINE ISD,18,english,5,5,1,4,3,2,5,2,3,2,0
22,123803,TEKOA ACADEMY O,5,english,5,19,7,12,3,2,19,5,14,10,2
22,123805,EHRHART SCHOOL,5,english,5,53,3,50,38,25,54,7,47,33,16
22,123807,BOB HOPE SCHOOL,5,english,5,88,14,74,45,26,89,24,65,36,22
22,123905,NEDERLAND ISD,5,english,5,378,59,319,217,137,382,72,310,202,100
22,123907,PORT ARTHUR ISD,5,english,5,598,191,407,205,110,598,250,348,146,49
22,123908,PORT NECHES-GRO,5,english,5,367,43,324,238,168,368,38,330,204,102
22,123910,BEAUMONT ISD,5,english,5,1067,420,647,388,175,1069,530,539,259,111
22,123913,SABINE PASS ISD,5,english,5,22,1,21,13,8,22,2,20,13,4
22,123914,HAMSHIRE-FANNET,5,english,5,145,27,118,64,36,144,29,115,66,32
22,124901,JIM HOGG COUNTY,1,english,5,75,14,61,40,26,75,18,57,37,15
22,125901,ALICE ISD,2,english,5,309,85,224,136,64,303,121,182,64,21
22,125902,BEN BOLT-PALITO,2,english,5,31,9,22,11,4,31,4,27,12,3
22,125903,ORANGE GROVE IS,2,english,5,136,18,118,90,55,137,14,123,83,45
22,125905,PREMONT ISD,2,english,5,49,18,31,20,10,47,19,28,13,5
22,125906,LA GLORIA ISD,2,english,5,16,1,15,12,5,16,2,14,6,1
22,126901,ALVARADO ISD,11,english,5,230,58,172,112,62,231,48,183,106,57
22,126902,BURLESON ISD,11,english,5,866,119,747,556,342,867,124,743,482,249
22,126903,CLEBURNE ISD,11,english,5,516,103,413,286,151,522,121,401,205,63
22,126904,GRANDVIEW ISD,11,english,5,100,13,87,60,32,100,5,95,71,36
22,126905,JOSHUA ISD,11,english,5,429,54,375,262,168,433,66,367,229,109
22,126906,KEENE ISD,11,english,5,77,17,60,38,22,78,28,50,24,8
22,126907,RIO VISTA ISD,11,english,5,71,24,47,31,15,71,24,47,20,10
22,126908,VENUS ISD,11,english,5,150,37,113,62,32,150,39,111,50,25
22,126911,GODLEY ISD,11,english,5,196,52,144,79,45,196,41,155,93,51
22,127901,ANSON ISD,14,english,5,56,14,42,25,11,56,24,32,12,4
22,127903,HAMLIN COLLEGIA,14,english,5,23,10,13,7,4,23,14,9,6,3
22,127904,HAWLEY ISD,14,english,5,62,14,48,26,11,62,26,36,13,10
22,127905,LUEDERS-AVOCA I,14,english,5,0,,,,,0,,,,
22,127906,STAMFORD ISD,14,english,5,29,2,27,18,11,29,2,27,17,9
22,128901,KARNES CITY ISD,20,english,5,84,31,53,17,5,84,33,51,18,5
22,128902,KENEDY ISD,3,english,5,42,13,29,19,6,42,7,35,15,5
22,128903,RUNGE ISD,3,english,5,18,4,14,9,5,18,6,12,7,3
22,128904,FALLS CITY ISD,20,english,5,28,1,27,25,16,28,0,28,22,14
22,129901,CRANDALL ISD,10,english,5,411,117,294,196,129,411,117,294,169,75
22,129902,FORNEY ISD,10,english,5,1114,229,885,599,381,1130,321,809,469,247
22,129903,KAUFMAN ISD,10,english,5,272,54,218,146,87,272,64,208,114,52
22,129904,KEMP ISD,10,english,5,113,36,77,41,23,113,23,90,48,21
22,129905,MABANK ISD,10,english,5,276,68,208,139,84,279,70,209,123,57
22,129906,TERRELL ISD,10,english,5,367,121,246,130,70,367,157,210,88,34
22,129910,SCURRY-ROSSER I,10,english,5,77,8,69,48,20,77,7,70,38,18
22,130801,MEADOWLAND CHAR,20,english,5,6,4,2,0,0,6,3,3,2,0
22,130901,BOERNE ISD,20,english,5,698,59,639,521,396,702,65,637,468,280
22,130902,COMFORT ISD,13,english,5,68,17,51,29,17,68,21,47,15,5
22,131001,KENEDY COUNTY W,2,english,5,12,0,12,10,9,12,0,12,11,4
22,132902,JAYTON-GIRARD I,17,english,5,17,2,15,12,9,17,2,15,10,6
22,133901,CENTER POINT IS,20,english,5,40,19,21,15,6,40,7,33,22,12
22,133902,HUNT ISD,20,english,5,18,2,16,10,8,18,2,16,9,5
22,133903,KERRVILLE ISD,20,english,5,317,51,266,204,131,317,34,283,189,107
22,133904,INGRAM ISD,20,english,5,80,9,71,50,22,80,7,73,52,22
22,133905,DIVIDE ISD,20,english,5,0,,,,,0,,,,
22,134901,JUNCTION ISD,15,english,5,36,8,28,16,6,36,10,26,14,3
22,135001,GUTHRIE CSD,17,english,5,16,2,14,9,6,16,1,15,12,3
22,136901,BRACKETT ISD,20,english,5,31,3,28,21,11,31,9,22,9,1
22,137901,KINGSVILLE ISD,2,english,5,166,58,108,64,42,166,70,96,45,15
22,137902,RICARDO ISD,2,english,5,60,13,47,33,19,60,13,47,28,15
22,137903,RIVIERA ISD,2,english,5,19,3,16,8,4,19,4,15,5,3
22,137904,SANTA GERTRUDIS,2,english,5,33,4,29,24,20,33,6,27,19,7
22,138902,KNOX CITY-O'BRI,9,english,5,19,6,13,7,3,19,6,13,4,2
22,138903,MUNDAY CISD,9,english,5,27,2,25,20,13,27,1,26,23,11
22,138904,BENJAMIN ISD,9,english,5,7,0,7,5,4,7,0,7,6,1
22,139905,CHISUM ISD,8,english,5,86,10,76,55,32,86,10,76,42,24
22,139909,PARIS ISD,8,english,5,262,83,179,120,71,260,99,161,82,39
22,139911,NORTH LAMAR ISD,8,english,5,158,29,129,79,42,157,28,129,72,30
22,139912,PRAIRILAND ISD,8,english,5,78,7,71,51,27,78,9,69,44,15
22,140901,AMHERST ISD,17,english,5,7,3,4,1,0,7,5,2,1,0
22,140904,LITTLEFIELD ISD,17,english,5,80,17,63,37,19,80,10,70,36,13
22,140905,OLTON ISD,17,english,5,34,13,21,9,5,34,11,23,6,2
22,140907,SPRINGLAKE-EART,17,english,5,16,3,13,8,5,16,2,14,12,5
22,140908,SUDAN ISD,17,english,5,36,6,30,20,14,36,3,33,24,12
22,141901,LAMPASAS ISD,12,english,5,260,43,217,158,93,259,37,222,140,66
22,141902,LOMETA ISD,12,english,5,19,11,8,4,1,19,6,13,4,3
22,142901,COTULLA ISD,20,english,5,77,14,63,37,17,77,29,48,18,8
22,143901,HALLETTSVILLE I,3,english,5,60,11,49,37,18,60,9,51,36,18
22,143902,MOULTON ISD,3,english,5,14,2,12,7,3,14,0,14,12,6
22,143903,SHINER ISD,3,english,5,50,2,48,41,28,50,0,50,49,39
22,143904,VYSEHRAD ISD,3,english,5,12,1,11,7,1,12,1,11,10,3
22,143905,SWEET HOME ISD,3,english,5,11,0,11,7,3,11,0,11,8,2
22,143906,EZZELL ISD,3,english,5,8,1,7,3,3,8,0,8,7,4
22,144901,GIDDINGS ISD,13,english,5,121,17,104,62,28,121,27,94,45,15
22,144902,LEXINGTON ISD,13,english,5,61,6,55,40,29,61,8,53,36,17
22,144903,DIME BOX ISD,13,english,5,15,4,11,3,1,16,7,9,3,2
22,145901,BUFFALO ISD,6,english,5,55,3,52,41,26,55,0,55,44,25
22,145902,CENTERVILLE ISD,6,english,5,46,11,35,24,9,46,11,35,14,3
22,145906,NORMANGEE ISD,6,english,5,42,6,36,23,12,41,8,33,23,10
22,145907,OAKWOOD ISD,6,english,5,17,3,14,6,3,17,4,13,6,1
22,145911,LEON ISD,6,english,5,49,10,39,29,12,49,11,38,22,6
22,146901,CLEVELAND ISD,4,english,5,830,265,565,331,166,862,369,493,243,90
22,146902,DAYTON ISD,4,english,5,425,96,329,194,115,428,115,313,168,63
22,146903,DEVERS ISD,4,english,5,27,2,25,24,15,27,1,26,23,15
22,146904,HARDIN ISD,5,english,5,92,28,64,45,22,92,21,71,33,14
22,146905,HULL-DAISETTA I,5,english,5,31,17,14,5,1,31,19,12,4,0
22,146906,LIBERTY ISD,5,english,5,162,27,135,90,54,161,36,125,50,25
22,146907,TARKINGTON ISD,4,english,5,119,22,97,60,30,119,13,106,58,33
22,147901,COOLIDGE ISD,12,english,5,25,2,23,16,7,25,4,21,10,3
22,147902,GROESBECK ISD,12,english,5,109,34,75,38,19,109,45,64,35,8
22,147903,MEXIA ISD,12,english,5,115,40,75,40,21,115,64,51,18,7
22,148901,BOOKER ISD,16,english,5,28,1,27,23,13,28,1,27,23,14
22,148902,FOLLETT ISD,16,english,5,9,5,4,0,0,9,5,4,1,0
22,148905,DARROUZETT ISD,16,english,5,8,3,5,2,0,8,6,2,1,0
22,149901,GEORGE WEST ISD,2,english,5,78,7,71,60,45,78,10,68,47,27
22,149902,THREE RIVERS IS,2,english,5,40,5,35,23,16,40,3,37,26,10
22,150901,LLANO ISD,13,english,5,135,42,93,51,26,136,45,91,49,21
22,152504,TEXAS TECH UNIV,17,english,5,11,0,11,9,8,11,1,10,8,4
22,152802,RISE ACADEMY,17,english,5,14,0,14,13,8,14,0,14,14,6
22,152806,BETTY M CONDRA,17,english,5,19,5,14,6,5,20,12,8,0,0
22,152901,LUBBOCK ISD,17,english,5,1754,338,1416,977,629,1780,368,1412,863,447
22,152902,NEW DEAL ISD,17,english,5,45,7,38,30,14,45,4,41,29,14
22,152903,SLATON ISD,17,english,5,72,16,56,35,14,72,22,50,26,12
22,152906,LUBBOCK-COOPER,17,english,5,567,59,508,380,259,568,62,506,374,225
22,152907,FRENSHIP ISD,17,english,5,755,76,679,533,362,761,70,691,484,295
22,152908,ROOSEVELT ISD,17,english,5,81,33,48,29,13,81,30,51,28,14
22,152909,SHALLOWATER ISD,17,english,5,114,4,110,92,64,114,1,113,101,63
22,152910,IDALOU ISD,17,english,5,62,11,51,37,27,62,1,61,43,21
22,153903,O'DONNELL ISD,17,english,5,19,1,18,15,8,19,0,19,13,4
22,153904,TAHOKA ISD,17,english,5,37,11,26,20,11,37,4,33,20,10
22,153905,NEW HOME ISD,17,english,5,32,1,31,27,19,32,1,31,28,22
22,153907,WILSON ISD,17,english,5,10,0,10,5,4,10,0,10,5,2
22,154901,MADISONVILLE CI,6,english,5,152,15,137,112,66,152,9,143,112,63
22,154903,NORTH ZULCH ISD,6,english,5,17,1,16,11,8,17,1,16,12,6
22,155901,JEFFERSON ISD,8,english,5,71,28,43,26,15,71,28,43,19,10
22,156902,STANTON ISD,18,english,5,81,20,61,35,21,81,20,61,38,16
22,156905,GRADY ISD,18,english,5,19,1,18,17,14,18,0,18,14,8
22,157901,MASON ISD,15,english,5,50,6,44,34,22,50,4,46,28,11
22,158901,BAY CITY ISD,3,english,5,241,69,172,115,77,241,90,151,92,45
22,158902,TIDEHAVEN ISD,3,english,5,63,6,57,46,33,63,8,55,35,21
22,158904,MATAGORDA ISD,3,english,5,0,,,,,0,,,,
22,158905,PALACIOS ISD,3,english,5,98,20,78,59,39,98,17,81,56,21
22,158906,VAN VLECK ISD,3,english,5,74,11,63,50,35,74,20,54,23,6
22,159901,EAGLE PASS ISD,20,english,5,800,180,620,366,206,809,193,616,356,136
22,160901,BRADY ISD,15,english,5,53,14,39,25,12,53,18,35,15,8
22,160904,ROCHELLE ISD,15,english,5,21,2,19,15,11,21,0,21,19,7
22,160905,LOHN ISD,15,english,5,7,4,3,2,1,7,3,4,1,1
22,161801,WACO CHARTER SC,12,english,5,24,6,18,13,7,24,5,19,6,1
22,161802,RAPOPORT ACADEM,12,english,5,63,19,44,28,18,63,25,38,14,4
22,161807,HARMONY PUBLIC,12,english,5,739,153,586,389,233,740,230,510,270,110
22,161901,CRAWFORD ISD,12,english,5,44,2,42,34,20,44,3,41,34,17
22,161903,MIDWAY ISD,12,english,5,628,75,553,448,311,628,76,552,419,258
22,161906,LA VEGA ISD,12,english,5,186,32,154,100,54,186,51,135,66,27
22,161907,LORENA ISD,12,english,5,118,14,104,81,56,118,10,108,75,46
22,161908,MART ISD,12,english,5,32,5,27,16,8,32,5,27,14,1
22,161909,MCGREGOR ISD,12,english,5,112,19,93,74,45,112,17,95,53,29
22,161910,MOODY ISD,12,english,5,41,7,34,20,8,41,16,25,10,5
22,161912,RIESEL ISD,12,english,5,26,2,24,16,12,26,1,25,18,9
22,161914,WACO ISD,12,english,5,971,330,641,364,195,973,385,588,257,105
22,161916,WEST ISD,12,english,5,73,6,67,50,35,73,7,66,51,32
22,161918,AXTELL ISD,12,english,5,53,8,45,33,27,53,5,48,31,16
22,161919,BRUCEVILLE-EDDY,12,english,5,42,3,39,25,14,43,3,40,22,12
22,161920,CHINA SPRING IS,12,english,5,231,25,206,149,107,231,33,198,141,85
22,161921,CONNALLY ISD,12,english,5,170,62,108,62,30,170,85,85,30,8
22,161922,ROBINSON ISD,12,english,5,190,21,169,135,93,190,24,166,107,49
22,161923,BOSQUEVILLE ISD,12,english,5,55,6,49,38,24,55,4,51,24,5
22,161924,HALLSBURG ISD,12,english,5,24,2,22,17,10,24,1,23,17,9
22,161925,GHOLSON ISD,12,english,5,20,4,16,7,5,20,6,14,7,6
22,162904,MCMULLEN COUNTY,2,english,5,18,1,17,14,6,18,0,18,13,8
22,163901,DEVINE ISD,20,english,5,128,23,105,70,41,128,16,112,68,32
22,163902,D'HANIS ISD,20,english,5,23,0,23,22,17,23,0,23,18,13
22,163903,NATALIA ISD,20,english,5,93,28,65,31,17,93,30,63,28,7
22,163904,HONDO ISD,20,english,5,132,35,97,64,43,133,40,93,44,23
22,163908,MEDINA VALLEY I,20,english,5,536,64,472,342,239,537,61,476,314,173
22,164901,MENARD ISD,15,english,5,16,2,14,9,6,16,5,11,8,3
22,165802,MIDLAND ACADEMY,18,english,5,37,3,34,29,23,37,1,36,28,15
22,165901,MIDLAND ISD,18,english,5,1933,426,1507,999,604,1936,459,1477,915,440
22,165902,GREENWOOD ISD,18,english,5,251,57,194,125,73,251,54,197,109,43
22,166901,CAMERON ISD,6,english,5,105,25,80,53,36,105,20,85,56,31
22,166902,GAUSE ISD,6,english,5,15,1,14,8,5,15,3,12,7,0
22,166903,MILANO ISD,6,english,5,20,3,17,7,6,20,2,18,16,9
22,166904,ROCKDALE ISD,6,english,5,92,15,77,55,34,92,13,79,49,19
22,166905,THORNDALE ISD,13,english,5,35,6,29,15,10,35,1,34,22,12
22,166907,BUCKHOLTS ISD,12,english,5,8,1,7,2,2,8,4,4,1,0
22,167901,GOLDTHWAITE ISD,12,english,5,31,0,31,25,17,31,3,28,19,9
22,167902,MULLIN ISD,12,english,5,8,3,5,4,3,8,4,4,1,0
22,167904,PRIDDY ISD,12,english,5,5,1,4,1,1,5,3,2,1,0
22,168901,COLORADO ISD,14,english,5,52,11,41,21,17,52,14,38,15,5
22,168902,LORAINE ISD,14,english,5,11,4,7,3,3,11,2,9,4,1
22,168903,WESTBROOK ISD,14,english,5,16,6,10,5,2,16,3,13,7,6
22,169901,BOWIE ISD,9,english,5,108,20,88,59,35,108,29,79,30,6
22,169902,NOCONA ISD,9,english,5,53,9,44,28,20,53,7,46,32,17
22,169906,GOLD BURG ISD,9,english,5,10,1,9,6,3,10,3,7,4,0
22,169908,MONTAGUE ISD,9,english,5,18,1,17,12,6,18,0,18,15,8
22,169909,PRAIRIE VALLEY,9,english,5,8,1,7,5,2,8,0,8,4,2
22,169910,FORESTBURG ISD,9,english,5,13,3,10,7,5,13,4,9,3,2
22,169911,SAINT JO ISD,9,english,5,22,4,18,12,8,22,3,19,10,7
22,170801,TEXAS SERENITY,6,english,5,33,15,18,7,7,33,20,13,5,2
22,170902,CONROE ISD,6,english,5,4759,727,4032,3111,2173,4780,778,4002,2827,1716
22,170903,MONTGOMERY ISD,6,english,5,681,74,607,504,351,685,69,616,466,268
22,170904,WILLIS ISD,6,english,5,601,123,478,327,188,601,119,482,267,123
22,170906,MAGNOLIA ISD,6,english,5,942,180,762,559,358,937,216,721,464,249
22,170907,SPLENDORA ISD,6,english,5,331,98,233,136,75,335,128,207,87,26
22,170908,NEW CANEY ISD,6,english,5,1202,305,897,606,392,1212,361,851,471,218
22,171901,DUMAS ISD,16,english,5,291,66,225,159,84,291,52,239,141,55
22,171902,SUNRAY COLLEGIA,16,english,5,46,9,37,27,13,46,6,40,24,12
22,172902,DAINGERFIELD-LO,8,english,5,66,19,47,23,13,66,22,44,15,6
22,172905,PEWITT CISD,8,english,5,51,6,45,29,13,51,6,45,21,6
22,173901,MOTLEY COUNTY I,17,english,5,14,0,14,8,5,14,2,12,9,4
22,174801,STEPHEN F AUSTI,7,english,5,37,0,37,32,23,37,0,37,33,22
22,174901,CHIRENO ISD,7,english,5,40,11,29,18,7,40,11,29,11,6
22,174902,CUSHING ISD,7,english,5,31,2,29,24,10,31,6,25,18,6
22,174903,GARRISON ISD,7,english,5,49,6,43,33,22,49,5,44,27,9
22,174904,NACOGDOCHES ISD,7,english,5,398,113,285,165,89,405,145,260,153,76
22,174906,WODEN ISD,7,english,5,59,11,48,25,16,58,17,41,17,3
22,174908,CENTRAL HEIGHTS,7,english,5,93,17,76,55,42,93,16,77,50,25
22,174909,MARTINSVILLE IS,7,english,5,26,4,22,16,13,26,3,23,9,4
22,174910,ETOILE ISD,7,english,5,8,1,7,4,0,8,5,3,2,0
22,174911,DOUGLASS ISD,7,english,5,33,5,28,23,18,33,5,28,23,16
22,175902,BLOOMING GROVE,12,english,5,75,10,65,41,26,75,14,61,37,13
22,175903,CORSICANA ISD,12,english,5,403,105,298,182,99,404,67,337,220,108
22,175904,DAWSON ISD,12,english,5,40,12,28,17,8,40,10,30,14,5
22,175905,FROST ISD,12,english,5,28,8,20,15,7,28,11,17,7,5
22,175907,KERENS ISD,12,english,5,45,17,28,18,7,45,13,32,11,6
22,175910,MILDRED ISD,12,english,5,78,10,68,49,27,78,14,64,38,20
22,175911,RICE ISD,12,english,5,65,17,48,35,20,65,5,60,46,28
22,176901,BURKEVILLE ISD,5,english,5,17,8,9,6,3,17,9,8,2,0
22,176902,NEWTON ISD,5,english,5,75,28,47,30,14,75,31,44,19,3
22,176903,DEWEYVILLE ISD,5,english,5,45,10,35,24,12,45,12,33,18,7
22,177901,ROSCOE COLLEGIA,14,english,5,750,361,389,200,100,747,547,200,52,18
22,177902,SWEETWATER ISD,14,english,5,129,33,96,70,35,129,22,107,63,26
22,177903,BLACKWELL CISD,14,english,5,8,0,8,7,5,8,0,8,6,2
22,177905,HIGHLAND ISD,14,english,5,17,1,16,14,11,17,2,15,10,5
22,178801,DR M L GARZA-GO,2,english,5,16,1,15,10,8,16,4,12,5,2
22,178807,CORPUS CHRISTI,2,english,5,8,0,8,7,5,8,2,6,4,2
22,178808,SEASHORE CHARTE,2,english,5,59,5,54,42,25,51,11,40,18,8
22,178901,AGUA DULCE ISD,2,english,5,28,4,24,13,6,28,7,21,11,3
22,178902,BISHOP CISD,2,english,5,96,15,81,48,30,94,18,76,35,18
22,178903,CALALLEN ISD,2,english,5,294,48,246,163,92,293,53,240,136,74
22,178904,CORPUS CHRISTI,2,english,5,2352,561,1791,1180,746,2367,588,1779,1030,477
22,178905,DRISCOLL ISD,2,english,5,32,3,29,23,18,32,7,25,14,4
22,178906,LONDON ISD,2,english,5,120,9,111,92,68,119,9,110,79,47
22,178908,PORT ARANSAS IS,2,english,5,31,5,26,23,16,31,6,25,20,13
22,178909,ROBSTOWN ISD,2,english,5,150,44,106,62,42,150,58,92,40,19
22,178912,TULOSO-MIDWAY I,2,english,5,250,28,222,162,100,250,61,189,116,51
22,178913,BANQUETE ISD,2,english,5,50,2,48,38,26,50,5,45,30,14
22,178914,FLOUR BLUFF ISD,2,english,5,393,44,349,275,191,393,67,326,211,118
22,178915,WEST OSO ISD,2,english,5,126,25,101,71,38,127,31,96,47,17
22,179901,PERRYTON ISD,16,english,5,145,15,130,97,55,145,9,136,105,63
22,180901,BOYS RANCH ISD,16,english,5,6,1,5,3,2,6,2,4,2,2
22,180902,VEGA ISD,16,english,5,29,0,29,22,15,29,0,29,18,12
22,180903,ADRIAN ISD,16,english,5,6,0,6,4,3,6,0,6,4,1
22,180904,WILDORADO ISD,16,english,5,16,2,14,7,6,16,5,11,5,1
22,181901,BRIDGE CITY ISD,5,english,5,228,39,189,141,86,227,49,178,100,46
22,181905,ORANGEFIELD ISD,5,english,5,127,30,97,69,44,127,19,108,71,38
22,181906,WEST ORANGE-COV,5,english,5,157,64,93,44,22,158,98,60,18,5
22,181907,VIDOR ISD,5,english,5,319,45,274,199,124,319,81,238,139,65
22,181908,LITTLE CYPRESS-,5,english,5,241,50,191,121,62,241,75,166,67,26
22,182901,GORDON ISD,11,english,5,15,5,10,5,3,15,9,6,3,2
22,182902,GRAFORD ISD,11,english,5,35,5,30,24,15,35,7,28,20,6
22,182903,MINERAL WELLS I,11,english,5,214,53,161,97,52,214,31,183,112,53
22,182904,SANTO ISD,11,english,5,31,1,30,15,11,31,1,30,21,10
22,182905,STRAWN ISD,11,english,5,6,0,6,3,2,6,2,4,2,2
22,182906,PALO PINTO ISD,11,english,5,9,0,9,8,5,9,1,8,7,2
22,183901,BECKVILLE ISD,7,english,5,45,5,40,23,16,45,4,41,32,15
22,183902,CARTHAGE ISD,7,english,5,176,43,133,81,45,177,38,139,77,34
22,183904,GARY ISD,7,english,5,35,8,27,19,8,35,7,28,14,6
22,184901,POOLVILLE ISD,11,english,5,49,7,42,25,13,49,3,46,35,22
22,184902,SPRINGTOWN ISD,11,english,5,279,71,208,116,63,279,106,173,96,34
22,184903,WEATHERFORD ISD,11,english,5,569,92,477,316,194,568,131,437,248,117
22,184904,MILLSAP ISD,11,english,5,75,14,61,41,26,75,4,71,38,20
22,184907,ALEDO ISD,11,english,5,579,55,524,429,318,581,50,531,389,231
22,184908,PEASTER ISD,11,english,5,109,14,95,67,41,109,11,98,73,49
22,184909,BROCK ISD,11,english,5,147,6,141,128,97,147,4,143,121,79
22,184911,GARNER ISD,11,english,5,17,5,12,7,1,17,5,12,4,1
22,185901,BOVINA ISD,16,english,5,24,6,18,12,4,24,3,21,16,11
22,185902,FARWELL ISD,16,english,5,38,3,35,30,19,38,0,38,33,24
22,185903,FRIONA ISD,16,english,5,70,23,47,28,17,70,26,44,18,7
22,185904,LAZBUDDIE ISD,16,english,5,17,3,14,10,6,17,6,11,5,2
22,186901,BUENA VISTA ISD,18,english,5,18,2,16,12,8,18,5,13,9,3
22,186902,FORT STOCKTON I,18,english,5,165,51,114,67,32,165,46,119,49,22
22,186903,IRAAN-SHEFFIELD,18,english,5,28,8,20,11,6,28,4,24,10,5
22,187901,BIG SANDY ISD,6,english,5,42,12,30,18,10,42,4,38,21,10
22,187903,GOODRICH ISD,6,english,5,11,2,9,6,2,11,6,5,3,2
22,187904,CORRIGAN-CAMDEN,6,english,5,63,19,44,26,15,64,22,42,26,12
22,187906,LEGGETT ISD,6,english,5,22,9,13,7,3,22,12,10,2,0
22,187907,LIVINGSTON ISD,6,english,5,276,35,241,162,112,275,35,240,162,93
22,187910,ONALASKA ISD,6,english,5,88,15,73,50,30,88,11,77,48,19
22,188901,AMARILLO ISD,16,english,5,2104,316,1788,1287,815,2190,337,1853,1137,558
22,188902,RIVER ROAD ISD,16,english,5,77,22,55,34,19,77,29,48,24,9
22,188903,HIGHLAND PARK I,16,english,5,60,7,53,42,24,60,3,57,43,23
22,188904,BUSHLAND ISD,16,english,5,112,10,102,85,62,112,12,100,68,41
22,189901,MARFA ISD,18,english,5,10,1,9,6,3,10,3,7,3,1
22,189902,PRESIDIO ISD,18,english,5,51,14,37,30,17,51,10,41,28,13
22,190903,RAINS ISD,7,english,5,119,24,95,54,36,119,32,87,51,23
22,191901,CANYON ISD,16,english,5,831,83,748,600,410,831,72,759,576,322
22,192901,REAGAN COUNTY I,18,english,5,47,12,35,27,13,47,15,32,15,4
22,193801,BIG SPRINGS CHA,20,english,5,12,5,7,5,1,12,7,5,1,0
22,193902,LEAKEY ISD,20,english,5,24,3,21,15,5,24,7,17,8,2
22,194902,AVERY ISD,8,english,5,30,6,24,17,9,30,2,28,23,18
22,194903,RIVERCREST ISD,8,english,5,52,11,41,26,12,52,5,47,29,9
22,194904,CLARKSVILLE ISD,8,english,5,31,6,25,13,7,31,6,25,11,4
22,194905,DETROIT ISD,8,english,5,40,9,31,21,11,40,11,29,15,8
22,195901,PECOS-BARSTOW-T,18,english,5,185,34,151,95,48,187,47,140,78,43
22,195902,BALMORHEA ISD,18,english,5,7,1,6,3,2,7,1,6,1,0
22,196901,AUSTWELL-TIVOLI,3,english,5,12,6,6,4,2,12,2,10,5,1
22,196902,WOODSBORO ISD,3,english,5,36,5,31,21,15,36,3,33,25,10
22,196903,REFUGIO ISD,3,english,5,42,9,33,22,13,42,7,35,17,5
22,197902,MIAMI ISD,16,english,5,15,2,13,10,7,15,1,14,8,5
22,198901,BREMOND ISD,6,english,5,42,4,38,28,14,42,2,40,26,9
22,198902,CALVERT ISD,6,english,5,6,1,5,1,0,6,2,4,3,1
22,198903,FRANKLIN ISD,6,english,5,91,4,87,57,43,91,1,90,62,33
22,198905,HEARNE ISD,6,english,5,44,20,24,11,6,44,15,29,7,0
22,198906,MUMFORD ISD,6,english,5,41,1,40,34,22,41,1,40,34,19
22,199901,ROCKWALL ISD,10,english,5,1281,168,1113,828,564,1215,190,1025,705,422
22,199902,ROYSE CITY ISD,10,english,5,600,97,503,352,213,600,90,510,318,151
22,200901,BALLINGER ISD,15,english,5,58,16,42,30,21,58,11,47,24,7
22,200902,MILES ISD,15,english,5,31,2,29,21,15,31,2,29,28,19
22,200904,WINTERS ISD,15,english,5,33,6,27,19,12,33,5,28,15,8
22,200906,OLFEN ISD,15,english,5,10,2,8,3,2,10,6,4,1,1
22,201902,HENDERSON ISD,7,english,5,251,83,168,84,40,251,100,151,74,18
22,201903,LANEVILLE ISD,7,english,5,11,4,7,3,1,11,0,11,8,1
22,201904,LEVERETTS CHAPE,7,english,5,19,3,16,10,6,19,4,15,8,4
22,201907,MOUNT ENTERPRIS,7,english,5,31,0,31,23,13,31,0,31,29,21
22,201908,OVERTON ISD,7,english,5,31,2,29,19,13,31,2,29,20,9
22,201910,TATUM ISD,7,english,5,100,9,91,67,46,100,10,90,62,29
22,201913,CARLISLE ISD,7,english,5,36,2,34,23,6,36,3,33,17,9
22,201914,WEST RUSK COUNT,7,english,5,83,16,67,49,25,83,14,69,38,14
22,202903,HEMPHILL ISD,7,english,5,59,11,48,33,19,59,12,47,16,5
22,202905,WEST SABINE ISD,7,english,5,38,12,26,12,6,38,11,27,8,1
22,203901,SAN AUGUSTINE I,7,english,5,35,19,16,8,3,35,17,18,7,5
22,203902,BROADDUS ISD,7,english,5,24,2,22,17,10,24,1,23,14,7
22,204901,COLDSPRING-OAKH,6,english,5,102,38,64,38,22,102,36,66,34,17
22,204904,SHEPHERD ISD,6,english,5,133,57,76,43,24,133,39,94,58,30
22,205901,ARANSAS PASS IS,2,english,5,123,35,88,45,26,123,47,76,30,9
22,205902,GREGORY-PORTLAN,2,english,5,325,56,269,187,127,325,61,264,166,88
22,205903,INGLESIDE ISD,2,english,5,143,12,131,95,53,143,28,115,71,30
22,205904,MATHIS ISD,2,english,5,122,14,108,71,38,122,23,99,50,10
22,205905,ODEM-EDROY ISD,2,english,5,56,24,32,18,13,56,34,22,4,1
22,205906,SINTON ISD,2,english,5,125,12,113,72,43,125,29,96,56,31
22,205907,TAFT ISD,2,english,5,55,19,36,19,12,55,21,34,19,8
22,206901,SAN SABA ISD,15,english,5,47,9,38,30,15,47,6,41,22,12
22,206902,RICHLAND SPRING,15,english,5,6,0,6,4,3,6,0,6,1,0
22,206903,CHEROKEE ISD,15,english,5,12,2,10,8,7,12,5,7,2,0
22,207901,SCHLEICHER ISD,15,english,5,25,4,21,9,4,25,2,23,11,5
22,208901,HERMLEIGH ISD,14,english,5,23,5,18,15,11,23,5,18,12,2
22,208902,SNYDER ISD,14,english,5,168,49,119,67,35,172,42,130,83,46
22,208903,IRA ISD,14,english,5,23,2,21,20,16,23,2,21,19,14
22,209901,ALBANY ISD,14,english,5,31,7,24,16,12,31,9,22,15,5
22,209902,MORAN ISD,14,english,5,10,6,4,1,0,10,9,1,0,0
22,210901,CENTER ISD,7,english,5,174,44,130,65,34,174,50,124,51,14
22,210902,JOAQUIN ISD,7,english,5,41,8,33,23,12,41,6,35,23,11
22,210903,SHELBYVILLE ISD,7,english,5,58,7,51,35,19,58,7,51,43,22
22,210904,TENAHA ISD,7,english,5,32,6,26,19,13,32,2,30,21,14
22,210905,TIMPSON ISD,7,english,5,49,20,29,17,9,49,9,40,8,0
22,210906,EXCELSIOR ISD,7,english,5,7,2,5,1,1,7,5,2,1,0
22,211902,STRATFORD ISD,16,english,5,40,9,31,27,16,39,7,32,18,8
22,212801,CUMBERLAND ACAD,7,english,5,127,31,96,61,32,127,35,92,42,16
22,212804,UT TYLER UNIVER,7,english,5,62,3,59,56,33,63,5,58,44,23
22,212901,ARP ISD,7,english,5,68,16,52,30,17,68,17,51,27,9
22,212902,BULLARD ISD,7,english,5,220,26,194,156,108,220,30,190,135,82
22,212903,LINDALE ISD,7,english,5,312,25,287,234,157,311,20,291,229,155
22,212904,TROUP ISD,7,english,5,75,11,64,47,30,75,13,62,39,16
22,212905,TYLER ISD,7,english,5,1243,244,999,700,426,1299,365,934,551,290
22,212906,WHITEHOUSE ISD,7,english,5,366,25,341,271,176,366,32,334,243,162
22,212909,CHAPEL HILL ISD,7,english,5,193,55,138,84,51,205,90,115,45,21
22,212910,WINONA ISD,7,english,5,78,23,55,36,23,77,31,46,26,10
22,213801,BRAZOS RIVER CH,11,english,5,6,3,3,2,0,6,4,2,0,0
22,213901,GLEN ROSE ISD,11,english,5,135,11,124,101,67,137,16,121,82,42
22,214901,RIO GRANDE CITY,1,english,5,636,168,468,288,152,637,226,411,210,79
22,214902,SAN ISIDRO ISD,1,english,5,8,2,6,5,3,8,3,5,1,1
22,214903,ROMA ISD,1,english,5,442,51,391,304,206,444,56,388,302,176
22,215901,BRECKENRIDGE IS,14,english,5,91,24,67,41,25,91,30,61,25,12
22,216901,STERLING CITY I,15,english,5,19,1,18,12,5,19,5,14,6,3
22,217901,ASPERMONT ISD,14,english,5,13,1,12,9,6,13,0,13,7,3
22,218901,SONORA ISD,15,english,5,51,10,41,29,19,51,12,39,21,14
22,219901,HAPPY ISD,16,english,5,14,0,14,10,6,14,1,13,10,3
22,219903,TULIA ISD,16,english,5,49,28,21,8,5,49,23,26,6,1
22,219905,KRESS ISD,16,english,5,23,8,15,11,5,23,5,18,11,4
22,220801,TREETOPS SCHOOL,11,english,5,32,1,31,25,13,32,6,26,16,4
22,220802,ARLINGTON CLASS,11,english,5,177,10,167,143,116,177,16,161,126,75
22,220809,FORT WORTH ACAD,11,english,5,65,4,61,35,27,65,6,59,46,18
22,220810,WESTLAKE ACADEM,11,english,5,63,0,63,56,45,63,2,61,52,45
22,220811,EAST FORT WORTH,11,english,5,17,1,16,11,9,17,6,11,6,2
22,220814,TEXAS SCHOOL OF,11,english,5,38,4,34,27,16,38,9,29,12,3
22,220815,CHAPEL HILL ACA,11,english,5,77,18,59,34,19,77,24,53,29,12
22,220817,NEWMAN INTERNAT,11,english,5,218,44,174,113,60,217,49,168,90,38
22,220819,HIGH POINT ACAD,11,english,5,135,20,115,74,37,136,51,85,27,5
22,220901,ARLINGTON ISD,11,english,5,3698,896,2802,1824,1107,3734,1260,2474,1354,602
22,220902,BIRDVILLE ISD,11,english,5,1566,255,1311,941,631,1577,343,1234,736,372
22,220904,EVERMAN ISD,11,english,5,348,84,264,151,80,370,134,236,121,52
22,220905,FORT WORTH ISD,11,english,5,4900,1425,3475,2214,1314,5194,1956,3238,1703,750
22,220906,GRAPEVINE-COLLE,11,english,5,1002,115,887,730,534,991,133,858,597,325
22,220907,KELLER ISD,11,english,5,2510,325,2185,1629,1081,2584,434,2150,1414,824
22,220908,MANSFIELD ISD,11,english,5,2457,408,2049,1433,878,2460,506,1954,1225,652
22,220910,LAKE WORTH ISD,11,english,5,238,111,127,66,37,246,160,86,27,6
22,220912,CROWLEY ISD,11,english,5,1031,228,803,540,333,1109,362,747,395,191
22,220914,KENNEDALE ISD,11,english,5,177,37,140,91,54,176,59,117,61,25
22,220915,AZLE ISD,11,english,5,507,95,412,268,157,507,100,407,237,95
22,220916,HURST-EULESS-BE,11,english,5,1549,191,1358,1009,672,1550,257,1293,876,491
22,220917,CASTLEBERRY ISD,11,english,5,242,70,172,113,71,262,97,165,85,42
22,220918,EAGLE MT-SAGINA,11,english,5,1580,256,1324,931,585,1589,371,1218,686,314
22,220919,CARROLL ISD,11,english,5,641,21,620,547,452,477,16,461,381,264
22,220920,WHITE SETTLEMEN,11,english,5,461,84,377,245,152,482,123,359,196,95
22,221801,TEXAS COLLEGE P,14,english,5,1331,211,1120,829,515,1329,322,1007,567,285
22,221901,ABILENE ISD,14,english,5,1089,281,808,519,296,1098,351,747,366,142
22,221904,MERKEL ISD,14,english,5,70,11,59,41,22,70,12,58,42,19
22,221905,TRENT ISD,14,english,5,12,4,8,6,3,12,6,6,1,1
22,221911,JIM NED CISD,14,english,5,112,8,104,85,54,112,4,108,75,43
22,221912,WYLIE ISD,14,english,5,398,41,357,276,192,399,17,382,295,189
22,222901,TERRELL COUNTY,18,english,5,5,0,5,4,3,5,0,5,5,4
22,223901,BROWNFIELD ISD,17,english,5,97,41,56,35,18,97,41,56,31,11
22,223902,MEADOW ISD,17,english,5,20,1,19,13,6,20,5,15,13,6
22,223904,WELLMAN-UNION C,17,english,5,20,2,18,10,5,20,1,19,15,6
22,224901,THROCKMORTON CO,9,english,5,7,5,2,1,0,7,5,2,0,0
22,224902,WOODSON ISD,9,english,5,0,,,,,0,,,,
22,225902,MOUNT PLEASANT,8,english,5,214,38,176,118,72,316,52,264,169,75
22,225906,CHAPEL HILL ISD,8,english,5,78,4,74,58,36,78,0,78,73,51
22,225907,HARTS BLUFF ISD,8,english,5,58,11,47,32,16,65,14,51,31,13
22,226801,TEXAS LEADERSHI,15,english,5,263,58,205,123,62,263,81,182,71,24
22,226901,CHRISTOVAL ISD,15,english,5,43,7,36,32,23,43,5,38,30,15
22,226903,SAN ANGELO ISD,15,english,5,983,234,749,481,303,979,344,635,341,154
22,226905,WATER VALLEY IS,15,english,5,22,1,21,14,6,22,3,19,10,4
22,226906,WALL ISD,15,english,5,92,3,89,74,57,92,4,88,75,47
22,226907,GRAPE CREEK ISD,15,english,5,79,17,62,36,15,79,10,69,40,14
22,226908,VERIBEST ISD,15,english,5,21,2,19,17,10,21,0,21,15,9
22,227803,WAYSIDE SCHOOLS,13,english,5,134,26,108,81,52,137,33,104,59,23
22,227804,NYOS CHARTER SC,13,english,5,89,5,84,66,45,88,12,76,46,25
22,227805,TEXAS EMPOWERME,13,english,5,34,14,20,11,8,32,12,20,11,4
22,227806,UNIVERSITY OF T,13,english,5,28,17,11,5,5,28,18,10,6,3
22,227814,CHAPARRAL STAR,13,english,5,29,1,28,25,20,29,3,26,23,16
22,227816,HARMONY PUBLIC,13,english,5,314,77,237,165,105,314,107,207,134,77
22,227817,CEDARS INTERNAT,13,english,5,29,6,23,14,7,29,3,26,10,1
22,227819,UNIVERSITY OF T,13,english,5,44,7,37,34,23,44,6,38,27,17
22,227820,KIPP TEXAS PUBL,4,english,5,2386,675,1711,1103,651,2389,941,1448,679,282
22,227821,AUSTIN DISCOVER,13,english,5,59,7,52,40,33,58,22,36,21,9
22,227824,VALERE PUBLIC S,13,english,5,60,15,45,25,16,59,23,36,20,10
22,227825,AUSTIN ACHIEVE,13,english,5,148,79,69,27,13,148,91,57,21,8
22,227826,MONTESSORI FOR,13,english,5,47,7,40,31,22,47,11,36,19,9
22,227829,VALOR PUBLIC SC,13,english,5,103,9,94,81,57,103,13,90,66,41
22,227901,AUSTIN ISD,13,english,5,4642,698,3944,3079,2208,4943,1076,3867,2513,1436
22,227904,PFLUGERVILLE IS,13,english,5,1625,283,1342,963,629,1735,472,1263,710,351
22,227905,TEXAS SCH FOR T,13,english,5,0,,,,,0,,,,
22,227906,TEXAS SCH FOR T,13,english,5,22,20,2,0,0,22,21,1,0,0
22,227907,MANOR ISD,13,english,5,629,182,447,270,159,630,278,352,180,68
22,227909,EANES ISD,13,english,5,610,31,579,500,384,559,40,519,406,249
22,227910,DEL VALLE ISD,13,english,5,530,152,378,240,123,736,294,442,212,86
22,227912,LAGO VISTA ISD,13,english,5,129,17,112,93,72,130,24,106,64,31
22,227913,LAKE TRAVIS ISD,13,english,5,816,94,722,568,393,809,136,673,449,262
22,228901,GROVETON ISD,6,english,5,61,8,53,33,20,61,2,59,49,28
22,228903,TRINITY ISD,6,english,5,95,37,58,30,14,95,40,55,22,9
22,228904,CENTERVILLE ISD,6,english,5,13,5,8,5,3,13,4,9,3,0
22,228905,APPLE SPRINGS I,6,english,5,16,2,14,12,5,16,6,10,7,1
22,229901,COLMESNEIL ISD,5,english,5,36,15,21,11,5,36,14,22,9,2
22,229903,WOODVILLE ISD,5,english,5,84,27,57,40,23,84,29,55,26,9
22,229904,WARREN ISD,5,english,5,92,17,75,59,33,92,26,66,33,8
22,229905,SPURGER ISD,5,english,5,24,1,23,17,8,24,3,21,15,6
22,229906,CHESTER ISD,5,english,5,14,3,11,9,5,14,1,13,6,2
22,230901,BIG SANDY ISD,7,english,5,49,11,38,29,19,49,7,42,30,16
22,230902,GILMER ISD,7,english,5,179,29,150,100,70,179,34,145,99,56
22,230903,ORE CITY ISD,7,english,5,59,19,40,22,14,59,21,38,16,5
22,230904,UNION HILL ISD,7,english,5,18,3,15,10,9,18,1,17,10,7
22,230905,HARMONY ISD,7,english,5,94,6,88,69,46,94,6,88,59,33
22,230906,NEW DIANA ISD,7,english,5,94,6,88,69,51,94,6,88,66,37
22,230908,UNION GROVE ISD,7,english,5,50,1,49,39,25,50,9,41,25,12
22,231901,MCCAMEY ISD,18,english,5,32,11,21,11,6,33,14,19,9,4
22,231902,RANKIN ISD,18,english,5,21,3,18,11,9,21,3,18,10,9
22,232901,KNIPPA ISD,20,english,5,29,0,29,27,22,29,0,29,21,14
22,232902,SABINAL ISD,20,english,5,23,5,18,14,10,23,5,18,10,5
22,232903,UVALDE CISD,20,english,5,281,90,191,126,79,286,122,164,79,35
22,232904,UTOPIA ISD,20,english,5,14,3,11,5,2,14,6,8,1,0
22,233901,SAN FELIPE-DEL,15,english,5,661,149,512,312,177,662,170,492,261,96
22,233903,COMSTOCK ISD,15,english,5,22,3,19,11,5,22,2,20,14,8
22,234902,CANTON ISD,10,english,5,181,15,166,119,76,181,17,164,97,45
22,234903,EDGEWOOD ISD,7,english,5,79,14,65,35,17,79,23,56,23,6
22,234904,GRAND SALINE IS,7,english,5,84,22,62,44,29,84,25,59,39,16
22,234905,MARTINS MILL IS,7,english,5,44,9,35,31,19,44,7,37,24,14
22,234906,VAN ISD,7,english,5,163,18,145,110,68,164,13,151,119,76
22,234907,WILLS POINT ISD,10,english,5,206,72,134,74,43,206,88,118,49,18
22,234909,FRUITVALE ISD,7,english,5,27,5,22,13,7,27,9,18,6,2
22,235901,BLOOMINGTON ISD,3,english,5,58,28,30,14,7,59,31,28,5,2
22,235902,VICTORIA ISD,3,english,5,910,237,673,415,236,910,299,611,329,145
22,235904,NURSERY ISD,3,english,5,25,0,25,23,17,25,1,24,23,18
22,236802,SAM HOUSTON STA,6,english,5,47,5,42,37,20,47,5,42,28,12
22,236901,NEW WAVERLY ISD,6,english,5,81,7,74,54,41,81,5,76,48,17
22,236902,HUNTSVILLE ISD,6,english,5,1347,388,959,608,337,1348,637,711,311,138
22,237902,HEMPSTEAD ISD,4,english,5,95,45,50,22,11,96,61,35,13,4
22,237904,WALLER ISD,4,english,5,627,133,494,333,202,627,163,464,253,115
22,237905,ROYAL ISD,4,english,5,165,48,117,72,29,164,40,124,51,18
22,238902,MONAHANS-WICKET,18,english,5,165,44,121,79,44,165,40,125,61,32
22,238904,GRANDFALLS-ROYA,18,english,5,6,3,3,1,0,6,4,2,0,0
22,239901,BRENHAM ISD,6,english,5,352,71,281,185,109,352,77,275,183,94
22,239903,BURTON ISD,6,english,5,32,3,29,22,11,32,2,30,26,17
22,240901,LAREDO ISD,1,english,5,1374,264,1110,759,459,1375,289,1086,682,374
22,240903,UNITED ISD,1,english,5,2842,451,2391,1737,1081,2834,505,2329,1521,807
22,240904,WEBB CISD,1,english,5,15,10,5,3,3,15,10,5,4,2
22,241901,BOLING ISD,3,english,5,86,13,73,50,34,86,12,74,44,12
22,241902,EAST BERNARD IS,3,english,5,72,14,58,41,22,73,12,61,42,16
22,241903,EL CAMPO ISD,3,english,5,241,53,188,120,79,241,32,209,142,85
22,241904,WHARTON ISD,3,english,5,103,50,53,28,13,103,55,48,19,8
22,241906,LOUISE ISD,3,english,5,45,5,40,31,20,45,7,38,28,14
22,242902,SHAMROCK ISD,16,english,5,19,6,13,5,3,19,7,12,4,0
22,242903,WHEELER ISD,16,english,5,34,1,33,20,12,34,0,34,23,8
22,242905,KELTON ISD,16,english,5,11,3,8,7,5,11,5,6,5,3
22,242906,FORT ELLIOTT CI,16,english,5,17,2,15,13,5,17,3,14,12,6
22,243901,BURKBURNETT ISD,9,english,5,234,73,161,93,49,234,74,160,82,34
22,243902,ELECTRA ISD,9,english,5,29,8,21,11,4,29,10,19,10,4
22,243903,IOWA PARK CISD,9,english,5,135,17,118,84,48,135,21,114,100,59
22,243905,WICHITA FALLS I,9,english,5,914,229,685,435,258,914,272,642,342,157
22,243906,CITY VIEW ISD,9,english,5,87,19,68,48,32,87,12,75,42,22
22,244901,HARROLD ISD,9,english,5,9,1,8,5,2,9,2,7,2,1
22,244903,VERNON ISD,9,english,5,126,52,74,48,29,126,52,74,33,13
22,244905,NORTHSIDE ISD,9,english,5,22,5,17,7,4,22,7,15,8,3
22,245901,LASARA ISD,1,english,5,31,4,27,14,9,31,13,18,6,1
22,245902,LYFORD CISD,1,english,5,90,15,75,49,25,90,34,56,31,11
22,245903,RAYMONDVILLE IS,1,english,5,140,24,116,81,49,140,21,119,72,31
22,245904,SAN PERLITA ISD,1,english,5,12,0,12,8,4,12,1,11,10,5
22,246801,MERIDIAN WORLD,13,english,5,148,12,136,108,84,149,12,137,106,70
22,246802,GOODWATER MONTE,13,english,5,21,4,17,12,6,21,9,12,5,1
22,246902,FLORENCE ISD,13,english,5,91,26,65,34,23,91,38,53,20,14
22,246904,GEORGETOWN ISD,13,english,5,890,184,706,460,276,899,298,601,298,135
22,246905,GRANGER ISD,13,english,5,40,11,29,17,8,40,13,27,12,4
22,246906,HUTTO ISD,13,english,5,628,99,529,361,216,657,162,495,271,118
22,246907,JARRELL ISD,13,english,5,216,76,140,78,44,217,122,95,39,18
22,246908,LIBERTY HILL IS,13,english,5,579,68,511,390,263,583,79,504,324,157
22,246909,ROUND ROCK ISD,13,english,5,3303,391,2912,2393,1811,3348,578,2770,2000,1310
22,246911,TAYLOR ISD,13,english,5,185,66,119,66,32,188,88,100,39,9
22,246912,THRALL ISD,13,english,5,57,7,50,38,24,57,9,48,27,13
22,246913,LEANDER ISD,13,english,5,2872,344,2528,1998,1466,2929,642,2287,1440,810
22,246914,COUPLAND ISD,13,english,5,33,5,28,15,10,33,8,25,14,7
22,247901,FLORESVILLE ISD,20,english,5,259,61,198,137,87,266,64,202,117,62
22,247903,LA VERNIA ISD,20,english,5,250,20,230,177,109,255,22,233,164,86
22,247904,POTH ISD,20,english,5,71,3,68,58,42,71,6,65,54,32
22,247906,STOCKDALE ISD,20,english,5,56,6,50,41,26,56,11,45,26,13
22,248901,KERMIT ISD,18,english,5,89,25,64,47,25,89,39,50,24,8
22,248902,WINK-LOVING ISD,18,english,5,28,4,24,19,14,28,2,26,19,11
22,249901,ALVORD ISD,11,english,5,64,7,57,41,27,64,5,59,44,20
22,249902,BOYD ISD,11,english,5,93,26,67,40,30,93,32,61,26,10
22,249903,BRIDGEPORT ISD,11,english,5,128,25,103,74,48,140,56,84,27,5
22,249904,CHICO ISD,11,english,5,46,3,43,34,25,46,5,41,25,11
22,249905,DECATUR ISD,11,english,5,268,45,223,163,107,282,70,212,111,51
22,249906,PARADISE ISD,11,english,5,106,7,99,81,64,106,2,104,80,47
22,249908,SLIDELL ISD,11,english,5,32,16,16,8,4,32,20,12,4,2
22,250902,HAWKINS ISD,7,english,5,46,10,36,23,13,46,4,42,17,7
22,250903,MINEOLA ISD,7,english,5,122,11,111,71,43,122,13,109,71,38
22,250904,QUITMAN ISD,7,english,5,84,20,64,41,26,84,19,65,33,10
22,250905,YANTIS ISD,7,english,5,25,1,24,9,3,25,6,19,7,3
22,250906,ALBA-GOLDEN ISD,7,english,5,66,11,55,36,16,66,14,52,17,7
22,250907,WINNSBORO ISD,7,english,5,88,20,68,45,27,88,19,69,43,30
22,251901,DENVER CITY ISD,17,english,5,116,23,93,65,49,116,17,99,65,32
22,251902,PLAINS ISD,17,english,5,23,7,16,9,5,23,11,12,6,1
22,252901,GRAHAM ISD,9,english,5,160,36,124,85,48,160,31,129,84,28
22,252902,NEWCASTLE ISD,9,english,5,18,1,17,11,3,18,4,14,7,3
22,252903,OLNEY ISD,9,english,5,34,3,31,24,16,34,7,27,17,5
22,253901,ZAPATA COUNTY I,1,english,5,241,77,164,94,43,240,83,157,93,42
22,254901,CRYSTAL CITY IS,20,english,5,108,33,75,33,13,108,53,55,21,7
22,254902,LA PRYOR ISD,20,english,5,23,1,22,15,8,23,3,20,10,6
22,1904,FRANKSTON ISD,7,spanish,5,0,,,,,0,,,,
22,2901,ANDREWS ISD,18,spanish,5,10,3,7,4,2,9,5,4,3,0
22,3903,LUFKIN ISD,7,spanish,5,0,,,,,0,,,,
22,4901,ARANSAS COUNTY,2,spanish,5,0,,,,,0,,,,
22,8902,SEALY ISD,6,spanish,5,0,,,,,0,,,,
22,11901,BASTROP ISD,13,spanish,5,22,14,8,3,1,22,19,3,0,0
22,11902,ELGIN ISD,13,spanish,5,30,19,11,6,3,0,,,,
22,13901,BEEVILLE ISD,2,spanish,5,0,,,,,0,,,,
22,14803,PRIORITY CHARTE,12,spanish,5,0,,,,,0,,,,
22,14902,BARTLETT ISD,13,spanish,5,0,,,,,0,,,,
22,14903,BELTON ISD,12,spanish,5,7,2,5,3,2,6,1,5,1,0
22,14906,KILLEEN ISD,12,spanish,5,22,9,13,3,3,18,8,10,3,1
22,14908,SALADO ISD,12,spanish,5,0,,,,,0,,,,
22,14909,TEMPLE ISD,12,spanish,5,18,10,8,5,3,6,4,2,0,0
22,15802,GEORGE GERVIN A,20,spanish,5,8,3,5,4,2,8,3,5,2,0
22,15822,JUBILEE ACADEMI,20,spanish,5,25,6,19,12,3,24,8,16,6,0
22,15827,SCHOOL OF SCIEN,20,spanish,5,0,,,,,0,,,,
22,15828,HARMONY PUBLIC,20,spanish,5,16,7,9,4,2,12,7,5,0,0
22,15830,BROOKS ACADEMIE,20,spanish,5,0,,,,,0,,,,
22,15838,COMPASS ROSE PU,20,spanish,5,0,,,,,0,,,,
22,15901,ALAMO HEIGHTS I,20,spanish,5,18,3,15,4,4,6,2,4,1,1
22,15904,HARLANDALE ISD,20,spanish,5,87,46,41,15,1,79,46,33,7,2
22,15905,EDGEWOOD ISD,20,spanish,5,20,12,8,4,1,12,8,4,2,1
22,15907,SAN ANTONIO ISD,20,spanish,5,479,210,269,126,53,428,180,248,126,49
22,15908,SOUTH SAN ANTON,20,spanish,5,31,21,10,5,3,22,16,6,2,1
22,15909,SOMERSET ISD,20,spanish,5,22,9,13,7,1,13,6,7,3,0
22,15910,NORTH EAST ISD,20,spanish,5,410,88,322,206,99,497,101,396,257,134
22,15911,EAST CENTRAL IS,20,spanish,5,72,35,37,12,3,18,13,5,2,0
22,15912,SOUTHWEST ISD,20,spanish,5,26,4,22,10,4,21,6,15,5,2
22,15915,NORTHSIDE ISD,20,spanish,5,138,51,87,40,10,141,59,82,29,6
22,15916,JUDSON ISD,20,spanish,5,21,8,13,5,1,15,7,8,2,0
22,15917,SOUTHSIDE ISD,20,spanish,5,81,31,50,21,13,7,3,4,1,0
22,19901,DEKALB ISD,8,spanish,5,0,,,,,0,,,,
22,19907,TEXARKANA ISD,8,spanish,5,11,7,4,1,0,0,,,,
22,20901,ALVIN ISD,4,spanish,5,11,5,6,3,0,9,6,3,2,0
22,20902,ANGLETON ISD,4,spanish,5,0,,,,,0,,,,
22,20905,BRAZOSPORT ISD,4,spanish,5,8,5,3,1,1,8,5,3,2,0
22,20908,PEARLAND ISD,4,spanish,5,6,2,4,1,0,0,,,,
22,21901,COLLEGE STATION,6,spanish,5,12,4,8,3,1,12,10,2,0,0
22,21902,BRYAN ISD,6,spanish,5,21,9,12,4,1,18,13,5,1,0
22,22901,ALPINE ISD,18,spanish,5,0,,,,,0,,,,
22,25909,EARLY ISD,15,spanish,5,0,,,,,0,,,,
22,26901,CALDWELL ISD,6,spanish,5,0,,,,,0,,,,
22,27904,MARBLE FALLS IS,13,spanish,5,18,7,11,3,1,9,7,2,0,0
22,28902,LOCKHART ISD,13,spanish,5,13,6,7,5,1,13,8,5,2,0
22,29901,CALHOUN COUNTY,3,spanish,5,0,,,,,0,,,,
22,31901,BROWNSVILLE ISD,1,spanish,5,88,29,59,29,12,78,37,41,13,5
22,31903,HARLINGEN CISD,1,spanish,5,11,4,7,5,0,11,4,7,2,1
22,31905,LA FERIA ISD,1,spanish,5,0,,,,,0,,,,
22,31906,LOS FRESNOS CIS,1,spanish,5,8,0,8,3,2,8,2,6,2,0
22,31909,POINT ISABEL IS,1,spanish,5,6,2,4,2,0,6,4,2,0,0
22,31912,SAN BENITO CISD,1,spanish,5,21,9,12,5,4,20,12,8,2,1
22,31914,SANTA ROSA ISD,1,spanish,5,0,,,,,0,,,,
22,35901,DIMMITT ISD,16,spanish,5,9,4,5,1,0,9,5,4,0,0
22,35902,HART ISD,16,spanish,5,0,,,,,0,,,,
22,36902,BARBERS HILL IS,4,spanish,5,0,,,,,0,,,,
22,37904,JACKSONVILLE IS,7,spanish,5,43,23,20,8,3,0,,,,
22,37907,RUSK ISD,7,spanish,5,0,,,,,0,,,,
22,40901,MORTON ISD,17,spanish,5,0,,,,,0,,,,
22,43802,LONE STAR LANGU,10,spanish,5,0,,,,,0,,,,
22,43901,ALLEN ISD,10,spanish,5,12,6,6,2,2,12,7,5,2,0
22,43903,CELINA ISD,10,spanish,5,0,,,,,0,,,,
22,43904,FARMERSVILLE IS,10,spanish,5,0,,,,,0,,,,
22,43905,FRISCO ISD,10,spanish,5,28,10,18,8,3,27,15,12,5,2
22,43907,MCKINNEY ISD,10,spanish,5,36,12,24,6,1,24,12,12,4,1
22,43910,PLANO ISD,10,spanish,5,181,64,117,58,16,171,113,58,15,4
22,43911,PRINCETON ISD,10,spanish,5,0,,,,,0,,,,
22,43912,PROSPER ISD,10,spanish,5,0,,,,,0,,,,
22,43914,WYLIE ISD,10,spanish,5,0,,,,,0,,,,
22,43918,COMMUNITY ISD,10,spanish,5,44,20,24,15,4,0,,,,
22,46901,NEW BRAUNFELS I,13,spanish,5,0,,,,,0,,,,
22,46902,COMAL ISD,20,spanish,5,9,3,6,3,3,7,5,2,1,0
22,47901,COMANCHE ISD,14,spanish,5,0,,,,,0,,,,
22,49901,GAINESVILLE ISD,11,spanish,5,0,,,,,0,,,,
22,50910,COPPERAS COVE I,12,spanish,5,0,,,,,0,,,,
22,53001,CROCKETT COUNTY,15,spanish,5,0,,,,,0,,,,
22,56901,DALHART ISD,16,spanish,5,5,1,4,2,0,5,4,1,0,0
22,57803,UPLIFT EDUCATIO,10,spanish,5,0,,,,,0,,,,
22,57807,LIFE SCHOOL,10,spanish,5,0,,,,,0,,,,
22,57827,NOVA ACADEMY SO,10,spanish,5,0,,,,,0,,,,
22,57835,GOLDEN RULE CHA,10,spanish,5,0,,,,,0,,,,
22,57839,LA ACADEMIA DE,10,spanish,5,0,,,,,0,,,,
22,57841,CITYSCAPE SCHOO,10,spanish,5,0,,,,,0,,,,
22,57848,INTERNATIONAL L,10,spanish,5,37,20,17,6,1,27,18,9,0,0
22,57903,CARROLLTON-FARM,10,spanish,5,184,48,136,70,24,57,49,8,1,0
22,57904,CEDAR HILL ISD,10,spanish,5,0,,,,,0,,,,
22,57905,DALLAS ISD,10,spanish,5,3425,987,2438,1429,629,286,162,124,51,19
22,57906,DESOTO ISD,10,spanish,5,0,,,,,0,,,,
22,57907,DUNCANVILLE ISD,10,spanish,5,55,24,31,12,5,0,,,,
22,57909,GARLAND ISD,10,spanish,5,646,192,454,252,116,79,32,47,18,7
22,57910,GRAND PRAIRIE I,10,spanish,5,376,121,255,140,51,41,23,18,5,1
22,57912,IRVING ISD,10,spanish,5,123,66,57,31,11,118,94,24,8,3
22,57913,LANCASTER ISD,10,spanish,5,0,,,,,0,,,,
22,57914,MESQUITE ISD,10,spanish,5,143,51,92,51,20,90,52,38,15,5
22,57916,RICHARDSON ISD,10,spanish,5,37,21,16,5,3,34,22,12,1,1
22,57922,COPPELL ISD,10,spanish,5,8,4,4,1,1,8,3,5,2,0
22,59901,HEREFORD ISD,16,spanish,5,0,,,,,0,,,,
22,61901,DENTON ISD,11,spanish,5,75,36,39,19,7,32,20,12,6,3
22,61902,LEWISVILLE ISD,11,spanish,5,113,35,78,47,19,102,47,55,23,7
22,61903,PILOT POINT ISD,11,spanish,5,6,1,5,2,0,0,,,,
22,61905,KRUM ISD,11,spanish,5,0,,,,,0,,,,
22,61906,PONDER ISD,11,spanish,5,0,,,,,0,,,,
22,61911,NORTHWEST ISD,11,spanish,5,0,,,,,0,,,,
22,61914,LITTLE ELM ISD,11,spanish,5,10,6,4,2,1,0,,,,
22,62901,CUERO ISD,3,spanish,5,0,,,,,0,,,,
22,68901,ECTOR COUNTY IS,18,spanish,5,111,51,60,35,14,85,49,36,11,1
22,70801,WAXAHACHIE FAIT,10,spanish,5,24,20,4,2,1,14,10,4,2,1
22,70901,AVALON ISD,10,spanish,5,0,,,,,0,,,,
22,70903,ENNIS ISD,10,spanish,5,0,,,,,0,,,,
22,70905,FERRIS ISD,10,spanish,5,0,,,,,0,,,,
22,70908,MIDLOTHIAN ISD,10,spanish,5,0,,,,,0,,,,
22,70911,RED OAK ISD,10,spanish,5,10,5,5,3,1,0,,,,
22,70912,WAXAHACHIE ISD,10,spanish,5,18,8,10,0,0,0,,,,
22,71801,BURNHAM WOOD CH,19,spanish,5,10,1,9,5,2,10,2,8,4,0
22,71806,HARMONY PUBLIC,19,spanish,5,10,0,10,7,2,8,1,7,3,1
22,71807,LA FE PREPARATO,19,spanish,5,14,3,11,7,4,14,0,14,12,6
22,71809,VISTA DEL FUTUR,19,spanish,5,7,3,4,3,1,7,3,4,2,1
22,71901,CLINT ISD,19,spanish,5,37,19,18,10,5,32,18,14,5,0
22,71902,EL PASO ISD,19,spanish,5,438,113,325,173,71,392,140,252,100,16
22,71903,FABENS ISD,19,spanish,5,38,15,23,12,5,32,5,27,9,6
22,71904,SAN ELIZARIO IS,19,spanish,5,42,22,20,7,1,0,,,,
22,71905,YSLETA ISD,19,spanish,5,101,37,64,31,9,66,23,43,14,0
22,71907,CANUTILLO ISD,19,spanish,5,34,11,23,11,9,31,11,20,15,6
22,71908,TORNILLO ISD,19,spanish,5,25,14,11,6,2,0,,,,
22,71909,SOCORRO ISD,19,spanish,5,52,14,38,19,6,46,19,27,5,0
22,72902,DUBLIN ISD,11,spanish,5,0,,,,,0,,,,
22,72903,STEPHENVILLE IS,11,spanish,5,0,,,,,0,,,,
22,75901,FLATONIA ISD,13,spanish,5,0,,,,,0,,,,
22,75902,LA GRANGE ISD,13,spanish,5,0,,,,,0,,,,
22,75906,FAYETTEVILLE IS,13,spanish,5,0,,,,,0,,,,
22,79901,LAMAR CISD,4,spanish,5,21,8,13,6,2,18,10,8,3,1
22,79907,FORT BEND ISD,4,spanish,5,30,10,20,11,4,30,13,17,7,5
22,79910,STAFFORD MSD,4,spanish,5,0,,,,,0,,,,
22,81902,FAIRFIELD ISD,12,spanish,5,0,,,,,0,,,,
22,82903,PEARSALL ISD,20,spanish,5,0,,,,,0,,,,
22,83903,SEMINOLE ISD,17,spanish,5,0,,,,,0,,,,
22,84802,ODYSSEY ACADEMY,4,spanish,5,0,,,,,0,,,,
22,84901,DICKINSON ISD,4,spanish,5,0,,,,,0,,,,
22,84902,GALVESTON ISD,4,spanish,5,22,8,14,9,2,21,12,9,4,1
22,84906,TEXAS CITY ISD,4,spanish,5,6,2,4,1,0,6,5,1,0,0
22,84908,HITCHCOCK ISD,4,spanish,5,0,,,,,0,,,,
22,84909,SANTA FE ISD,4,spanish,5,0,,,,,0,,,,
22,84910,CLEAR CREEK ISD,4,spanish,5,82,41,41,16,5,67,48,19,5,0
22,86901,FREDERICKSBURG,13,spanish,5,0,,,,,0,,,,
22,89905,WAELDER ISD,13,spanish,5,0,,,,,0,,,,
22,91903,DENISON ISD,10,spanish,5,7,2,5,2,1,0,,,,
22,91906,SHERMAN ISD,10,spanish,5,9,5,4,1,1,5,5,0,0,0
22,92901,GLADEWATER ISD,7,spanish,5,0,,,,,0,,,,
22,92902,KILGORE ISD,7,spanish,5,22,5,17,11,3,0,,,,
22,92903,LONGVIEW ISD,7,spanish,5,50,14,36,19,7,5,3,2,0,0
22,92904,PINE TREE ISD,7,spanish,5,0,,,,,0,,,,
22,93904,NAVASOTA ISD,6,spanish,5,0,,,,,0,,,,
22,94901,SEGUIN ISD,20,spanish,5,6,3,3,0,0,6,2,4,2,0
22,94902,SCHERTZ-CIBOLO-,20,spanish,5,13,9,4,3,1,6,4,2,1,0
22,94904,MARION ISD,20,spanish,5,0,,,,,0,,,,
22,95905,PLAINVIEW ISD,17,spanish,5,0,,,,,0,,,,
22,101802,SER-NINOS CHART,4,spanish,5,26,9,17,6,2,26,15,11,2,1
22,101806,RAUL YZAGUIRRE,4,spanish,5,8,1,7,4,1,0,,,,
22,101814,THE VARNETT PUB,4,spanish,5,0,,,,,0,,,,
22,101828,HOUSTON GATEWAY,4,spanish,5,0,,,,,0,,,,
22,101856,DRAW ACADEMY,4,spanish,5,6,1,5,0,0,6,2,4,0,0
22,101859,STEP CHARTER SC,4,spanish,5,0,,,,,0,,,,
22,101902,ALDINE ISD,4,spanish,5,239,112,127,66,17,212,142,70,16,4
22,101903,ALIEF ISD,4,spanish,5,155,74,81,31,10,0,,,,
22,101905,CHANNELVIEW ISD,4,spanish,5,61,18,43,19,8,26,16,10,4,0
22,101906,CROSBY ISD,4,spanish,5,10,2,8,2,0,0,,,,
22,101907,CYPRESS-FAIRBAN,4,spanish,5,18,8,10,4,0,18,12,6,0,0
22,101908,DEER PARK ISD,4,spanish,5,0,,,,,0,,,,
22,101910,GALENA PARK ISD,4,spanish,5,113,42,71,39,17,79,34,45,21,7
22,101911,GOOSE CREEK CIS,4,spanish,5,23,6,17,13,6,23,7,16,9,5
22,101912,HOUSTON ISD,4,spanish,5,838,323,515,250,94,827,401,426,190,82
22,101913,HUMBLE ISD,4,spanish,5,35,16,19,10,4,28,17,11,2,1
22,101914,KATY ISD,4,spanish,5,192,46,146,95,46,174,60,114,49,20
22,101915,KLEIN ISD,4,spanish,5,57,24,33,19,5,52,29,23,6,1
22,101916,LA PORTE ISD,4,spanish,5,0,,,,,0,,,,
22,101917,PASADENA ISD,4,spanish,5,68,26,42,18,4,63,40,23,5,0
22,101919,SPRING ISD,4,spanish,5,92,31,61,31,20,86,48,38,21,16
22,101920,SPRING BRANCH I,4,spanish,5,111,41,70,33,15,62,42,20,4,0
22,101921,TOMBALL ISD,4,spanish,5,27,9,18,13,6,5,3,2,2,1
22,101924,SHELDON ISD,4,spanish,5,8,5,3,2,1,8,5,3,2,0
22,101925,HUFFMAN ISD,4,spanish,5,0,,,,,0,,,,
22,102902,MARSHALL ISD,7,spanish,5,11,6,5,2,1,0,,,,
22,105902,SAN MARCOS CISD,13,spanish,5,27,14,13,7,4,15,10,5,3,0
22,105904,DRIPPING SPRING,13,spanish,5,0,,,,,0,,,,
22,105905,WIMBERLEY ISD,13,spanish,5,0,,,,,0,,,,
22,105906,HAYS CISD,13,spanish,5,18,11,7,2,1,15,12,3,0,0
22,106901,CANADIAN ISD,16,spanish,5,0,,,,,0,,,,
22,108807,IDEA PUBLIC SCH,1,spanish,5,23,8,15,9,3,17,10,7,1,0
22,108808,VANGUARD ACADEM,1,spanish,5,11,1,10,7,5,0,,,,
22,108902,DONNA ISD,1,spanish,5,142,62,80,35,13,32,15,17,3,2
22,108903,EDCOUCH-ELSA IS,1,spanish,5,6,1,5,2,1,5,2,3,1,0
22,108904,EDINBURG CISD,1,spanish,5,50,22,28,14,5,43,23,20,8,3
22,108905,HIDALGO ISD,1,spanish,5,32,5,27,16,8,17,4,13,2,1
22,108906,MCALLEN ISD,1,spanish,5,102,30,72,35,12,44,18,26,9,4
22,108907,MERCEDES ISD,1,spanish,5,11,9,2,0,0,8,6,2,0,0
22,108908,MISSION CISD,1,spanish,5,188,78,110,59,23,26,9,17,5,1
22,108909,PHARR-SAN JUAN-,1,spanish,5,357,127,230,118,43,42,21,21,8,3
22,108910,PROGRESO ISD,1,spanish,5,12,4,8,6,4,0,,,,
22,108911,SHARYLAND ISD,1,spanish,5,26,1,25,16,8,25,5,20,8,3
22,108912,LA JOYA ISD,1,spanish,5,756,287,469,222,82,30,15,15,6,2
22,108913,WESLACO ISD,1,spanish,5,9,2,7,4,1,7,4,3,1,0
22,108915,MONTE ALTO ISD,1,spanish,5,0,,,,,0,,,,
22,108916,VALLEY VIEW ISD,1,spanish,5,19,3,16,8,2,18,7,11,3,0
22,110902,LEVELLAND ISD,17,spanish,5,0,,,,,0,,,,
22,111901,GRANBURY ISD,11,spanish,5,5,0,5,4,2,5,1,4,2,1
22,112901,SULPHUR SPRINGS,8,spanish,5,0,,,,,0,,,,
22,112906,NORTH HOPKINS I,8,spanish,5,0,,,,,0,,,,
22,114901,BIG SPRING ISD,18,spanish,5,0,,,,,0,,,,
22,115901,FT HANCOCK ISD,19,spanish,5,11,5,6,3,1,10,6,4,2,1
22,116903,COMMERCE ISD,10,spanish,5,0,,,,,0,,,,
22,116905,GREENVILLE ISD,10,spanish,5,12,4,8,3,1,0,,,,
22,116908,QUINLAN ISD,10,spanish,5,0,,,,,0,,,,
22,116915,BLAND ISD,10,spanish,5,0,,,,,0,,,,
22,117901,BORGER ISD,16,spanish,5,0,,,,,0,,,,
22,123807,BOB HOPE SCHOOL,5,spanish,5,11,3,8,6,2,10,4,6,3,0
22,123905,NEDERLAND ISD,5,spanish,5,0,,,,,0,,,,
22,123907,PORT ARTHUR ISD,5,spanish,5,17,9,8,4,2,17,11,6,2,2
22,123910,BEAUMONT ISD,5,spanish,5,14,5,9,5,2,14,5,9,6,1
22,123914,HAMSHIRE-FANNET,5,spanish,5,0,,,,,0,,,,
22,126901,ALVARADO ISD,11,spanish,5,0,,,,,0,,,,
22,126902,BURLESON ISD,11,spanish,5,5,0,5,3,1,0,,,,
22,126903,CLEBURNE ISD,11,spanish,5,26,10,16,9,1,19,8,11,4,1
22,126904,GRANDVIEW ISD,11,spanish,5,0,,,,,0,,,,
22,126905,JOSHUA ISD,11,spanish,5,0,,,,,0,,,,
22,126906,KEENE ISD,11,spanish,5,0,,,,,0,,,,
22,126908,VENUS ISD,11,spanish,5,0,,,,,0,,,,
22,127906,STAMFORD ISD,14,spanish,5,0,,,,,0,,,,
22,128902,KENEDY ISD,3,spanish,5,0,,,,,0,,,,
22,129901,CRANDALL ISD,10,spanish,5,0,,,,,0,,,,
22,129902,FORNEY ISD,10,spanish,5,18,4,14,5,2,0,,,,
22,129903,KAUFMAN ISD,10,spanish,5,0,,,,,0,,,,
22,129904,KEMP ISD,10,spanish,5,0,,,,,0,,,,
22,129905,MABANK ISD,10,spanish,5,0,,,,,0,,,,
22,129906,TERRELL ISD,10,spanish,5,0,,,,,0,,,,
22,129910,SCURRY-ROSSER I,10,spanish,5,0,,,,,0,,,,
22,130901,BOERNE ISD,20,spanish,5,13,5,8,5,1,9,3,6,3,0
22,133901,CENTER POINT IS,20,spanish,5,0,,,,,0,,,,
22,139909,PARIS ISD,8,spanish,5,0,,,,,0,,,,
22,140904,LITTLEFIELD ISD,17,spanish,5,0,,,,,0,,,,
22,143902,MOULTON ISD,3,spanish,5,0,,,,,0,,,,
22,144901,GIDDINGS ISD,13,spanish,5,0,,,,,0,,,,
22,145902,CENTERVILLE ISD,6,spanish,5,0,,,,,0,,,,
22,145911,LEON ISD,6,spanish,5,0,,,,,0,,,,
22,146901,CLEVELAND ISD,4,spanish,5,51,37,14,4,2,19,15,4,1,0
22,146902,DAYTON ISD,4,spanish,5,6,2,4,2,0,0,,,,
22,147903,MEXIA ISD,12,spanish,5,0,,,,,0,,,,
22,149902,THREE RIVERS IS,2,spanish,5,0,,,,,0,,,,
22,152901,LUBBOCK ISD,17,spanish,5,46,11,35,19,10,22,5,17,12,7
22,152903,SLATON ISD,17,spanish,5,0,,,,,0,,,,
22,152906,LUBBOCK-COOPER,17,spanish,5,0,,,,,0,,,,
22,152907,FRENSHIP ISD,17,spanish,5,5,1,4,3,2,0,,,,
22,152908,ROOSEVELT ISD,17,spanish,5,0,,,,,0,,,,
22,154901,MADISONVILLE CI,6,spanish,5,0,,,,,0,,,,
22,154903,NORTH ZULCH ISD,6,spanish,5,0,,,,,0,,,,
22,156902,STANTON ISD,18,spanish,5,0,,,,,0,,,,
22,158901,BAY CITY ISD,3,spanish,5,0,,,,,0,,,,
22,158905,PALACIOS ISD,3,spanish,5,0,,,,,0,,,,
22,159901,EAGLE PASS ISD,20,spanish,5,54,19,35,22,12,45,18,27,18,3
22,161807,HARMONY PUBLIC,12,spanish,5,0,,,,,0,,,,
22,161906,LA VEGA ISD,12,spanish,5,0,,,,,0,,,,
22,161909,MCGREGOR ISD,12,spanish,5,0,,,,,0,,,,
22,161912,RIESEL ISD,12,spanish,5,0,,,,,0,,,,
22,161914,WACO ISD,12,spanish,5,7,4,3,2,1,8,4,4,1,0
22,163908,MEDINA VALLEY I,20,spanish,5,0,,,,,0,,,,
22,165901,MIDLAND ISD,18,spanish,5,46,14,32,8,1,45,33,12,4,0
22,165902,GREENWOOD ISD,18,spanish,5,0,,,,,0,,,,
22,170902,CONROE ISD,6,spanish,5,158,68,90,43,18,142,78,64,18,6
22,170903,MONTGOMERY ISD,6,spanish,5,0,,,,,0,,,,
22,170904,WILLIS ISD,6,spanish,5,14,3,11,4,1,13,7,6,1,0
22,170906,MAGNOLIA ISD,6,spanish,5,8,4,4,1,0,10,6,4,0,0
22,170907,SPLENDORA ISD,6,spanish,5,5,1,4,3,1,5,1,4,2,0
22,170908,NEW CANEY ISD,6,spanish,5,69,36,33,15,3,59,33,26,12,3
22,171902,SUNRAY COLLEGIA,16,spanish,5,0,,,,,0,,,,
22,174904,NACOGDOCHES ISD,7,spanish,5,8,4,4,2,0,0,,,,
22,175903,CORSICANA ISD,12,spanish,5,0,,,,,0,,,,
22,177901,ROSCOE COLLEGIA,14,spanish,5,0,,,,,0,,,,
22,178902,BISHOP CISD,2,spanish,5,0,,,,,0,,,,
22,178904,CORPUS CHRISTI,2,spanish,5,21,7,14,6,3,21,10,11,2,0
22,178912,TULOSO-MIDWAY I,2,spanish,5,0,,,,,0,,,,
22,178914,FLOUR BLUFF ISD,2,spanish,5,0,,,,,0,,,,
22,181906,WEST ORANGE-COV,5,spanish,5,0,,,,,0,,,,
22,181907,VIDOR ISD,5,spanish,5,0,,,,,0,,,,
22,182903,MINERAL WELLS I,11,spanish,5,7,1,6,1,1,7,0,7,2,0
22,184903,WEATHERFORD ISD,11,spanish,5,5,2,3,2,1,5,3,2,1,0
22,187907,LIVINGSTON ISD,6,spanish,5,0,,,,,0,,,,
22,188901,AMARILLO ISD,16,spanish,5,107,17,90,48,20,17,12,5,1,0
22,189902,PRESIDIO ISD,18,spanish,5,11,5,6,1,1,11,3,8,1,1
22,191901,CANYON ISD,16,spanish,5,0,,,,,0,,,,
22,192901,REAGAN COUNTY I,18,spanish,5,0,,,,,0,,,,
22,194903,RIVERCREST ISD,8,spanish,5,0,,,,,0,,,,
22,195901,PECOS-BARSTOW-T,18,spanish,5,9,4,5,2,1,7,1,6,1,1
22,199901,ROCKWALL ISD,10,spanish,5,0,,,,,0,,,,
22,199902,ROYSE CITY ISD,10,spanish,5,0,,,,,0,,,,
22,201907,MOUNT ENTERPRIS,7,spanish,5,0,,,,,0,,,,
22,205901,ARANSAS PASS IS,2,spanish,5,0,,,,,0,,,,
22,205902,GREGORY-PORTLAN,2,spanish,5,0,,,,,0,,,,
22,205903,INGLESIDE ISD,2,spanish,5,0,,,,,0,,,,
22,208902,SNYDER ISD,14,spanish,5,0,,,,,0,,,,
22,211902,STRATFORD ISD,16,spanish,5,0,,,,,0,,,,
22,212804,UT TYLER UNIVER,7,spanish,5,0,,,,,0,,,,
22,212905,TYLER ISD,7,spanish,5,63,21,42,23,9,6,4,2,1,0
22,212906,WHITEHOUSE ISD,7,spanish,5,0,,,,,0,,,,
22,212909,CHAPEL HILL ISD,7,spanish,5,13,11,2,0,0,0,,,,
22,213901,GLEN ROSE ISD,11,spanish,5,0,,,,,0,,,,
22,214901,RIO GRANDE CITY,1,spanish,5,10,6,4,2,1,10,9,1,0,0
22,214903,ROMA ISD,1,spanish,5,10,3,7,4,1,8,4,4,3,1
22,220901,ARLINGTON ISD,11,spanish,5,166,72,94,49,19,128,77,51,18,5
22,220902,BIRDVILLE ISD,11,spanish,5,54,21,33,16,4,41,22,19,5,1
22,220904,EVERMAN ISD,11,spanish,5,28,4,24,16,10,6,4,2,1,0
22,220905,FORT WORTH ISD,11,spanish,5,361,177,184,91,31,69,47,22,5,0
22,220906,GRAPEVINE-COLLE,11,spanish,5,8,4,4,3,2,6,5,1,1,0
22,220907,KELLER ISD,11,spanish,5,57,10,47,29,14,5,3,2,0,0
22,220908,MANSFIELD ISD,11,spanish,5,11,3,8,2,0,9,3,6,0,0
22,220910,LAKE WORTH ISD,11,spanish,5,23,11,12,6,2,14,10,4,2,1
22,220912,CROWLEY ISD,11,spanish,5,86,21,65,39,16,7,2,5,3,0
22,220915,AZLE ISD,11,spanish,5,0,,,,,0,,,,
22,220916,HURST-EULESS-BE,11,spanish,5,17,7,10,6,3,16,6,10,4,3
22,220917,CASTLEBERRY ISD,11,spanish,5,25,11,14,3,2,5,4,1,0,0
22,220918,EAGLE MT-SAGINA,11,spanish,5,18,5,13,7,1,5,2,3,1,0
22,220920,WHITE SETTLEMEN,11,spanish,5,34,8,26,10,3,13,4,9,1,0
22,221801,TEXAS COLLEGE P,14,spanish,5,6,1,5,1,1,6,3,3,0,0
22,221901,ABILENE ISD,14,spanish,5,19,8,11,5,0,11,7,4,1,0
22,221912,WYLIE ISD,14,spanish,5,0,,,,,0,,,,
22,223901,BROWNFIELD ISD,17,spanish,5,5,1,4,3,2,5,2,3,2,0
22,225902,MOUNT PLEASANT,8,spanish,5,105,30,75,50,15,0,,,,
22,225907,HARTS BLUFF ISD,8,spanish,5,8,5,3,0,0,0,,,,
22,226801,TEXAS LEADERSHI,15,spanish,5,0,,,,,0,,,,
22,226903,SAN ANGELO ISD,15,spanish,5,0,,,,,0,,,,
22,227803,WAYSIDE SCHOOLS,13,spanish,5,9,1,8,3,0,5,3,2,1,0
22,227816,HARMONY PUBLIC,13,spanish,5,10,4,6,3,1,10,9,1,0,0
22,227820,KIPP TEXAS PUBL,4,spanish,5,25,15,10,6,1,27,19,8,2,0
22,227901,AUSTIN ISD,13,spanish,5,550,219,331,139,37,261,172,89,12,3
22,227904,PFLUGERVILLE IS,13,spanish,5,161,77,84,41,10,38,26,12,5,1
22,227907,MANOR ISD,13,spanish,5,25,12,13,4,2,25,16,9,1,0
22,227910,DEL VALLE ISD,13,spanish,5,251,109,142,70,28,44,30,14,4,1
22,227912,LAGO VISTA ISD,13,spanish,5,0,,,,,0,,,,
22,227913,LAKE TRAVIS ISD,13,spanish,5,17,8,9,2,0,0,,,,
22,228901,GROVETON ISD,6,spanish,5,0,,,,,0,,,,
22,230903,ORE CITY ISD,7,spanish,5,0,,,,,0,,,,
22,230905,HARMONY ISD,7,spanish,5,0,,,,,0,,,,
22,231901,MCCAMEY ISD,18,spanish,5,0,,,,,0,,,,
22,232903,UVALDE CISD,20,spanish,5,17,4,13,4,2,13,7,6,2,0
22,233901,SAN FELIPE-DEL,15,spanish,5,0,,,,,0,,,,
22,234907,WILLS POINT ISD,10,spanish,5,0,,,,,0,,,,
22,235902,VICTORIA ISD,3,spanish,5,16,5,11,7,5,18,5,13,5,4
22,236902,HUNTSVILLE ISD,6,spanish,5,7,3,4,2,0,7,6,1,0,0
22,237902,HEMPSTEAD ISD,4,spanish,5,0,,,,,0,,,,
22,237904,WALLER ISD,4,spanish,5,6,1,5,3,1,6,1,5,1,0
22,237905,ROYAL ISD,4,spanish,5,0,,,,,0,,,,
22,238902,MONAHANS-WICKET,18,spanish,5,0,,,,,0,,,,
22,240901,LAREDO ISD,1,spanish,5,55,22,33,14,8,56,33,23,9,2
22,240903,UNITED ISD,1,spanish,5,33,9,24,20,9,30,12,18,10,4
22,241902,EAST BERNARD IS,3,spanish,5,0,,,,,0,,,,
22,241903,EL CAMPO ISD,3,spanish,5,0,,,,,0,,,,
22,243905,WICHITA FALLS I,9,spanish,5,7,2,5,1,1,7,5,2,0,0
22,245902,LYFORD CISD,1,spanish,5,0,,,,,0,,,,
22,245903,RAYMONDVILLE IS,1,spanish,5,0,,,,,0,,,,
22,246902,FLORENCE ISD,13,spanish,5,0,,,,,0,,,,
22,246904,GEORGETOWN ISD,13,spanish,5,24,13,11,1,1,15,13,2,0,0
22,246906,HUTTO ISD,13,spanish,5,36,12,24,13,4,5,3,2,0,0
22,246907,JARRELL ISD,13,spanish,5,0,,,,,0,,,,
22,246909,ROUND ROCK ISD,13,spanish,5,95,44,51,27,10,51,29,22,6,1
22,246911,TAYLOR ISD,13,spanish,5,0,,,,,0,,,,
22,246912,THRALL ISD,13,spanish,5,0,,,,,0,,,,
22,246913,LEANDER ISD,13,spanish,5,78,30,48,21,5,17,12,5,1,0
22,247901,FLORESVILLE ISD,20,spanish,5,7,5,2,2,0,0,,,,
22,247903,LA VERNIA ISD,20,spanish,5,0,,,,,0,,,,
22,248901,KERMIT ISD,18,spanish,5,0,,,,,0,,,,
22,249903,BRIDGEPORT ISD,11,spanish,5,13,12,1,0,0,0,,,,
22,249905,DECATUR ISD,11,spanish,5,16,8,8,2,1,0,,,,
22,250904,QUITMAN ISD,7,spanish,5,0,,,,,0,,,,
22,251902,PLAINS ISD,17,spanish,5,0,,,,,0,,,,
22,252903,OLNEY ISD,9,spanish,5,0,,,,,0,,,,
22,1902,CAYUGA ISD,7,english,6,51,11,40,29,14,51,10,41,24,8
22,1903,ELKHART ISD,7,english,6,89,25,64,37,21,89,31,58,22,3
22,1904,FRANKSTON ISD,7,english,6,60,14,46,28,15,60,5,55,37,20
22,1906,NECHES ISD,7,english,6,25,7,18,15,7,25,0,25,17,6
22,1907,PALESTINE ISD,7,english,6,206,56,150,86,43,206,44,162,81,33
22,1908,WESTWOOD ISD,7,english,6,96,31,65,39,23,96,52,44,15,4
22,1909,SLOCUM ISD,7,english,6,25,8,17,11,6,25,8,17,7,3
22,2901,ANDREWS ISD,18,english,6,291,69,222,132,70,291,71,220,97,33
22,3801,PINEYWOODS COMM,7,english,6,77,21,56,39,22,77,14,63,39,22
22,3902,HUDSON ISD,7,english,6,203,31,172,121,76,203,16,187,138,75
22,3903,LUFKIN ISD,7,english,6,480,174,306,170,85,481,160,321,162,88
22,3904,HUNTINGTON ISD,7,english,6,120,26,94,49,25,120,17,103,54,20
22,3905,DIBOLL ISD,7,english,6,111,39,72,28,11,111,23,88,35,8
22,3906,ZAVALLA ISD,7,english,6,25,4,21,18,10,25,7,18,8,3
22,3907,CENTRAL ISD,7,english,6,100,19,81,50,28,100,21,79,43,15
22,4901,ARANSAS COUNTY,2,english,6,247,102,145,83,51,247,115,132,60,26
22,5901,ARCHER CITY ISD,9,english,6,28,1,27,23,16,28,0,28,23,13
22,5902,HOLLIDAY ISD,9,english,6,82,17,65,45,29,82,7,75,47,23
22,5904,WINDTHORST ISD,9,english,6,38,5,33,23,11,38,2,36,22,6
22,6902,CLAUDE ISD,16,english,6,24,2,22,10,8,24,2,22,16,10
22,7901,CHARLOTTE ISD,20,english,6,33,15,18,7,2,33,16,17,5,0
22,7902,JOURDANTON ISD,20,english,6,125,17,108,73,40,125,18,107,57,19
22,7904,LYTLE ISD,20,english,6,128,51,77,34,15,128,52,76,25,9
22,7905,PLEASANTON ISD,20,english,6,236,67,169,96,49,236,61,175,87,22
22,7906,POTEET ISD,20,english,6,133,51,82,36,8,132,52,80,25,3
22,8901,BELLVILLE ISD,6,english,6,190,66,124,77,41,190,63,127,58,19
22,8902,SEALY ISD,6,english,6,211,68,143,68,29,212,58,154,59,14
22,8903,BRAZOS ISD,6,english,6,65,19,46,28,17,65,12,53,26,12
22,9901,MULESHOE ISD,17,english,6,84,44,40,18,4,84,37,47,15,4
22,10901,MEDINA ISD,20,english,6,11,3,8,4,3,11,1,10,6,0
22,10902,BANDERA ISD,20,english,6,176,63,113,76,37,161,72,89,26,4
22,11901,BASTROP ISD,13,english,6,855,405,450,222,101,856,346,510,205,73
22,11902,ELGIN ISD,13,english,6,358,156,202,100,42,358,178,180,58,14
22,11904,SMITHVILLE ISD,13,english,6,113,35,78,55,34,112,34,78,31,10
22,11905,MCDADE ISD,13,english,6,20,5,15,10,7,20,3,17,12,5
22,12901,SEYMOUR ISD,9,english,6,48,6,42,26,13,48,5,43,32,16
22,13801,ST MARY'S ACADE,2,english,6,24,1,23,15,9,24,7,17,4,0
22,13901,BEEVILLE ISD,2,english,6,203,70,133,77,31,182,63,119,28,0
22,13902,PAWNEE ISD,2,english,6,9,1,8,5,3,9,1,8,3,1
22,13903,PETTUS ISD,2,english,6,28,9,19,11,7,28,10,18,7,1
22,13905,SKIDMORE-TYNAN,2,english,6,54,5,49,32,19,55,9,46,26,7
22,14803,PRIORITY CHARTE,12,english,6,58,15,43,30,13,59,20,39,17,2
22,14804,ORENDA CHARTER,12,english,6,171,15,156,124,78,171,25,146,89,30
22,14901,ACADEMY ISD,12,english,6,126,22,104,69,47,126,13,113,74,37
22,14902,BARTLETT ISD,13,english,6,29,10,19,10,5,29,15,14,4,1
22,14903,BELTON ISD,12,english,6,968,326,642,383,208,969,297,672,321,98
22,14905,HOLLAND ISD,12,english,6,43,8,35,22,14,43,3,40,31,12
22,14906,KILLEEN ISD,12,english,6,2844,1081,1763,869,377,2848,925,1923,763,246
22,14907,ROGERS ISD,12,english,6,74,22,52,33,18,74,20,54,22,2
22,14908,SALADO ISD,12,english,6,208,51,157,96,52,208,54,154,90,35
22,14909,TEMPLE ISD,12,english,6,584,256,328,149,71,584,187,397,172,67
22,14910,TROY ISD,12,english,6,124,29,95,54,27,110,25,85,38,6
22,15802,GEORGE GERVIN A,20,english,6,32,21,11,5,2,33,20,13,4,1
22,15806,LEGACY TRADITIO,20,english,6,25,13,12,6,3,25,14,11,3,1
22,15807,SOUTHWEST PREPA,20,english,6,58,34,24,7,2,58,36,22,3,1
22,15808,INSPIRE ACADEMI,20,english,6,46,18,28,15,9,45,21,24,9,3
22,15809,BEXAR COUNTY AC,20,english,6,15,12,3,2,1,15,10,5,0,0
22,15815,HERITAGE ACADEM,20,english,6,82,32,50,27,12,82,23,59,22,4
22,15822,JUBILEE ACADEMI,20,english,6,582,299,283,142,74,582,309,273,89,29
22,15825,LIGHTHOUSE PUBL,20,english,6,32,24,8,5,3,32,22,10,1,0
22,15827,SCHOOL OF SCIEN,20,english,6,398,100,298,167,88,395,75,320,177,66
22,15828,HARMONY PUBLIC,20,english,6,456,170,286,171,86,456,138,318,150,48
22,15830,BROOKS ACADEMIE,20,english,6,276,104,172,94,44,274,151,123,34,6
22,15831,SCHOOL OF SCIEN,20,english,6,482,99,383,261,145,481,74,407,247,115
22,15834,BASIS TEXAS,20,english,6,291,9,282,237,160,278,7,271,238,142
22,15835,GREAT HEARTS TE,20,english,6,796,126,670,436,247,795,120,675,379,139
22,15836,ELEANOR KOLITZ,20,english,6,48,2,46,37,20,48,2,46,31,9
22,15838,COMPASS ROSE PU,20,english,6,201,101,100,46,18,203,112,91,25,7
22,15840,SAN ANTONIO PRE,20,english,6,42,23,19,5,1,42,20,22,4,0
22,15901,ALAMO HEIGHTS I,20,english,6,357,56,301,233,141,356,43,313,228,93
22,15904,HARLANDALE ISD,20,english,6,863,330,533,214,90,862,308,554,162,25
22,15905,EDGEWOOD ISD,20,english,6,575,294,281,120,50,573,324,249,76,28
22,15906,RANDOLPH FIELD,20,english,6,121,12,109,77,47,118,8,110,74,16
22,15907,SAN ANTONIO ISD,20,english,6,2913,1481,1432,701,279,2904,1552,1352,404,107
22,15908,SOUTH SAN ANTON,20,english,6,560,336,224,94,30,560,324,236,77,23
22,15909,SOMERSET ISD,20,english,6,282,82,200,120,66,282,69,213,112,40
22,15910,NORTH EAST ISD,20,english,6,4197,1070,3127,2028,1175,4102,990,3112,1649,714
22,15911,EAST CENTRAL IS,20,english,6,742,325,417,188,67,740,284,456,169,33
22,15912,SOUTHWEST ISD,20,english,6,975,383,592,299,130,976,391,585,212,54
22,15913,LACKLAND ISD,20,english,6,55,16,39,24,10,55,10,45,23,8
22,15914,FT SAM HOUSTON,20,english,6,124,30,94,62,35,124,33,91,36,3
22,15915,NORTHSIDE ISD,20,english,6,7265,2299,4966,2895,1484,7264,2434,4830,2068,640
22,15916,JUDSON ISD,20,english,6,1546,621,925,484,227,1544,634,910,304,89
22,15917,SOUTHSIDE ISD,20,english,6,408,191,217,116,42,407,146,261,116,41
22,16901,JOHNSON CITY IS,13,english,6,60,16,44,26,13,60,18,42,19,4
22,16902,BLANCO ISD,13,english,6,69,10,59,35,20,69,7,62,46,23
22,17901,BORDEN COUNTY I,17,english,6,15,6,9,6,3,15,2,13,8,2
22,18901,CLIFTON ISD,12,english,6,76,30,46,22,13,76,25,51,16,6
22,18902,MERIDIAN ISD,12,english,6,24,8,16,4,0,26,13,13,1,0
22,18903,MORGAN ISD,12,english,6,7,2,5,3,1,7,2,5,3,0
22,18904,VALLEY MILLS IS,12,english,6,46,13,33,21,8,46,8,38,21,6
22,18905,WALNUT SPRINGS,12,english,6,11,6,5,3,2,11,5,6,1,0
22,18906,IREDELL ISD,12,english,6,10,3,7,2,1,10,2,8,3,1
22,18907,KOPPERL ISD,12,english,6,11,5,6,5,3,11,5,6,4,0
22,18908,CRANFILLS GAP I,12,english,6,8,2,6,3,1,8,2,6,3,1
22,19901,DEKALB ISD,8,english,6,51,19,32,21,9,51,8,43,14,4
22,19902,HOOKS ISD,8,english,6,76,8,68,39,21,76,19,57,24,8
22,19903,MAUD ISD,8,english,6,32,1,31,20,15,32,1,31,21,9
22,19905,NEW BOSTON ISD,8,english,6,97,27,70,38,15,96,31,65,29,6
22,19906,REDWATER ISD,8,english,6,89,17,72,46,28,89,6,83,50,21
22,19907,TEXARKANA ISD,8,english,6,461,166,295,178,93,399,132,267,75,10
22,19908,LIBERTY-EYLAU I,8,english,6,118,59,59,25,15,118,42,76,25,4
22,19909,SIMMS ISD,8,english,6,38,9,29,14,8,38,5,33,11,2
22,19910,MALTA ISD,8,english,6,6,0,6,2,1,6,0,6,6,2
22,19911,RED LICK ISD,8,english,6,58,7,51,38,26,58,3,55,27,7
22,19912,PLEASANT GROVE,8,english,6,174,21,153,112,72,174,17,157,98,39
22,19913,HUBBARD ISD,8,english,6,8,1,7,6,4,8,0,8,5,1
22,19914,LEARY ISD,8,english,6,7,1,6,3,2,7,3,4,1,1
22,20901,ALVIN ISD,4,english,6,2141,602,1539,949,516,2152,541,1611,902,397
22,20902,ANGLETON ISD,4,english,6,499,103,396,244,132,498,103,395,210,56
22,20904,DANBURY ISD,4,english,6,54,14,40,20,10,52,13,39,19,7
22,20905,BRAZOSPORT ISD,4,english,6,873,270,603,379,205,874,202,672,365,145
22,20906,SWEENY ISD,4,english,6,145,38,107,73,29,122,31,91,39,5
22,20907,COLUMBIA-BRAZOR,4,english,6,228,86,142,88,45,228,60,168,87,24
22,20908,PEARLAND ISD,4,english,6,1640,230,1410,1084,724,1639,174,1465,1088,639
22,20910,DAMON ISD,4,english,6,12,5,7,2,0,12,4,8,4,1
22,21803,BRAZOS SCHOOL F,6,english,6,22,7,15,8,6,22,5,17,9,5
22,21805,ARROW ACADEMY,6,english,6,57,10,47,32,19,57,9,48,26,4
22,21901,COLLEGE STATION,6,english,6,1024,211,813,541,320,1042,138,904,630,375
22,21902,BRYAN ISD,6,english,6,1081,467,614,302,139,1078,309,769,373,156
22,22004,TERLINGUA CSD,18,english,6,6,4,2,1,0,6,4,2,0,0
22,22901,ALPINE ISD,18,english,6,72,14,58,34,21,72,16,56,25,7
22,22902,MARATHON ISD,18,english,6,0,,,,,0,,,,
22,22903,SAN VICENTE ISD,18,english,6,0,,,,,0,,,,
22,23902,SILVERTON ISD,16,english,6,9,1,8,6,4,9,1,8,7,4
22,24901,BROOKS COUNTY I,1,english,6,92,38,54,21,7,92,43,49,15,2
22,25901,BANGS ISD,15,english,6,62,17,45,31,19,62,16,46,15,2
22,25902,BROWNWOOD ISD,15,english,6,239,69,170,92,51,239,71,168,77,26
22,25904,BLANKET ISD,15,english,6,11,6,5,3,3,11,6,5,1,0
22,25905,MAY ISD,15,english,6,26,1,25,18,7,26,5,21,12,2
22,25906,ZEPHYR ISD,15,english,6,18,4,14,9,5,18,4,14,5,1
22,25908,BROOKESMITH ISD,15,english,6,15,4,11,7,2,15,6,9,6,2
22,25909,EARLY ISD,15,english,6,92,10,82,54,23,92,7,85,50,14
22,26901,CALDWELL ISD,6,english,6,133,30,103,72,39,133,22,111,66,41
22,26902,SOMERVILLE ISD,6,english,6,40,14,26,15,7,40,7,33,18,7
22,26903,SNOOK ISD,6,english,6,44,13,31,17,10,44,11,33,15,8
22,27903,BURNET CISD,13,english,6,214,94,120,73,38,214,56,158,68,16
22,27904,MARBLE FALLS IS,13,english,6,334,122,212,115,57,334,111,223,80,20
22,28902,LOCKHART ISD,13,english,6,426,191,235,109,44,304,144,160,35,4
22,28903,LULING ISD,13,english,6,96,45,51,30,13,96,25,71,27,9
22,28906,PRAIRIE LEA ISD,13,english,6,14,6,8,3,1,14,10,4,0,0
22,29901,CALHOUN COUNTY,3,english,6,268,107,161,85,46,268,81,187,81,25
22,30901,CROSS PLAINS IS,14,english,6,28,2,26,15,9,28,1,27,20,9
22,30902,CLYDE CISD,14,english,6,117,29,88,50,27,117,25,92,36,11
22,30903,BAIRD ISD,14,english,6,16,9,7,6,4,16,4,12,3,2
22,30906,EULA ISD,14,english,6,38,5,33,18,13,38,4,34,18,7
22,31901,BROWNSVILLE ISD,1,english,6,2546,909,1637,921,465,2546,839,1707,694,214
22,31903,HARLINGEN CISD,1,english,6,1255,440,815,418,224,1254,420,834,330,84
22,31905,LA FERIA ISD,1,english,6,206,45,161,83,50,205,60,145,72,33
22,31906,LOS FRESNOS CIS,1,english,6,770,219,551,336,178,771,195,576,305,122
22,31909,POINT ISABEL IS,1,english,6,142,53,89,46,18,142,71,71,15,2
22,31911,RIO HONDO ISD,1,english,6,128,50,78,37,17,128,58,70,13,2
22,31912,SAN BENITO CISD,1,english,6,552,260,292,119,47,663,324,339,107,22
22,31913,SANTA MARIA ISD,1,english,6,28,11,17,6,4,28,19,9,2,0
22,31914,SANTA ROSA ISD,1,english,6,66,25,41,27,15,66,17,49,15,1
22,31916,SOUTH TEXAS ISD,1,english,6,78,5,73,57,34,78,18,60,36,12
22,32902,PITTSBURG ISD,8,english,6,175,11,164,109,52,175,3,172,110,43
22,33901,GROOM ISD,16,english,6,6,1,5,2,2,6,0,6,2,0
22,33902,PANHANDLE ISD,16,english,6,46,8,38,25,16,46,2,44,39,19
22,33904,WHITE DEER ISD,16,english,6,32,5,27,17,9,32,11,21,7,1
22,34901,ATLANTA ISD,8,english,6,122,45,77,45,22,123,39,84,30,8
22,34902,AVINGER ISD,8,english,6,9,1,8,4,1,9,1,8,5,1
22,34903,HUGHES SPRINGS,8,english,6,95,14,81,48,28,95,23,72,33,13
22,34905,LINDEN-KILDARE,8,english,6,41,9,32,16,6,41,12,29,10,1
22,34906,MCLEOD ISD,8,english,6,38,10,28,12,6,38,11,27,10,2
22,34907,QUEEN CITY ISD,8,english,6,66,20,46,31,11,65,11,54,21,4
22,34909,BLOOMBURG ISD,8,english,6,19,1,18,11,7,19,3,16,7,4
22,35901,DIMMITT ISD,16,english,6,87,35,52,24,10,87,36,51,14,4
22,35902,HART ISD,16,english,6,18,2,16,7,1,18,2,16,9,1
22,35903,NAZARETH ISD,16,english,6,16,0,16,13,10,16,0,16,13,7
22,36901,ANAHUAC ISD,4,english,6,94,26,68,42,19,94,20,74,41,11
22,36902,BARBERS HILL IS,4,english,6,570,87,483,356,219,562,40,522,379,218
22,36903,EAST CHAMBERS I,5,english,6,102,36,66,33,14,102,26,76,23,5
22,37901,ALTO ISD,7,english,6,45,21,24,10,6,45,7,38,14,5
22,37904,JACKSONVILLE IS,7,english,6,325,118,207,101,49,325,128,197,88,30
22,37907,RUSK ISD,7,english,6,151,37,114,53,27,151,36,115,38,14
22,37908,NEW SUMMERFIELD,7,english,6,40,13,27,11,6,40,18,22,10,3
22,37909,WELLS ISD,7,english,6,15,3,12,6,2,15,0,15,5,0
22,38901,CHILDRESS ISD,16,english,6,91,28,63,41,20,91,25,66,30,13
22,39902,HENRIETTA ISD,9,english,6,69,17,52,28,13,69,10,59,27,8
22,39903,PETROLIA CISD,9,english,6,36,8,28,15,8,36,9,27,12,6
22,39904,BELLEVUE ISD,9,english,6,10,0,10,6,1,10,1,9,5,2
22,39905,MIDWAY ISD,9,english,6,8,2,6,4,1,8,1,7,2,1
22,40901,MORTON ISD,17,english,6,30,15,15,4,4,30,18,12,1,1
22,40902,WHITEFACE CISD,17,english,6,26,7,19,13,6,26,7,19,4,1
22,41901,BRONTE ISD,15,english,6,15,3,12,10,7,15,1,14,10,3
22,41902,ROBERT LEE ISD,15,english,6,16,5,11,7,2,16,5,11,6,2
22,42901,COLEMAN ISD,15,english,6,56,11,45,26,11,56,20,36,14,4
22,42903,SANTA ANNA ISD,15,english,6,17,5,12,7,5,17,4,13,3,1
22,42905,PANTHER CREEK C,15,english,6,8,3,5,2,1,8,1,7,1,0
22,43801,IMAGINE INTERNA,10,english,6,151,9,142,113,68,152,5,147,115,59
22,43901,ALLEN ISD,10,english,6,1604,204,1400,1043,684,1603,133,1470,1139,699
22,43902,ANNA ISD,10,english,6,352,120,232,116,56,353,99,254,123,46
22,43903,CELINA ISD,10,english,6,273,30,243,186,106,259,30,229,135,51
22,43904,FARMERSVILLE IS,10,english,6,168,35,133,90,46,168,71,97,25,3
22,43905,FRISCO ISD,10,english,6,5173,570,4603,3519,2291,5000,497,4503,3321,1976
22,43907,MCKINNEY ISD,10,english,6,1725,373,1352,862,494,1657,226,1431,989,477
22,43908,MELISSA ISD,10,english,6,353,35,318,215,123,264,25,239,115,30
22,43910,PLANO ISD,10,english,6,3600,751,2849,2063,1335,3380,639,2741,1747,869
22,43911,PRINCETON ISD,10,english,6,509,142,367,214,116,509,86,423,246,108
22,43912,PROSPER ISD,10,english,6,1695,235,1460,1022,563,1678,172,1506,960,441
22,43914,WYLIE ISD,10,english,6,1400,226,1174,849,542,1399,105,1294,929,493
22,43917,BLUE RIDGE ISD,10,english,6,63,15,48,33,20,63,15,48,20,12
22,43918,COMMUNITY ISD,10,english,6,259,90,169,81,40,259,107,152,47,12
22,43919,LOVEJOY ISD,10,english,6,332,15,317,253,159,325,2,323,297,195
22,44902,WELLINGTON ISD,16,english,6,43,10,33,21,12,43,8,35,20,8
22,45902,COLUMBUS ISD,3,english,6,100,24,76,47,17,100,31,69,29,6
22,45903,RICE CISD,3,english,6,80,33,47,23,9,80,34,46,18,8
22,45905,WEIMAR ISD,3,english,6,58,13,45,27,17,58,5,53,31,9
22,46802,TRINITY CHARTER,20,english,6,28,20,8,4,2,28,18,10,3,0
22,46901,NEW BRAUNFELS I,13,english,6,733,194,539,320,164,733,120,613,372,123
22,46902,COMAL ISD,20,english,6,2107,367,1740,1243,725,2106,306,1800,1163,528
22,47901,COMANCHE ISD,14,english,6,84,19,65,42,28,84,15,69,43,23
22,47902,DE LEON ISD,14,english,6,51,11,40,25,10,51,7,44,17,3
22,47903,GUSTINE ISD,14,english,6,13,8,5,2,2,13,5,8,3,1
22,47905,SIDNEY ISD,14,english,6,13,2,11,4,1,13,5,8,3,1
22,48901,EDEN CISD,15,english,6,15,8,7,2,1,15,8,7,4,1
22,48903,PAINT ROCK ISD,15,english,6,17,7,10,3,1,18,7,11,4,1
22,49901,GAINESVILLE ISD,11,english,6,212,87,125,62,28,211,61,150,67,22
22,49902,MUENSTER ISD,11,english,6,37,10,27,21,10,37,6,31,24,8
22,49903,VALLEY VIEW ISD,11,english,6,69,27,42,17,8,69,30,39,14,4
22,49905,CALLISBURG ISD,11,english,6,92,19,73,46,23,92,6,86,53,21
22,49906,ERA ISD,11,english,6,37,9,28,15,7,37,7,30,13,4
22,49907,LINDSAY ISD,11,english,6,39,4,35,22,17,39,1,38,27,13
22,49908,WALNUT BEND ISD,11,english,6,5,2,3,0,0,5,1,4,0,0
22,49909,SIVELLS BEND IS,11,english,6,9,1,8,2,1,9,1,8,3,1
22,50901,EVANT ISD,12,english,6,13,2,11,7,1,13,6,7,3,1
22,50902,GATESVILLE ISD,12,english,6,200,55,145,90,51,200,37,163,98,36
22,50904,OGLESBY ISD,12,english,6,9,2,7,4,2,9,2,7,4,0
22,50909,JONESBORO ISD,12,english,6,21,5,16,8,3,21,9,12,5,0
22,50910,COPPERAS COVE I,12,english,6,598,201,397,209,109,598,125,473,259,87
22,51901,PADUCAH ISD,17,english,6,12,5,7,3,2,12,3,9,3,2
22,52901,CRANE ISD,15,english,6,81,42,39,26,8,81,42,39,12,4
22,53001,CROCKETT COUNTY,15,english,6,55,18,37,19,11,55,16,39,18,11
22,54901,CROSBYTON CISD,17,english,6,18,10,8,5,1,18,9,9,3,1
22,54902,LORENZO ISD,17,english,6,17,10,7,2,2,17,6,11,1,1
22,54903,RALLS ISD,17,english,6,32,13,19,7,3,32,13,19,8,3
22,55901,CULBERSON COUNT,18,english,6,20,11,9,1,1,20,13,7,0,0
22,56901,DALHART ISD,16,english,6,117,46,71,40,19,117,39,78,38,14
22,56902,TEXLINE ISD,16,english,6,19,8,11,7,4,19,4,15,12,7
22,57802,PEGASUS SCHOOL,10,english,6,56,32,24,11,6,56,37,19,5,0
22,57803,UPLIFT EDUCATIO,10,english,6,1884,705,1179,639,326,1886,680,1206,542,207
22,57806,ADVANTAGE ACADE,10,english,6,106,53,53,22,6,106,57,49,6,1
22,57807,LIFE SCHOOL,10,english,6,436,132,304,159,81,436,127,309,107,33
22,57808,UNIVERSAL ACADE,10,english,6,141,22,119,91,64,141,31,110,71,43
22,57810,ACADEMY OF DALL,10,english,6,22,11,11,6,1,22,12,10,1,0
22,57813,TRINITY BASIN P,10,english,6,406,172,234,112,49,406,130,276,116,33
22,57814,ACADEMY FOR ACA,10,english,6,6,4,2,0,0,5,3,2,0,0
22,57816,A W BROWN LEADE,10,english,6,58,18,40,19,9,58,24,34,11,4
22,57819,JEAN MASSIEU AC,10,english,6,13,8,5,4,1,13,4,9,4,0
22,57827,NOVA ACADEMY SO,10,english,6,61,11,50,26,8,61,16,45,19,7
22,57829,A+ ACADEMY,10,english,6,146,65,81,32,15,146,59,87,20,6
22,57830,INSPIRED VISION,10,english,6,100,34,66,35,10,100,47,53,13,3
22,57831,GATEWAY CHARTER,10,english,6,26,4,22,10,2,26,9,17,5,0
22,57833,EDUCATION CENTE,10,english,6,31,15,16,9,4,31,14,17,7,3
22,57835,GOLDEN RULE CHA,10,english,6,100,35,65,41,18,100,35,65,19,9
22,57836,ST ANTHONY SCHO,10,english,6,35,3,32,17,8,35,4,31,13,2
22,57839,LA ACADEMIA DE,10,english,6,100,40,60,23,8,100,37,63,9,0
22,57841,CITYSCAPE SCHOO,10,english,6,82,32,50,21,10,82,38,44,9,1
22,57844,MANARA ACADEMY,10,english,6,50,20,30,16,6,50,21,29,14,4
22,57845,UME PREPARATORY,10,english,6,112,12,100,76,46,110,15,95,56,22
22,57846,LEGACY PREPARAT,10,english,6,154,67,87,51,27,154,78,76,27,3
22,57847,VILLAGE TECH SC,10,english,6,101,46,55,30,11,101,44,57,18,4
22,57848,INTERNATIONAL L,10,english,6,1917,838,1079,555,242,1911,822,1089,398,120
22,57850,PIONEER TECHNOL,10,english,6,189,36,153,96,63,189,38,151,65,12
22,57903,CARROLLTON-FARM,10,english,6,1636,667,969,513,265,1643,536,1107,484,170
22,57904,CEDAR HILL ISD,10,english,6,470,218,252,123,52,474,247,227,67,18
22,57905,DALLAS ISD,10,english,6,9334,3664,5670,3103,1490,9315,3133,6182,2922,990
22,57906,DESOTO ISD,10,english,6,537,242,295,147,49,538,299,239,60,15
22,57907,DUNCANVILLE ISD,10,english,6,803,294,509,290,133,803,233,570,273,102
22,57909,GARLAND ISD,10,english,6,3734,1244,2490,1407,719,3483,1257,2226,847,223
22,57910,GRAND PRAIRIE I,10,english,6,1802,680,1122,609,295,1796,560,1236,559,173
22,57911,HIGHLAND PARK I,10,english,6,511,30,481,355,211,515,15,500,402,221
22,57912,IRVING ISD,10,english,6,2194,1039,1155,534,225,1929,863,1066,306,49
22,57913,LANCASTER ISD,10,english,6,490,213,277,136,66,490,188,302,125,31
22,57914,MESQUITE ISD,10,english,6,2797,1100,1697,855,383,2795,702,2093,1064,372
22,57916,RICHARDSON ISD,10,english,6,2688,769,1919,1284,755,2687,617,2070,1288,678
22,57919,SUNNYVALE ISD,10,english,6,180,27,153,111,64,180,27,153,105,43
22,57922,COPPELL ISD,10,english,6,1023,107,916,702,475,485,52,433,277,114
22,58902,DAWSON ISD,17,english,6,11,3,8,4,2,11,5,6,1,0
22,58905,KLONDIKE ISD,17,english,6,23,1,22,19,14,23,0,23,20,9
22,58906,LAMESA ISD,17,english,6,111,60,51,24,8,112,63,49,14,6
22,58909,SANDS CISD,17,english,6,26,4,22,12,3,26,5,21,11,4
22,59901,HEREFORD ISD,16,english,6,284,131,153,70,22,284,142,142,33,2
22,59902,WALCOTT ISD,16,english,6,17,4,13,6,2,17,1,16,9,2
22,60902,COOPER ISD,8,english,6,61,28,33,20,15,62,29,33,18,4
22,60914,FANNINDEL ISD,8,english,6,7,5,2,1,0,7,5,2,1,1
22,61802,NORTH TEXAS COL,11,english,6,53,19,34,15,7,53,18,35,15,6
22,61804,LEADERSHIP PREP,10,english,6,123,25,98,59,32,123,23,100,46,22
22,61805,TRIVIUM ACADEMY,11,english,6,53,6,47,34,18,53,7,46,32,15
22,61901,DENTON ISD,11,english,6,2200,682,1518,890,479,2198,712,1486,665,275
22,61902,LEWISVILLE ISD,11,english,6,3505,793,2712,1905,1238,3505,753,2752,1717,831
22,61903,PILOT POINT ISD,11,english,6,104,47,57,41,19,104,41,63,21,6
22,61905,KRUM ISD,11,english,6,172,63,109,62,28,172,44,128,65,23
22,61906,PONDER ISD,11,english,6,122,38,84,40,10,122,9,113,59,17
22,61907,AUBREY ISD,11,english,6,252,66,186,98,41,251,48,203,137,60
22,61908,SANGER ISD,11,english,6,197,37,160,108,57,197,28,169,103,36
22,61910,ARGYLE ISD,11,english,6,356,49,307,206,121,310,11,299,236,133
22,61911,NORTHWEST ISD,11,english,6,2154,494,1660,1049,529,2143,344,1799,1115,502
22,61912,LAKE DALLAS ISD,11,english,6,309,111,198,97,46,308,68,240,118,42
22,61914,LITTLE ELM ISD,11,english,6,642,246,396,205,111,591,223,368,122,27
22,62901,CUERO ISD,3,english,6,156,51,105,64,41,156,44,112,52,12
22,62902,NORDHEIM ISD,3,english,6,11,3,8,7,4,11,1,10,2,2
22,62903,YOAKUM ISD,3,english,6,110,43,67,34,22,110,30,80,32,16
22,62904,YORKTOWN ISD,3,english,6,45,14,31,10,6,45,13,32,10,4
22,62905,WESTHOFF ISD,3,english,6,7,1,6,5,4,7,1,6,3,1
22,62906,MEYERSVILLE ISD,3,english,6,14,1,13,9,6,14,0,14,9,6
22,63903,SPUR ISD,17,english,6,16,3,13,12,5,16,2,14,4,2
22,63906,PATTON SPRINGS,17,english,6,0,,,,,0,,,,
22,64903,CARRIZO SPRINGS,20,english,6,119,51,68,44,23,119,55,64,31,13
22,65901,CLARENDON ISD,16,english,6,29,6,23,17,11,29,4,25,18,7
22,65902,HEDLEY ISD,16,english,6,10,0,10,5,3,10,0,10,6,0
22,66005,RAMIREZ CSD,2,english,6,8,3,5,3,3,8,4,4,1,1
22,66901,BENAVIDES ISD,2,english,6,11,4,7,4,3,11,4,7,2,1
22,66902,SAN DIEGO ISD,2,english,6,105,39,66,33,9,104,30,74,32,11
22,66903,FREER ISD,2,english,6,52,20,32,10,1,51,14,37,15,3
22,67902,CISCO ISD,14,english,6,59,10,49,31,21,59,8,51,27,11
22,67903,EASTLAND ISD,14,english,6,89,18,71,48,25,89,16,73,29,8
22,67904,GORMAN ISD,14,english,6,19,6,13,5,3,19,5,14,6,2
22,67907,RANGER ISD,14,english,6,30,14,16,4,1,30,17,13,3,0
22,67908,RISING STAR ISD,14,english,6,14,4,10,3,1,14,7,7,1,0
22,68802,COMPASS ACADEMY,18,english,6,117,21,96,58,30,117,28,89,37,12
22,68803,UTPB STEM ACADE,18,english,6,64,9,55,35,21,64,17,47,24,16
22,68901,ECTOR COUNTY IS,18,english,6,2203,977,1226,638,270,2198,783,1415,683,254
22,69901,ROCKSPRINGS ISD,15,english,6,23,11,12,7,3,23,13,10,3,1
22,69902,NUECES CANYON C,15,english,6,12,3,9,5,4,12,3,9,4,0
22,70801,WAXAHACHIE FAIT,10,english,6,233,148,85,38,14,232,125,107,28,8
22,70901,AVALON ISD,10,english,6,24,12,12,6,5,24,12,12,5,1
22,70903,ENNIS ISD,10,english,6,433,108,325,194,112,433,100,333,184,59
22,70905,FERRIS ISD,10,english,6,184,77,107,62,28,184,53,131,54,7
22,70907,ITALY ISD,10,english,6,55,18,37,23,9,55,8,47,33,14
22,70908,MIDLOTHIAN ISD,10,english,6,823,225,598,333,155,823,154,669,374,148
22,70909,MILFORD ISD,10,english,6,25,9,16,5,3,25,14,11,1,0
22,70910,PALMER ISD,10,english,6,98,10,88,64,39,98,8,90,76,30
22,70911,RED OAK ISD,10,english,6,478,162,316,166,74,478,154,324,140,34
22,70912,WAXAHACHIE ISD,10,english,6,736,193,543,345,175,736,171,565,293,100
22,70915,MAYPEARL ISD,10,english,6,77,24,53,32,12,77,17,60,32,5
22,71801,BURNHAM WOOD CH,19,english,6,119,29,90,65,39,119,18,101,63,30
22,71806,HARMONY PUBLIC,19,english,6,430,112,318,189,96,429,100,329,170,72
22,71809,VISTA DEL FUTUR,19,english,6,34,14,20,15,8,34,14,20,8,2
22,71810,EL PASO LEADERS,19,english,6,76,42,34,9,4,76,33,43,11,1
22,71901,CLINT ISD,19,english,6,722,335,387,183,77,722,281,441,160,31
22,71902,EL PASO ISD,19,english,6,3264,1199,2065,1130,566,3256,1167,2089,923,323
22,71903,FABENS ISD,19,english,6,150,79,71,28,9,150,54,96,33,5
22,71904,SAN ELIZARIO IS,19,english,6,211,89,122,78,27,214,72,142,51,14
22,71905,YSLETA ISD,19,english,6,2595,775,1820,1069,535,2594,610,1984,1023,410
22,71906,ANTHONY ISD,19,english,6,60,21,39,23,12,59,15,44,15,4
22,71907,CANUTILLO ISD,19,english,6,430,122,308,192,94,173,77,96,22,4
22,71908,TORNILLO ISD,19,english,6,48,20,28,11,1,48,29,19,3,0
22,71909,SOCORRO ISD,19,english,6,3257,1069,2188,1146,524,3260,902,2358,981,270
22,72901,THREE WAY ISD,11,english,6,14,4,10,1,0,14,5,9,5,1
22,72902,DUBLIN ISD,11,english,6,75,10,65,49,22,75,6,69,46,20
22,72903,STEPHENVILLE IS,11,english,6,251,76,175,108,53,248,57,191,105,45
22,72904,BLUFF DALE ISD,11,english,6,16,5,11,7,3,16,5,11,5,2
22,72908,HUCKABAY ISD,11,english,6,17,3,14,7,4,17,2,15,9,3
22,72909,LINGLEVILLE ISD,11,english,6,15,2,13,10,5,15,3,12,3,0
22,72910,MORGAN MILL ISD,11,english,6,6,0,6,5,2,6,0,6,3,2
22,73901,CHILTON ISD,12,english,6,41,11,30,16,7,41,9,32,10,3
22,73903,MARLIN ISD,12,english,6,62,30,32,12,5,62,22,40,14,6
22,73904,WESTPHALIA ISD,12,english,6,18,3,15,11,3,18,0,18,13,9
22,73905,ROSEBUD-LOTT IS,12,english,6,50,12,38,24,10,50,15,35,18,9
22,74903,BONHAM ISD,10,english,6,131,35,96,46,20,131,31,100,42,19
22,74904,DODD CITY ISD,10,english,6,27,9,18,8,2,27,8,19,7,1
22,74905,ECTOR ISD,10,english,6,25,15,10,3,0,25,7,18,5,0
22,74907,HONEY GROVE ISD,8,english,6,42,8,34,22,14,42,7,35,21,5
22,74909,LEONARD ISD,10,english,6,64,14,50,33,19,64,14,50,16,5
22,74911,SAVOY ISD,10,english,6,22,1,21,12,9,22,2,20,10,6
22,74912,TRENTON ISD,10,english,6,46,6,40,26,14,46,8,38,15,3
22,74917,SAM RAYBURN ISD,10,english,6,31,1,30,20,13,31,3,28,21,9
22,75901,FLATONIA ISD,13,english,6,46,6,40,23,11,46,6,40,29,14
22,75902,LA GRANGE ISD,13,english,6,141,36,105,53,27,141,35,106,54,12
22,75903,SCHULENBURG ISD,13,english,6,48,23,25,12,3,48,12,36,18,7
22,75906,FAYETTEVILLE IS,13,english,6,26,5,21,13,6,26,5,21,15,6
22,75908,ROUND TOP-CARMI,13,english,6,16,3,13,10,7,16,0,16,13,6
22,76903,ROBY CISD,14,english,6,26,7,19,13,8,26,10,16,6,2
22,76904,ROTAN ISD,14,english,6,19,4,15,9,6,19,1,18,11,2
22,77901,FLOYDADA COLLEG,17,english,6,48,12,36,15,7,48,14,34,10,3
22,77902,LOCKNEY ISD,17,english,6,32,15,17,8,3,32,15,17,5,1
22,78901,CROWELL ISD,9,english,6,14,3,11,6,4,14,3,11,3,0
22,79901,LAMAR CISD,4,english,6,2899,584,2315,1568,914,2900,504,2396,1427,646
22,79906,NEEDVILLE ISD,4,english,6,247,23,224,170,106,247,10,237,157,68
22,79907,FORT BEND ISD,4,english,6,5810,1390,4420,2881,1700,5701,1357,4344,2598,1332
22,79910,STAFFORD MSD,4,english,6,279,95,184,110,53,279,87,192,97,30
22,80901,MOUNT VERNON IS,8,english,6,109,17,92,47,28,109,10,99,58,33
22,81902,FAIRFIELD ISD,12,english,6,121,38,83,44,23,121,34,87,38,13
22,81904,TEAGUE ISD,12,english,6,75,19,56,23,17,75,18,57,23,6
22,81905,WORTHAM ISD,12,english,6,43,15,28,18,11,43,14,29,11,6
22,81906,DEW ISD,12,english,6,12,2,10,7,4,12,2,10,6,0
22,82902,DILLEY ISD,20,english,6,50,26,24,12,7,50,34,16,4,0
22,82903,PEARSALL ISD,20,english,6,148,72,76,26,13,148,96,52,11,3
22,83901,SEAGRAVES ISD,17,english,6,48,23,25,14,4,48,13,35,10,3
22,83902,LOOP ISD,17,english,6,13,1,12,9,5,13,3,10,7,2
22,83903,SEMINOLE ISD,17,english,6,209,70,139,79,43,209,38,171,88,39
22,84802,ODYSSEY ACADEMY,4,english,6,101,60,41,18,5,101,48,53,10,3
22,84804,AMBASSADORS PRE,4,english,6,11,2,9,6,5,11,3,8,3,0
22,84901,DICKINSON ISD,4,english,6,905,315,590,303,150,907,231,676,335,130
22,84902,GALVESTON ISD,4,english,6,424,192,232,131,52,426,170,256,94,34
22,84903,HIGH ISLAND ISD,5,english,6,10,3,7,3,2,10,2,8,5,4
22,84906,TEXAS CITY ISD,4,english,6,554,250,304,138,65,553,226,327,112,38
22,84908,HITCHCOCK ISD,4,english,6,125,48,77,29,11,125,56,69,23,2
22,84909,SANTA FE ISD,4,english,6,325,89,236,133,71,325,114,211,87,24
22,84910,CLEAR CREEK ISD,4,english,6,3018,617,2401,1649,942,2970,542,2428,1387,543
22,84911,FRIENDSWOOD ISD,4,english,6,482,48,434,326,205,230,22,208,117,26
22,85902,POST ISD,17,english,6,51,18,33,17,5,51,21,30,5,2
22,85903,SOUTHLAND ISD,17,english,6,0,,,,,0,,,,
22,86901,FREDERICKSBURG,13,english,6,206,71,135,86,48,206,49,157,98,54
22,86902,HARPER ISD,13,english,6,44,8,36,25,12,44,5,39,16,2
22,87901,GLASSCOCK COUNT,18,english,6,21,1,20,14,6,21,1,20,13,7
22,88902,GOLIAD ISD,3,english,6,90,32,58,31,17,90,32,58,14,4
22,89901,GONZALES ISD,13,english,6,175,59,116,63,31,175,63,112,45,15
22,89903,NIXON-SMILEY CI,13,english,6,70,25,45,27,10,70,31,39,13,3
22,89905,WAELDER ISD,13,english,6,20,10,10,5,3,20,9,11,2,1
22,90902,LEFORS ISD,16,english,6,14,7,7,2,0,14,6,8,2,1
22,90903,MCLEAN ISD,16,english,6,13,4,9,4,1,13,3,10,2,1
22,90904,PAMPA ISD,16,english,6,232,90,142,68,33,232,64,168,75,35
22,90905,GRANDVIEW-HOPKI,16,english,6,5,0,5,3,1,5,0,5,2,0
22,91901,BELLS ISD,10,english,6,70,16,54,28,16,70,12,58,21,6
22,91902,COLLINSVILLE IS,10,english,6,38,9,29,12,6,38,7,31,19,3
22,91903,DENISON ISD,10,english,6,351,92,259,162,85,351,72,279,150,58
22,91905,HOWE ISD,10,english,6,79,7,72,48,25,79,3,76,45,17
22,91906,SHERMAN ISD,10,english,6,503,187,316,173,87,494,188,306,121,38
22,91907,TIOGA ISD,10,english,6,53,7,46,26,12,53,17,36,12,1
22,91908,VAN ALSTYNE ISD,10,english,6,156,20,136,98,66,156,12,144,82,28
22,91909,WHITESBORO ISD,10,english,6,132,38,94,55,29,130,19,111,54,10
22,91910,WHITEWRIGHT ISD,10,english,6,49,11,38,21,12,49,2,47,43,21
22,91913,POTTSBORO ISD,10,english,6,92,27,65,31,14,76,29,47,5,0
22,91914,S AND S CISD,10,english,6,64,20,44,25,10,63,24,39,20,1
22,91917,GUNTER ISD,10,english,6,90,15,75,50,28,90,19,71,34,8
22,91918,TOM BEAN ISD,10,english,6,52,6,46,26,13,52,4,48,25,8
22,92901,GLADEWATER ISD,7,english,6,120,40,80,43,15,120,36,84,42,8
22,92902,KILGORE ISD,7,english,6,299,100,199,109,56,298,91,207,94,23
22,92903,LONGVIEW ISD,7,english,6,615,164,451,274,159,614,130,484,260,122
22,92904,PINE TREE ISD,7,english,6,336,118,218,114,52,336,99,237,99,31
22,92906,SABINE ISD,7,english,6,104,30,74,52,26,104,19,85,43,15
22,92907,SPRING HILL ISD,7,english,6,149,45,104,78,45,149,36,113,58,26
22,92908,WHITE OAK ISD,7,english,6,121,19,102,63,37,121,11,110,57,17
22,93901,ANDERSON-SHIRO,6,english,6,55,11,44,31,16,55,5,50,38,23
22,93903,IOLA ISD,6,english,6,44,8,36,26,18,44,9,35,25,7
22,93904,NAVASOTA ISD,6,english,6,187,79,108,47,22,187,51,136,49,20
22,93905,RICHARDS ISD,6,english,6,20,7,13,5,5,20,10,10,3,0
22,94901,SEGUIN ISD,20,english,6,483,237,246,121,62,482,225,257,69,18
22,94902,SCHERTZ-CIBOLO-,20,english,6,1202,305,897,553,304,1199,161,1038,686,281
22,94903,NAVARRO ISD,20,english,6,158,27,131,93,54,157,22,135,77,29
22,94904,MARION ISD,20,english,6,116,34,82,47,16,116,38,78,30,7
22,95901,ABERNATHY ISD,17,english,6,64,21,43,31,20,64,11,53,32,22
22,95902,COTTON CENTER I,17,english,6,11,3,8,4,2,11,3,8,3,2
22,95903,HALE CENTER ISD,17,english,6,43,12,31,18,7,43,13,30,9,4
22,95904,PETERSBURG ISD,17,english,6,19,3,16,8,6,19,0,19,10,5
22,95905,PLAINVIEW ISD,17,english,6,376,160,216,101,50,377,135,242,89,23
22,96904,MEMPHIS ISD,16,english,6,23,3,20,10,7,23,4,19,9,6
22,96905,TURKEY-QUITAQUE,16,english,6,13,0,13,9,6,13,1,12,6,2
22,97902,HAMILTON ISD,12,english,6,58,9,49,36,18,58,8,50,34,18
22,97903,HICO ISD,12,english,6,46,7,39,27,14,46,12,34,15,5
22,98901,GRUVER ISD,16,english,6,34,2,32,24,13,34,0,34,33,22
22,98903,PRINGLE-MORSE C,16,english,6,15,4,11,5,3,15,2,13,3,2
22,98904,SPEARMAN ISD,16,english,6,45,10,35,25,14,45,2,43,31,18
22,99902,CHILLICOTHE ISD,9,english,6,12,5,7,4,3,12,6,6,4,3
22,99903,QUANAH ISD,9,english,6,37,10,27,17,11,37,13,24,11,3
22,100903,KOUNTZE ISD,5,english,6,70,23,47,25,11,70,13,57,23,4
22,100904,SILSBEE ISD,5,english,6,216,92,124,62,22,218,83,135,42,4
22,100905,HARDIN-JEFFERSO,5,english,6,180,42,138,92,46,180,23,157,93,33
22,100907,LUMBERTON ISD,5,english,6,316,87,229,135,62,316,59,257,138,48
22,100908,WEST HARDIN COU,5,english,6,34,8,26,20,13,34,2,32,18,4
22,101802,SER-NINOS CHART,4,english,6,91,27,64,39,16,91,16,75,35,10
22,101803,ARISTOI CLASSIC,4,english,6,106,8,98,79,48,106,14,92,65,33
22,101804,GEORGE I SANCHE,4,english,6,95,60,35,16,3,95,56,39,10,1
22,101806,RAUL YZAGUIRRE,4,english,6,155,60,95,50,24,155,61,94,43,18
22,101810,ACADEMY OF ACCE,4,english,6,76,23,53,28,15,76,24,52,21,9
22,101811,EXCEL ACADEMY,4,english,6,0,,,,,0,,,,
22,101814,THE VARNETT PUB,4,english,6,101,40,61,35,13,101,20,81,35,14
22,101815,ALIEF MONTESSOR,4,english,6,23,2,21,19,11,23,2,21,16,10
22,101819,AMIGOS POR VIDA,4,english,6,66,18,48,26,12,66,6,60,39,17
22,101828,HOUSTON GATEWAY,4,english,6,164,6,158,126,78,164,4,160,149,109
22,101837,CALVIN NELMS CH,4,english,6,47,10,37,26,17,47,6,41,19,7
22,101838,SOUTHWEST SCHOO,4,english,6,72,42,30,10,7,72,41,31,5,3
22,101842,COMQUEST ACADEM,4,english,6,0,,,,,0,,,,
22,101845,YES PREP PUBLIC,4,english,6,2080,899,1181,585,231,2077,649,1428,645,191
22,101846,HARMONY PUBLIC,4,english,6,352,97,255,155,77,356,65,291,162,74
22,101847,BEATRICE MAYES,4,english,6,48,11,37,22,9,48,12,36,16,6
22,101849,ACCELERATED INT,4,english,6,18,2,16,9,4,18,4,14,8,3
22,101853,PROMISE COMMUNI,4,english,6,82,36,46,12,7,82,16,66,21,6
22,101855,MEYERPARK ELEME,4,english,6,19,6,13,9,6,20,6,14,7,4
22,101856,DRAW ACADEMY,4,english,6,60,31,29,19,8,60,25,35,9,3
22,101858,HARMONY PUBLIC,4,english,6,554,168,386,238,125,534,101,433,255,115
22,101859,STEP CHARTER SC,4,english,6,54,12,42,23,13,54,8,46,30,10
22,101861,THE RHODES SCHO,4,english,6,44,10,34,17,8,44,8,36,20,5
22,101862,HARMONY PUBLIC,4,english,6,412,61,351,235,150,389,48,341,255,137
22,101864,THE LAWSON ACAD,4,english,6,55,30,25,11,4,55,27,28,7,2
22,101868,THE PRO-VISION,4,english,6,44,34,10,5,0,44,38,6,1,0
22,101870,BETA ACADEMY,4,english,6,105,9,96,76,46,104,9,95,53,24
22,101871,A+ UNLIMITED PO,4,english,6,47,19,28,15,6,47,20,27,9,3
22,101872,ETOILE ACADEMY,4,english,6,75,36,39,24,12,75,32,43,16,4
22,101873,YELLOWSTONE COL,4,english,6,44,11,33,10,5,44,13,31,7,2
22,101874,LEGACY SCHOOL O,4,english,6,38,10,28,20,7,37,10,27,15,0
22,101902,ALDINE ISD,4,english,6,4435,2355,2080,873,338,4436,2246,2190,679,195
22,101903,ALIEF ISD,4,english,6,2716,1159,1557,809,363,2716,1063,1653,707,272
22,101905,CHANNELVIEW ISD,4,english,6,719,298,421,207,86,719,256,463,164,39
22,101906,CROSBY ISD,4,english,6,529,193,336,174,74,529,156,373,179,54
22,101907,CYPRESS-FAIRBAN,4,english,6,8399,2010,6389,4333,2613,8387,1966,6421,3741,1815
22,101908,DEER PARK ISD,4,english,6,923,242,681,384,184,847,123,724,410,129
22,101910,GALENA PARK ISD,4,english,6,1483,519,964,509,213,1480,354,1126,583,225
22,101911,GOOSE CREEK CIS,4,english,6,1778,660,1118,596,260,1778,514,1264,633,241
22,101912,HOUSTON ISD,4,english,6,12189,4584,7605,4668,2643,12176,4524,7652,3734,1619
22,101913,HUMBLE ISD,4,english,6,3645,1073,2572,1497,729,3648,1005,2643,1269,476
22,101914,KATY ISD,4,english,6,6935,1261,5674,4088,2505,6774,875,5899,4118,2268
22,101915,KLEIN ISD,4,english,6,3917,1117,2800,1791,986,3548,895,2653,1269,464
22,101916,LA PORTE ISD,4,english,6,503,138,365,200,100,503,90,413,202,73
22,101917,PASADENA ISD,4,english,6,3445,1315,2130,1054,445,2818,1055,1763,561,84
22,101919,SPRING ISD,4,english,6,2220,1015,1205,589,237,2223,998,1225,422,114
22,101920,SPRING BRANCH I,4,english,6,2408,806,1602,1063,614,2342,565,1777,1076,564
22,101921,TOMBALL ISD,4,english,6,1569,187,1382,1003,610,1568,124,1444,1004,547
22,101924,SHELDON ISD,4,english,6,783,376,407,193,91,783,396,387,118,23
22,101925,HUFFMAN ISD,4,english,6,291,106,185,92,44,291,87,204,94,41
22,102901,KARNACK ISD,7,english,6,17,2,15,6,3,17,5,12,4,0
22,102902,MARSHALL ISD,7,english,6,380,148,232,116,52,379,122,257,132,46
22,102903,WASKOM ISD,7,english,6,66,19,47,22,6,66,15,51,24,5
22,102904,HALLSVILLE ISD,7,english,6,1701,624,1077,553,258,1703,762,941,406,170
22,102905,HARLETON ISD,7,english,6,61,13,48,33,22,61,6,55,30,13
22,102906,ELYSIAN FIELDS,7,english,6,58,4,54,33,21,58,7,51,29,14
22,103901,CHANNING ISD,16,english,6,13,2,11,6,4,13,1,12,8,2
22,103902,HARTLEY ISD,16,english,6,16,2,14,10,6,16,0,16,9,2
22,104901,HASKELL CISD,14,english,6,36,8,28,16,10,36,15,21,8,3
22,104903,RULE ISD,14,english,6,13,5,8,4,2,13,4,9,3,1
22,104907,PAINT CREEK ISD,14,english,6,11,4,7,3,1,11,0,11,6,1
22,105802,TEXAS PREPARATO,13,english,6,13,4,9,5,1,13,4,9,4,1
22,105803,KI CHARTER ACAD,13,english,6,24,15,9,4,2,24,18,6,0,0
22,105902,SAN MARCOS CISD,13,english,6,608,279,329,175,86,418,248,170,32,4
22,105904,DRIPPING SPRING,13,english,6,593,80,513,369,211,493,62,431,243,52
22,105905,WIMBERLEY ISD,13,english,6,179,35,144,108,72,179,28,151,92,46
22,105906,HAYS CISD,13,english,6,1558,473,1085,641,332,1551,488,1063,539,207
22,106901,CANADIAN ISD,16,english,6,79,16,63,37,11,79,7,72,43,19
22,107901,ATHENS ISD,10,english,6,216,82,134,77,42,216,65,151,65,20
22,107902,BROWNSBORO ISD,7,english,6,187,47,140,95,49,187,29,158,86,39
22,107904,CROSS ROADS ISD,7,english,6,28,1,27,13,8,27,0,27,17,6
22,107905,EUSTACE ISD,7,english,6,117,20,97,50,28,117,18,99,45,8
22,107906,MALAKOFF ISD,7,english,6,111,12,99,71,50,111,19,92,53,14
22,107907,TRINIDAD ISD,7,english,6,14,10,4,2,0,14,3,11,2,1
22,107908,MURCHISON ISD,7,english,6,16,7,9,6,2,16,5,11,4,1
22,107910,LAPOYNOR ISD,7,english,6,31,9,22,17,10,31,9,22,9,2
22,108802,HORIZON MONTESS,1,english,6,90,22,68,36,18,90,31,59,27,4
22,108807,IDEA PUBLIC SCH,1,english,6,6088,1464,4624,2840,1484,6087,1484,4603,2520,1031
22,108808,VANGUARD ACADEM,1,english,6,414,95,319,193,108,414,133,281,122,36
22,108809,EXCELLENCE IN L,1,english,6,29,13,16,12,3,29,12,17,6,1
22,108902,DONNA ISD,1,english,6,914,458,456,198,78,907,346,561,218,60
22,108903,EDCOUCH-ELSA IS,1,english,6,267,111,156,75,37,268,99,169,49,13
22,108904,EDINBURG CISD,1,english,6,2201,683,1518,964,506,2204,729,1475,646,207
22,108905,HIDALGO ISD,1,english,6,165,57,108,65,39,165,44,121,66,18
22,108906,MCALLEN ISD,1,english,6,1475,394,1081,684,376,1216,361,855,369,89
22,108907,MERCEDES ISD,1,english,6,335,150,185,81,33,336,185,151,53,9
22,108908,MISSION CISD,1,english,6,932,403,529,242,116,932,466,466,165,40
22,108909,PHARR-SAN JUAN-,1,english,6,1937,758,1179,594,291,1935,742,1193,478,138
22,108910,PROGRESO ISD,1,english,6,101,49,52,23,13,101,54,47,10,2
22,108911,SHARYLAND ISD,1,english,6,678,127,551,361,228,677,110,567,363,186
22,108912,LA JOYA ISD,1,english,6,1651,623,1028,575,279,1451,460,991,433,120
22,108913,WESLACO ISD,1,english,6,1142,473,669,356,158,1145,436,709,295,118
22,108914,LA VILLA ISD,1,english,6,36,14,22,10,3,36,18,18,7,1
22,108915,MONTE ALTO ISD,1,english,6,62,16,46,22,8,62,6,56,27,6
22,108916,VALLEY VIEW ISD,1,english,6,225,70,155,89,47,226,59,167,91,38
22,109901,ABBOTT ISD,12,english,6,24,2,22,17,10,24,1,23,13,8
22,109902,BYNUM ISD,12,english,6,12,3,9,5,1,12,0,12,7,2
22,109903,COVINGTON ISD,12,english,6,17,1,16,11,5,17,2,15,5,1
22,109904,HILLSBORO ISD,12,english,6,128,28,100,54,25,127,21,106,51,16
22,109905,HUBBARD ISD,12,english,6,40,13,27,17,8,40,10,30,10,4
22,109907,ITASCA ISD,12,english,6,46,18,28,14,4,46,19,27,8,1
22,109908,MALONE ISD,12,english,6,15,9,6,2,1,15,5,10,2,0
22,109910,MOUNT CALM ISD,12,english,6,12,3,9,2,2,12,2,10,3,1
22,109911,WHITNEY ISD,12,english,6,112,31,81,38,17,112,34,78,33,7
22,109912,AQUILLA ISD,12,english,6,20,7,13,8,3,20,4,16,9,3
22,109913,BLUM ISD,12,english,6,28,8,20,13,7,28,7,21,9,1
22,109914,PENELOPE ISD,12,english,6,13,4,9,7,2,13,4,9,5,2
22,110901,ANTON ISD,17,english,6,17,10,7,2,1,17,8,9,0,0
22,110902,LEVELLAND ISD,17,english,6,193,79,114,52,22,193,50,143,45,13
22,110905,ROPES ISD,17,english,6,28,0,28,16,6,28,0,28,19,6
22,110906,SMYER ISD,17,english,6,25,0,25,15,11,25,2,23,16,5
22,110907,SUNDOWN ISD,17,english,6,38,5,33,22,13,38,1,37,34,20
22,110908,WHITHARRAL ISD,17,english,6,19,6,13,10,3,19,1,18,6,3
22,111901,GRANBURY ISD,11,english,6,600,157,443,262,127,597,146,451,233,87
22,111902,LIPAN ISD,11,english,6,27,5,22,15,9,27,6,21,8,2
22,111903,TOLAR ISD,11,english,6,63,8,55,46,33,64,5,59,38,14
22,112901,SULPHUR SPRINGS,8,english,6,311,78,233,141,84,311,57,254,148,73
22,112905,CUMBY ISD,8,english,6,25,8,17,11,4,25,4,21,8,6
22,112906,NORTH HOPKINS I,8,english,6,45,20,25,16,5,45,7,38,16,5
22,112907,MILLER GROVE IS,8,english,6,23,4,19,17,8,23,3,20,7,3
22,112908,COMO-PICKTON CI,8,english,6,56,10,46,28,15,56,15,41,13,5
22,112909,SALTILLO ISD,8,english,6,13,1,12,10,3,13,3,10,7,0
22,112910,SULPHUR BLUFF I,8,english,6,20,2,18,10,5,20,0,20,8,3
22,113901,CROCKETT ISD,6,english,6,84,31,53,19,8,86,38,48,13,5
22,113902,GRAPELAND ISD,6,english,6,38,16,22,16,10,38,14,24,8,1
22,113903,LOVELADY ISD,6,english,6,48,1,47,37,24,48,5,43,16,9
22,113905,LATEXO ISD,6,english,6,29,5,24,14,8,29,3,26,17,6
22,113906,KENNARD ISD,6,english,6,18,3,15,9,5,18,1,17,9,2
22,114901,BIG SPRING ISD,18,english,6,243,96,147,79,31,244,84,160,63,22
22,114902,COAHOMA ISD,18,english,6,93,41,52,20,8,92,33,59,15,2
22,114904,FORSAN ISD,18,english,6,52,15,37,23,13,52,13,39,20,6
22,115901,FT HANCOCK ISD,19,english,6,32,17,15,5,3,32,11,21,6,0
22,115902,SIERRA BLANCA I,19,english,6,10,3,7,5,2,10,3,7,3,1
22,115903,DELL CITY ISD,19,english,6,5,1,4,2,2,6,1,5,2,2
22,116901,CADDO MILLS ISD,10,english,6,185,24,161,107,69,185,24,161,81,28
22,116902,CELESTE ISD,10,english,6,30,8,22,15,9,30,9,21,13,3
22,116903,COMMERCE ISD,10,english,6,109,51,58,37,23,107,58,49,16,11
22,116905,GREENVILLE ISD,10,english,6,349,188,161,75,38,349,120,229,90,34
22,116906,LONE OAK ISD,10,english,6,78,27,51,30,17,78,10,68,39,8
22,116908,QUINLAN ISD,10,english,6,171,64,107,57,29,171,75,96,42,15
22,116909,WOLFE CITY ISD,10,english,6,42,16,26,14,6,42,8,34,13,3
22,116910,CAMPBELL ISD,10,english,6,21,12,9,4,3,21,10,11,7,2
22,116915,BLAND ISD,10,english,6,48,11,37,27,15,48,5,43,26,16
22,116916,BOLES ISD,10,english,6,35,10,25,6,3,35,6,29,8,3
22,117901,BORGER ISD,16,english,6,182,58,124,77,42,182,57,125,64,19
22,117903,SANFORD-FRITCH,16,english,6,46,18,28,16,12,46,10,36,14,7
22,117904,PLEMONS-STINNET,16,english,6,37,11,26,15,7,37,7,30,16,5
22,117907,SPRING CREEK IS,16,english,6,8,2,6,5,2,8,2,6,2,0
22,118902,IRION COUNTY IS,15,english,6,20,1,19,14,10,20,1,19,12,5
22,119901,BRYSON ISD,9,english,6,12,5,7,7,3,12,3,9,6,2
22,119902,JACKSBORO ISD,9,english,6,76,20,56,28,17,76,10,66,34,11
22,119903,PERRIN-WHITT CI,9,english,6,17,5,12,9,4,17,1,16,8,1
22,120901,EDNA ISD,3,english,6,125,35,90,54,24,125,29,96,56,24
22,120902,GANADO ISD,3,english,6,54,15,39,19,12,54,12,42,18,3
22,120905,INDUSTRIAL ISD,3,english,6,98,6,92,69,34,98,5,93,58,22
22,121902,BROOKELAND ISD,5,english,6,21,2,19,8,2,21,4,17,7,3
22,121903,BUNA ISD,5,english,6,115,26,89,51,27,115,22,93,31,13
22,121904,JASPER ISD,5,english,6,177,110,67,31,13,177,86,91,39,13
22,121905,KIRBYVILLE CISD,5,english,6,119,41,78,37,13,119,12,107,53,18
22,121906,EVADALE ISD,5,english,6,31,8,23,11,6,31,5,26,13,1
22,122901,FT DAVIS ISD,18,english,6,16,8,8,6,5,16,9,7,3,1
22,122902,VALENTINE ISD,18,english,6,0,,,,,0,,,,
22,123803,TEKOA ACADEMY O,5,english,6,10,1,9,3,1,10,4,6,0,0
22,123805,EHRHART SCHOOL,5,english,6,54,12,42,32,14,54,7,47,25,14
22,123807,BOB HOPE SCHOOL,5,english,6,168,44,124,62,32,168,46,122,53,17
22,123905,NEDERLAND ISD,5,english,6,407,85,322,216,125,406,63,343,208,105
22,123907,PORT ARTHUR ISD,5,english,6,505,251,254,109,42,504,269,235,88,23
22,123908,PORT NECHES-GRO,5,english,6,405,95,310,158,73,406,84,322,150,49
22,123910,BEAUMONT ISD,5,english,6,1122,653,469,216,79,1115,699,416,111,23
22,123913,SABINE PASS ISD,5,english,6,28,3,25,15,7,28,3,25,14,2
22,123914,HAMSHIRE-FANNET,5,english,6,156,47,109,70,41,157,45,112,44,10
22,124901,JIM HOGG COUNTY,1,english,6,62,27,35,15,6,62,25,37,9,3
22,125901,ALICE ISD,2,english,6,299,114,185,94,40,300,108,192,77,16
22,125902,BEN BOLT-PALITO,2,english,6,32,9,23,15,4,32,8,24,5,1
22,125903,ORANGE GROVE IS,2,english,6,127,41,86,52,28,127,32,95,40,12
22,125905,PREMONT ISD,2,english,6,47,23,24,11,5,47,14,33,10,3
22,125906,LA GLORIA ISD,2,english,6,7,1,6,6,3,7,0,7,4,2
22,126901,ALVARADO ISD,11,english,6,258,105,153,75,34,258,79,179,81,21
22,126902,BURLESON ISD,11,english,6,946,266,680,416,208,944,171,773,450,228
22,126903,CLEBURNE ISD,11,english,6,514,180,334,185,83,516,142,374,164,43
22,126904,GRANDVIEW ISD,11,english,6,103,27,76,46,28,103,14,89,57,21
22,126905,JOSHUA ISD,11,english,6,433,78,355,241,144,433,58,375,255,153
22,126906,KEENE ISD,11,english,6,68,16,52,36,16,68,9,59,35,17
22,126907,RIO VISTA ISD,11,english,6,56,25,31,18,8,56,14,42,14,4
22,126908,VENUS ISD,11,english,6,172,75,97,37,18,172,68,104,42,9
22,126911,GODLEY ISD,11,english,6,196,68,128,59,28,196,48,148,62,24
22,127901,ANSON ISD,14,english,6,52,19,33,15,9,52,16,36,14,4
22,127903,HAMLIN COLLEGIA,14,english,6,33,12,21,10,2,33,7,26,13,3
22,127904,HAWLEY ISD,14,english,6,72,28,44,17,9,72,18,54,13,3
22,127905,LUEDERS-AVOCA I,14,english,6,11,1,10,8,5,11,1,10,3,1
22,127906,STAMFORD ISD,14,english,6,38,12,26,17,10,38,5,33,16,7
22,128901,KARNES CITY ISD,20,english,6,54,21,33,20,7,54,14,40,11,3
22,128902,KENEDY ISD,3,english,6,45,19,26,15,6,45,14,31,13,4
22,128903,RUNGE ISD,3,english,6,15,8,7,2,0,16,12,4,0,0
22,128904,FALLS CITY ISD,20,english,6,34,2,32,29,18,34,1,33,31,21
22,129901,CRANDALL ISD,10,english,6,478,122,356,221,126,478,115,363,186,67
22,129902,FORNEY ISD,10,english,6,1140,345,795,486,249,1140,307,833,446,188
22,129903,KAUFMAN ISD,10,english,6,309,70,239,146,81,309,49,260,147,57
22,129904,KEMP ISD,10,english,6,122,46,76,32,11,122,43,79,29,3
22,129905,MABANK ISD,10,english,6,286,107,179,98,51,286,56,230,117,52
22,129906,TERRELL ISD,10,english,6,363,159,204,108,53,363,171,192,56,17
22,129910,SCURRY-ROSSER I,10,english,6,91,18,73,43,24,91,7,84,58,24
22,130801,MEADOWLAND CHAR,20,english,6,10,10,0,0,0,10,7,3,0,0
22,130901,BOERNE ISD,20,english,6,794,130,664,463,281,792,80,712,493,231
22,130902,COMFORT ISD,13,english,6,77,21,56,36,18,77,21,56,26,6
22,131001,KENEDY COUNTY W,2,english,6,12,1,11,7,4,12,2,10,6,3
22,132902,JAYTON-GIRARD I,17,english,6,10,0,10,7,5,10,0,10,8,3
22,133901,CENTER POINT IS,20,english,6,44,17,27,16,7,44,4,40,27,14
22,133902,HUNT ISD,20,english,6,19,1,18,13,10,19,2,17,14,10
22,133903,KERRVILLE ISD,20,english,6,343,83,260,174,104,342,73,269,142,48
22,133904,INGRAM ISD,20,english,6,98,21,77,51,34,97,12,85,49,18
22,133905,DIVIDE ISD,20,english,6,0,,,,,0,,,,
22,134901,JUNCTION ISD,15,english,6,40,16,24,15,7,39,10,29,13,3
22,135001,GUTHRIE CSD,17,english,6,8,1,7,5,4,8,1,7,5,0
22,136901,BRACKETT ISD,20,english,6,37,8,29,18,10,37,7,30,15,6
22,137901,KINGSVILLE ISD,2,english,6,169,90,79,47,19,169,90,79,34,11
22,137902,RICARDO ISD,2,english,6,78,21,57,34,13,78,21,57,22,4
22,137903,RIVIERA ISD,2,english,6,30,3,27,12,5,30,3,27,13,5
22,137904,SANTA GERTRUDIS,2,english,6,49,7,42,27,16,49,14,35,15,6
22,138902,KNOX CITY-O'BRI,9,english,6,11,3,8,2,2,11,1,10,7,3
22,138903,MUNDAY CISD,9,english,6,45,13,32,18,8,45,15,30,9,1
22,138904,BENJAMIN ISD,9,english,6,8,0,8,6,3,8,0,8,4,2
22,139905,CHISUM ISD,8,english,6,85,17,68,47,22,85,4,81,47,18
22,139909,PARIS ISD,8,english,6,242,98,144,76,39,242,86,156,70,21
22,139911,NORTH LAMAR ISD,8,english,6,165,65,100,63,35,166,43,123,60,23
22,139912,PRAIRILAND ISD,8,english,6,92,25,67,42,25,92,13,79,31,17
22,140901,AMHERST ISD,17,english,6,8,2,6,3,0,8,4,4,0,0
22,140904,LITTLEFIELD ISD,17,english,6,97,26,71,36,15,97,28,69,25,4
22,140905,OLTON ISD,17,english,6,46,12,34,18,8,46,7,39,16,9
22,140907,SPRINGLAKE-EART,17,english,6,22,9,13,9,6,22,7,15,7,0
22,140908,SUDAN ISD,17,english,6,39,2,37,27,17,39,2,37,25,6
22,141901,LAMPASAS ISD,12,english,6,244,56,188,121,66,244,33,211,141,54
22,141902,LOMETA ISD,12,english,6,22,5,17,3,2,22,3,19,8,1
22,142901,COTULLA ISD,20,english,6,90,32,58,30,17,89,30,59,34,9
22,143901,HALLETTSVILLE I,3,english,6,86,17,69,42,24,86,10,76,45,18
22,143902,MOULTON ISD,3,english,6,19,7,12,8,4,19,1,18,9,6
22,143903,SHINER ISD,3,english,6,53,10,43,28,16,53,1,52,43,24
22,143904,VYSEHRAD ISD,3,english,6,7,1,6,3,3,7,1,6,4,1
22,143905,SWEET HOME ISD,3,english,6,11,1,10,10,4,11,1,10,6,3
22,143906,EZZELL ISD,3,english,6,16,5,11,5,3,16,4,12,5,0
22,144901,GIDDINGS ISD,13,english,6,146,42,104,57,26,146,42,104,47,14
22,144902,LEXINGTON ISD,13,english,6,79,18,61,43,23,79,16,63,41,21
22,144903,DIME BOX ISD,13,english,6,16,6,10,6,4,16,2,14,5,2
22,145901,BUFFALO ISD,6,english,6,72,16,56,32,17,72,10,62,36,11
22,145902,CENTERVILLE ISD,6,english,6,61,12,49,31,18,61,5,56,26,8
22,145906,NORMANGEE ISD,6,english,6,48,10,38,24,12,48,5,43,23,6
22,145907,OAKWOOD ISD,6,english,6,17,4,13,7,2,17,2,15,2,1
22,145911,LEON ISD,6,english,6,60,9,51,28,19,60,13,47,29,12
22,146901,CLEVELAND ISD,4,english,6,874,513,361,145,49,878,427,451,144,28
22,146902,DAYTON ISD,4,english,6,445,229,216,86,36,445,192,253,79,13
22,146903,DEVERS ISD,4,english,6,21,0,21,17,10,21,0,21,17,5
22,146904,HARDIN ISD,5,english,6,102,28,74,38,17,102,44,58,25,3
22,146905,HULL-DAISETTA I,5,english,6,26,9,17,5,3,26,10,16,6,2
22,146906,LIBERTY ISD,5,english,6,175,62,113,70,29,175,60,115,46,13
22,146907,TARKINGTON ISD,4,english,6,136,56,80,43,24,136,41,95,43,11
22,147901,COOLIDGE ISD,12,english,6,20,3,17,8,3,20,6,14,5,0
22,147902,GROESBECK ISD,12,english,6,120,32,88,50,21,119,34,85,53,19
22,147903,MEXIA ISD,12,english,6,126,50,76,41,19,125,51,74,30,10
22,148901,BOOKER ISD,16,english,6,21,2,19,12,5,21,4,17,10,2
22,148902,FOLLETT ISD,16,english,6,24,7,17,12,8,24,8,16,8,4
22,148905,DARROUZETT ISD,16,english,6,15,7,8,5,3,15,5,10,4,2
22,149901,GEORGE WEST ISD,2,english,6,78,10,68,44,22,77,7,70,36,13
22,149902,THREE RIVERS IS,2,english,6,38,2,36,25,13,38,6,32,12,2
22,150901,LLANO ISD,13,english,6,126,39,87,43,23,126,36,90,32,3
22,152504,TEXAS TECH UNIV,17,english,6,19,1,18,15,12,18,1,17,13,6
22,152802,RISE ACADEMY,17,english,6,17,0,17,12,10,17,0,17,16,12
22,152901,LUBBOCK ISD,17,english,6,1813,675,1138,648,341,1813,497,1316,614,216
22,152902,NEW DEAL ISD,17,english,6,61,17,44,26,16,61,11,50,27,15
22,152903,SLATON ISD,17,english,6,90,45,45,21,9,90,35,55,21,3
22,152906,LUBBOCK-COOPER,17,english,6,611,144,467,296,152,609,146,463,250,84
22,152907,FRENSHIP ISD,17,english,6,829,172,657,462,271,829,138,691,397,168
22,152908,ROOSEVELT ISD,17,english,6,85,33,52,25,14,85,42,43,11,2
22,152909,SHALLOWATER ISD,17,english,6,127,24,103,70,39,127,14,113,72,25
22,152910,IDALOU ISD,17,english,6,73,11,62,37,24,72,9,63,32,4
22,153903,O'DONNELL ISD,17,english,6,23,6,17,7,3,23,1,22,9,1
22,153904,TAHOKA ISD,17,english,6,38,5,33,20,14,39,4,35,19,9
22,153905,NEW HOME ISD,17,english,6,43,1,42,30,20,43,2,41,27,11
22,153907,WILSON ISD,17,english,6,6,2,4,2,0,6,2,4,2,0
22,154901,MADISONVILLE CI,6,english,6,175,42,133,71,29,175,11,164,90,25
22,154903,NORTH ZULCH ISD,6,english,6,23,3,20,11,5,23,2,21,18,8
22,155901,JEFFERSON ISD,8,english,6,95,49,46,27,10,95,52,43,9,2
22,156902,STANTON ISD,18,english,6,81,22,59,36,21,81,5,76,52,29
22,156905,GRADY ISD,18,english,6,20,0,20,14,9,20,2,18,8,4
22,157901,MASON ISD,15,english,6,44,5,39,27,17,44,5,39,20,7
22,158901,BAY CITY ISD,3,english,6,251,103,148,89,45,251,107,144,61,23
22,158902,TIDEHAVEN ISD,3,english,6,81,13,68,46,27,81,9,72,53,20
22,158904,MATAGORDA ISD,3,english,6,14,3,11,5,3,14,5,9,2,0
22,158905,PALACIOS ISD,3,english,6,88,24,64,35,15,88,25,63,25,8
22,158906,VAN VLECK ISD,3,english,6,75,22,53,38,21,75,11,64,23,7
22,159901,EAGLE PASS ISD,20,english,6,921,257,664,382,182,921,207,714,352,138
22,160901,BRADY ISD,15,english,6,58,22,36,20,12,58,11,47,17,7
22,160904,ROCHELLE ISD,15,english,6,14,1,13,10,7,14,1,13,12,8
22,160905,LOHN ISD,15,english,6,13,7,6,3,1,13,6,7,1,0
22,161802,RAPOPORT ACADEM,12,english,6,66,19,47,17,5,66,23,43,8,1
22,161807,HARMONY PUBLIC,12,english,6,888,254,634,359,198,888,208,680,373,184
22,161901,CRAWFORD ISD,12,english,6,44,3,41,30,14,44,1,43,29,17
22,161903,MIDWAY ISD,12,english,6,635,66,569,406,263,635,48,587,438,259
22,161906,LA VEGA ISD,12,english,6,211,60,151,72,36,209,56,153,65,18
22,161907,LORENA ISD,12,english,6,163,21,142,95,52,165,21,144,80,40
22,161908,MART ISD,12,english,6,38,10,28,16,13,38,7,31,12,8
22,161909,MCGREGOR ISD,12,english,6,115,30,85,47,21,115,20,95,50,16
22,161910,MOODY ISD,12,english,6,42,13,29,18,6,36,10,26,4,0
22,161912,RIESEL ISD,12,english,6,46,8,38,29,17,46,8,38,30,13
22,161914,WACO ISD,12,english,6,942,478,464,221,104,947,452,495,179,61
22,161916,WEST ISD,12,english,6,73,14,59,42,17,73,5,68,50,22
22,161918,AXTELL ISD,12,english,6,56,18,38,25,11,56,10,46,23,7
22,161919,BRUCEVILLE-EDDY,12,english,6,57,18,39,12,4,57,19,38,10,1
22,161920,CHINA SPRING IS,12,english,6,230,34,196,130,83,230,21,209,140,69
22,161921,CONNALLY ISD,12,english,6,172,107,65,25,12,170,101,69,11,0
22,161922,ROBINSON ISD,12,english,6,176,26,150,101,49,176,8,168,111,43
22,161923,BOSQUEVILLE ISD,12,english,6,46,9,37,20,6,46,10,36,14,5
22,161924,HALLSBURG ISD,12,english,6,22,1,21,9,3,22,0,22,16,7
22,161925,GHOLSON ISD,12,english,6,17,4,13,6,4,17,2,15,12,6
22,162904,MCMULLEN COUNTY,2,english,6,19,1,18,14,7,19,1,18,18,14
22,163901,DEVINE ISD,20,english,6,136,46,90,50,20,136,46,90,40,6
22,163902,D'HANIS ISD,20,english,6,25,4,21,12,7,25,5,20,9,4
22,163903,NATALIA ISD,20,english,6,66,34,32,18,8,66,37,29,8,3
22,163904,HONDO ISD,20,english,6,125,46,79,32,13,125,55,70,19,5
22,163908,MEDINA VALLEY I,20,english,6,535,101,434,279,176,534,99,435,270,118
22,164901,MENARD ISD,15,english,6,21,3,18,13,8,20,5,15,7,2
22,165802,MIDLAND ACADEMY,18,english,6,41,5,36,26,11,41,3,38,24,8
22,165901,MIDLAND ISD,18,english,6,1980,601,1379,790,418,1981,502,1479,802,339
22,165902,GREENWOOD ISD,18,english,6,236,59,177,106,56,236,67,169,74,22
22,166901,CAMERON ISD,6,english,6,118,42,76,53,27,93,30,63,15,7
22,166902,GAUSE ISD,6,english,6,15,1,14,12,5,15,1,14,7,5
22,166903,MILANO ISD,6,english,6,26,7,19,13,8,26,4,22,7,2
22,166904,ROCKDALE ISD,6,english,6,111,43,68,37,20,111,23,88,42,12
22,166905,THORNDALE ISD,13,english,6,45,13,32,16,7,45,13,32,15,2
22,166907,BUCKHOLTS ISD,12,english,6,11,5,6,4,2,11,4,7,2,2
22,167901,GOLDTHWAITE ISD,12,english,6,32,5,27,13,8,32,0,32,27,18
22,167902,MULLIN ISD,12,english,6,13,2,11,3,2,13,2,11,8,3
22,167904,PRIDDY ISD,12,english,6,8,1,7,3,0,8,2,6,2,1
22,168901,COLORADO ISD,14,english,6,48,16,32,25,13,48,11,37,16,2
22,168902,LORAINE ISD,14,english,6,10,6,4,2,0,10,8,2,1,0
22,168903,WESTBROOK ISD,14,english,6,21,2,19,13,7,21,1,20,10,4
22,169901,BOWIE ISD,9,english,6,119,49,70,42,15,119,41,78,31,10
22,169902,NOCONA ISD,9,english,6,62,26,36,18,5,62,17,45,14,4
22,169906,GOLD BURG ISD,9,english,6,16,4,12,7,4,16,6,10,4,1
22,169908,MONTAGUE ISD,9,english,6,9,2,7,4,0,9,0,9,8,5
22,169909,PRAIRIE VALLEY,9,english,6,6,2,4,1,1,6,2,4,3,0
22,169910,FORESTBURG ISD,9,english,6,9,0,9,7,2,9,1,8,5,1
22,169911,SAINT JO ISD,9,english,6,25,5,20,12,8,25,3,22,13,7
22,170801,TEXAS SERENITY,6,english,6,41,15,26,12,2,40,24,16,2,0
22,170902,CONROE ISD,6,english,6,5208,1076,4132,2910,1812,5218,777,4441,3053,1787
22,170903,MONTGOMERY ISD,6,english,6,685,97,588,400,218,685,59,626,448,227
22,170904,WILLIS ISD,6,english,6,690,280,410,212,106,691,255,436,166,47
22,170906,MAGNOLIA ISD,6,english,6,1008,242,766,470,258,1007,204,803,457,201
22,170907,SPLENDORA ISD,6,english,6,332,119,213,105,49,334,127,207,69,17
22,170908,NEW CANEY ISD,6,english,6,1324,502,822,456,223,1322,425,897,424,145
22,171901,DUMAS ISD,16,english,6,306,82,224,125,57,306,40,266,143,51
22,171902,SUNRAY COLLEGIA,16,english,6,53,20,33,19,8,53,11,42,16,5
22,172902,DAINGERFIELD-LO,8,english,6,77,45,32,16,5,77,46,31,15,3
22,172905,PEWITT CISD,8,english,6,60,11,49,35,19,60,9,51,31,10
22,173901,MOTLEY COUNTY I,17,english,6,13,3,10,8,5,13,1,12,8,2
22,174901,CHIRENO ISD,7,english,6,26,10,16,11,6,26,9,17,8,5
22,174902,CUSHING ISD,7,english,6,39,12,27,16,9,39,17,22,8,4
22,174903,GARRISON ISD,7,english,6,55,15,40,20,8,52,17,35,13,5
22,174904,NACOGDOCHES ISD,7,english,6,467,197,270,146,71,469,229,240,96,28
22,174906,WODEN ISD,7,english,6,37,7,30,20,6,32,4,28,13,1
22,174908,CENTRAL HEIGHTS,7,english,6,87,9,78,58,34,87,8,79,62,24
22,174909,MARTINSVILLE IS,7,english,6,30,8,22,9,6,30,9,21,7,2
22,174910,ETOILE ISD,7,english,6,12,3,9,7,5,12,2,10,3,0
22,174911,DOUGLASS ISD,7,english,6,36,8,28,17,12,36,5,31,19,8
22,175902,BLOOMING GROVE,12,english,6,60,9,51,26,10,60,13,47,18,1
22,175903,CORSICANA ISD,12,english,6,442,154,288,145,80,442,112,330,166,69
22,175904,DAWSON ISD,12,english,6,41,11,30,18,7,41,7,34,18,5
22,175905,FROST ISD,12,english,6,41,13,28,7,3,41,12,29,7,0
22,175907,KERENS ISD,12,english,6,42,8,34,16,5,42,4,38,14,4
22,175910,MILDRED ISD,12,english,6,57,10,47,34,18,57,9,48,29,11
22,175911,RICE ISD,12,english,6,73,15,58,39,21,73,9,64,43,22
22,176901,BURKEVILLE ISD,5,english,6,11,3,8,2,1,11,5,6,1,0
22,176902,NEWTON ISD,5,english,6,75,20,55,28,14,75,23,52,17,1
22,176903,DEWEYVILLE ISD,5,english,6,33,5,28,17,9,33,12,21,9,2
22,177901,ROSCOE COLLEGIA,14,english,6,522,227,295,120,52,523,295,228,59,12
22,177902,SWEETWATER ISD,14,english,6,147,64,83,42,15,145,60,85,25,3
22,177903,BLACKWELL CISD,14,english,6,12,1,11,8,3,12,1,11,8,2
22,177905,HIGHLAND ISD,14,english,6,17,1,16,13,6,17,1,16,15,6
22,178801,DR M L GARZA-GO,2,english,6,19,7,12,4,1,19,10,9,1,0
22,178807,CORPUS CHRISTI,2,english,6,16,1,15,8,6,16,5,11,4,1
22,178808,SEASHORE CHARTE,2,english,6,52,5,47,32,18,46,8,38,21,2
22,178901,AGUA DULCE ISD,2,english,6,30,9,21,10,5,30,10,20,3,0
22,178902,BISHOP CISD,2,english,6,89,25,64,44,17,91,22,69,36,10
22,178903,CALALLEN ISD,2,english,6,314,83,231,142,71,296,73,223,106,28
22,178904,CORPUS CHRISTI,2,english,6,2287,828,1459,781,398,2249,764,1485,605,175
22,178905,DRISCOLL ISD,2,english,6,32,11,21,12,5,32,10,22,11,4
22,178906,LONDON ISD,2,english,6,121,8,113,83,48,122,5,117,91,45
22,178908,PORT ARANSAS IS,2,english,6,48,6,42,27,10,48,6,42,24,3
22,178909,ROBSTOWN ISD,2,english,6,168,92,76,37,17,168,97,71,18,4
22,178912,TULOSO-MIDWAY I,2,english,6,266,74,192,108,64,266,78,188,90,26
22,178913,BANQUETE ISD,2,english,6,63,15,48,25,11,63,14,49,23,5
22,178914,FLOUR BLUFF ISD,2,english,6,399,93,306,200,122,335,44,291,154,40
22,178915,WEST OSO ISD,2,english,6,153,69,84,43,19,154,77,77,20,0
22,179901,PERRYTON ISD,16,english,6,134,26,108,63,41,134,22,112,50,21
22,180901,BOYS RANCH ISD,16,english,6,10,0,10,4,4,10,3,7,5,1
22,180902,VEGA ISD,16,english,6,24,0,24,19,9,24,1,23,16,9
22,180903,ADRIAN ISD,16,english,6,11,3,8,3,1,11,2,9,1,0
22,180904,WILDORADO ISD,16,english,6,16,0,16,11,5,16,3,13,10,4
22,181901,BRIDGE CITY ISD,5,english,6,230,43,187,134,71,230,31,199,116,35
22,181905,ORANGEFIELD ISD,5,english,6,148,28,120,75,38,148,25,123,56,26
22,181906,WEST ORANGE-COV,5,english,6,183,82,101,49,17,183,92,91,21,6
22,181907,VIDOR ISD,5,english,6,299,94,205,130,70,301,53,248,136,68
22,181908,LITTLE CYPRESS-,5,english,6,223,65,158,89,42,224,55,169,101,38
22,182901,GORDON ISD,11,english,6,17,5,12,5,2,17,3,14,5,1
22,182902,GRAFORD ISD,11,english,6,19,8,11,7,3,19,10,9,2,1
22,182903,MINERAL WELLS I,11,english,6,217,66,151,76,30,217,49,168,89,34
22,182904,SANTO ISD,11,english,6,44,7,37,18,10,44,10,34,16,5
22,182905,STRAWN ISD,11,english,6,12,5,7,2,1,12,5,7,1,0
22,182906,PALO PINTO ISD,11,english,6,9,1,8,6,3,9,0,9,4,3
22,183901,BECKVILLE ISD,7,english,6,50,5,45,32,19,50,6,44,28,11
22,183902,CARTHAGE ISD,7,english,6,183,45,138,92,47,183,39,144,71,23
22,183904,GARY ISD,7,english,6,29,7,22,13,10,29,2,27,13,3
22,184901,POOLVILLE ISD,11,english,6,45,8,37,17,4,45,12,33,13,4
22,184902,SPRINGTOWN ISD,11,english,6,298,106,192,93,33,298,65,233,109,31
22,184903,WEATHERFORD ISD,11,english,6,629,173,456,284,152,632,140,492,232,78
22,184904,MILLSAP ISD,11,english,6,76,14,62,38,27,76,4,72,44,29
22,184907,ALEDO ISD,11,english,6,562,74,488,397,247,563,41,522,386,214
22,184908,PEASTER ISD,11,english,6,130,32,98,61,40,130,39,91,45,19
22,184909,BROCK ISD,11,english,6,153,10,143,112,63,153,15,138,98,33
22,184911,GARNER ISD,11,english,6,27,6,21,12,4,27,6,21,7,0
22,185901,BOVINA ISD,16,english,6,34,12,22,8,5,34,8,26,12,5
22,185902,FARWELL ISD,16,english,6,53,6,47,31,19,53,7,46,34,16
22,185903,FRIONA ISD,16,english,6,63,16,47,27,10,63,7,56,28,3
22,185904,LAZBUDDIE ISD,16,english,6,13,3,10,9,4,13,1,12,7,2
22,186901,BUENA VISTA ISD,18,english,6,17,0,17,11,7,17,0,17,12,2
22,186902,FORT STOCKTON I,18,english,6,138,54,84,47,14,138,55,83,30,5
22,186903,IRAAN-SHEFFIELD,18,english,6,26,10,16,6,1,26,12,14,0,0
22,187901,BIG SANDY ISD,6,english,6,42,14,28,18,7,42,12,30,11,1
22,187903,GOODRICH ISD,6,english,6,16,7,9,4,1,16,7,9,2,1
22,187904,CORRIGAN-CAMDEN,6,english,6,59,17,42,25,12,58,15,43,23,7
22,187906,LEGGETT ISD,6,english,6,12,7,5,1,1,12,8,4,1,0
22,187907,LIVINGSTON ISD,6,english,6,287,111,176,100,46,287,100,187,61,16
22,187910,ONALASKA ISD,6,english,6,91,21,70,46,24,91,8,83,51,24
22,188901,AMARILLO ISD,16,english,6,2208,683,1525,866,436,2210,555,1655,788,302
22,188902,RIVER ROAD ISD,16,english,6,108,32,76,40,18,108,19,89,40,9
22,188903,HIGHLAND PARK I,16,english,6,56,15,41,22,8,56,12,44,17,6
22,188904,BUSHLAND ISD,16,english,6,128,27,101,68,36,128,28,100,49,18
22,189901,MARFA ISD,18,english,6,13,2,11,7,5,13,3,10,5,3
22,189902,PRESIDIO ISD,18,english,6,81,34,47,25,11,81,26,55,24,8
22,190903,RAINS ISD,7,english,6,148,68,80,30,14,147,57,90,28,9
22,191901,CANYON ISD,16,english,6,822,141,681,459,265,822,67,755,536,249
22,192901,REAGAN COUNTY I,18,english,6,54,9,45,32,17,54,15,39,16,6
22,193801,BIG SPRINGS CHA,20,english,6,23,13,10,2,0,23,15,8,3,0
22,193902,LEAKEY ISD,20,english,6,28,5,23,14,6,28,5,23,14,4
22,194902,AVERY ISD,8,english,6,29,6,23,16,6,29,9,20,9,2
22,194903,RIVERCREST ISD,8,english,6,48,16,32,18,10,48,3,45,26,10
22,194904,CLARKSVILLE ISD,8,english,6,27,16,11,1,0,27,18,9,1,0
22,194905,DETROIT ISD,8,english,6,42,19,23,8,3,42,8,34,23,12
22,195901,PECOS-BARSTOW-T,18,english,6,198,86,112,56,24,198,69,129,38,5
22,195902,BALMORHEA ISD,18,english,6,7,4,3,1,0,7,4,3,1,1
22,196901,AUSTWELL-TIVOLI,3,english,6,10,1,9,6,3,10,0,10,9,5
22,196902,WOODSBORO ISD,3,english,6,26,6,20,13,6,26,1,25,10,6
22,196903,REFUGIO ISD,3,english,6,51,21,30,16,6,51,14,37,11,1
22,197902,MIAMI ISD,16,english,6,15,2,13,8,5,15,1,14,7,4
22,198901,BREMOND ISD,6,english,6,43,11,32,16,9,43,11,32,11,3
22,198902,CALVERT ISD,6,english,6,6,3,3,2,1,6,3,3,2,0
22,198903,FRANKLIN ISD,6,english,6,101,14,87,64,40,102,5,97,72,35
22,198905,HEARNE ISD,6,english,6,51,17,34,19,9,51,21,30,15,4
22,198906,MUMFORD ISD,6,english,6,42,1,41,36,22,42,0,42,25,8
22,199901,ROCKWALL ISD,10,english,6,1368,211,1157,822,485,1362,117,1245,893,485
22,199902,ROYSE CITY ISD,10,english,6,577,175,402,242,130,577,152,425,188,59
22,200901,BALLINGER ISD,15,english,6,64,20,44,26,11,65,26,39,16,4
22,200902,MILES ISD,15,english,6,33,3,30,24,12,33,1,32,27,14
22,200904,WINTERS ISD,15,english,6,34,4,30,19,17,34,5,29,23,15
22,200906,OLFEN ISD,15,english,6,12,4,8,3,3,12,1,11,5,1
22,201902,HENDERSON ISD,7,english,6,278,155,123,59,24,279,141,138,61,20
22,201903,LANEVILLE ISD,7,english,6,10,2,8,2,0,10,1,9,6,2
22,201904,LEVERETTS CHAPE,7,english,6,15,4,11,6,3,15,3,12,7,0
22,201907,MOUNT ENTERPRIS,7,english,6,31,10,21,12,5,31,5,26,7,5
22,201908,OVERTON ISD,7,english,6,31,9,22,11,7,31,10,21,9,1
22,201910,TATUM ISD,7,english,6,106,21,85,45,21,105,12,93,48,15
22,201913,CARLISLE ISD,7,english,6,37,11,26,13,7,37,16,21,10,4
22,201914,WEST RUSK COUNT,7,english,6,67,26,41,20,9,67,17,50,23,7
22,202903,HEMPHILL ISD,7,english,6,66,11,55,30,14,66,13,53,26,5
22,202905,WEST SABINE ISD,7,english,6,42,16,26,20,9,42,9,33,13,3
22,203901,SAN AUGUSTINE I,7,english,6,55,40,15,8,3,55,36,19,6,3
22,203902,BROADDUS ISD,7,english,6,21,4,17,8,4,21,3,18,12,3
22,204901,COLDSPRING-OAKH,6,english,6,119,58,61,34,16,119,60,59,17,4
22,204904,SHEPHERD ISD,6,english,6,130,76,54,23,11,130,60,70,25,8
22,205901,ARANSAS PASS IS,2,english,6,108,31,77,44,21,108,40,68,15,2
22,205902,GREGORY-PORTLAN,2,english,6,345,82,263,169,88,345,69,276,163,96
22,205903,INGLESIDE ISD,2,english,6,146,33,113,60,33,146,37,109,45,6
22,205904,MATHIS ISD,2,english,6,106,23,83,42,18,106,29,77,27,6
22,205905,ODEM-EDROY ISD,2,english,6,49,12,37,15,5,49,15,34,9,0
22,205906,SINTON ISD,2,english,6,121,44,77,35,20,119,49,70,22,4
22,205907,TAFT ISD,2,english,6,78,39,39,15,4,78,22,56,19,2
22,206901,SAN SABA ISD,15,english,6,41,12,29,17,7,41,19,22,7,0
22,206902,RICHLAND SPRING,15,english,6,8,1,7,3,1,8,2,6,1,0
22,206903,CHEROKEE ISD,15,english,6,12,0,12,9,5,12,2,10,5,0
22,207901,SCHLEICHER ISD,15,english,6,24,5,19,11,6,24,5,19,13,6
22,208901,HERMLEIGH ISD,14,english,6,22,14,8,6,2,22,11,11,2,1
22,208902,SNYDER ISD,14,english,6,207,110,97,48,21,207,74,133,46,17
22,208903,IRA ISD,14,english,6,22,3,19,17,8,22,2,20,16,6
22,209901,ALBANY ISD,14,english,6,32,7,25,14,5,32,4,28,14,5
22,209902,MORAN ISD,14,english,6,9,4,5,2,2,9,5,4,2,0
22,210901,CENTER ISD,7,english,6,169,52,117,67,33,169,34,135,65,28
22,210902,JOAQUIN ISD,7,english,6,47,4,43,30,11,47,6,41,18,2
22,210903,SHELBYVILLE ISD,7,english,6,62,14,48,34,15,62,11,51,20,4
22,210904,TENAHA ISD,7,english,6,43,10,33,20,10,43,6,37,24,11
22,210905,TIMPSON ISD,7,english,6,42,18,24,7,4,42,10,32,14,4
22,210906,EXCELSIOR ISD,7,english,6,5,2,3,2,1,5,1,4,2,0
22,211902,STRATFORD ISD,16,english,6,37,11,26,18,6,36,15,21,12,2
22,212801,CUMBERLAND ACAD,7,english,6,137,38,99,59,35,137,47,90,35,7
22,212804,UT TYLER UNIVER,7,english,6,71,11,60,50,36,71,7,64,50,22
22,212901,ARP ISD,7,english,6,66,23,43,25,13,66,16,50,14,6
22,212902,BULLARD ISD,7,english,6,215,24,191,132,68,215,25,190,123,51
22,212903,LINDALE ISD,7,english,6,341,53,288,220,159,340,45,295,217,134
22,212904,TROUP ISD,7,english,6,79,12,67,49,32,79,11,68,37,18
22,212905,TYLER ISD,7,english,6,1265,416,849,505,268,1262,364,898,460,182
22,212906,WHITEHOUSE ISD,7,english,6,373,57,316,228,151,374,42,332,239,127
22,212909,CHAPEL HILL ISD,7,english,6,252,128,124,52,26,252,123,129,31,5
22,212910,WINONA ISD,7,english,6,83,26,57,35,20,81,27,54,19,5
22,213801,BRAZOS RIVER CH,11,english,6,12,7,5,2,1,12,5,7,3,0
22,213901,GLEN ROSE ISD,11,english,6,147,20,127,85,54,95,28,67,23,2
22,214901,RIO GRANDE CITY,1,english,6,657,302,355,157,81,657,299,358,116,23
22,214902,SAN ISIDRO ISD,1,english,6,16,1,15,9,4,16,5,11,6,1
22,214903,ROMA ISD,1,english,6,413,171,242,122,50,416,165,251,102,27
22,215901,BRECKENRIDGE IS,14,english,6,95,32,63,34,15,95,18,77,50,20
22,216901,STERLING CITY I,15,english,6,26,9,17,11,6,26,3,23,10,5
22,217901,ASPERMONT ISD,14,english,6,16,4,12,7,4,16,2,14,6,5
22,218901,SONORA ISD,15,english,6,41,4,37,25,13,41,4,37,27,12
22,219901,HAPPY ISD,16,english,6,17,4,13,7,3,17,1,16,9,6
22,219903,TULIA ISD,16,english,6,79,52,27,8,5,80,36,44,12,3
22,219905,KRESS ISD,16,english,6,20,5,15,8,6,20,2,18,9,2
22,220801,TREETOPS SCHOOL,11,english,6,27,4,23,17,9,27,3,24,14,5
22,220802,ARLINGTON CLASS,11,english,6,172,19,153,100,51,172,24,148,76,28
22,220809,FORT WORTH ACAD,11,english,6,87,10,77,55,34,87,12,75,34,20
22,220810,WESTLAKE ACADEM,11,english,6,73,3,70,56,42,73,2,71,58,42
22,220815,CHAPEL HILL ACA,11,english,6,66,22,44,22,13,66,28,38,14,5
22,220817,NEWMAN INTERNAT,11,english,6,226,50,176,94,49,226,62,164,86,40
22,220819,HIGH POINT ACAD,11,english,6,130,33,97,53,24,131,49,82,29,4
22,220901,ARLINGTON ISD,11,english,6,3892,1245,2647,1598,822,3893,1171,2722,1428,593
22,220902,BIRDVILLE ISD,11,english,6,1653,514,1139,671,369,1654,387,1267,666,247
22,220904,EVERMAN ISD,11,english,6,351,167,184,86,29,350,154,196,59,17
22,220905,FORT WORTH ISD,11,english,6,4971,2323,2648,1341,659,4730,2432,2298,710,175
22,220906,GRAPEVINE-COLLE,11,english,6,1049,152,897,667,447,1044,122,922,629,330
22,220907,KELLER ISD,11,english,6,2515,587,1928,1231,662,2527,411,2116,1346,655
22,220908,MANSFIELD ISD,11,english,6,2630,704,1926,1151,578,2632,485,2147,1251,528
22,220910,LAKE WORTH ISD,11,english,6,250,138,112,48,20,249,115,134,33,9
22,220912,CROWLEY ISD,11,english,6,1099,471,628,303,132,1098,553,545,175,47
22,220914,KENNEDALE ISD,11,english,6,189,44,145,98,52,189,46,143,73,21
22,220915,AZLE ISD,11,english,6,525,126,399,235,119,525,93,432,229,98
22,220916,HURST-EULESS-BE,11,english,6,1679,319,1360,906,553,1678,198,1480,1027,557
22,220917,CASTLEBERRY ISD,11,english,6,253,121,132,68,34,253,108,145,30,6
22,220918,EAGLE MT-SAGINA,11,english,6,1686,442,1244,770,401,1683,450,1233,579,210
22,220919,CARROLL ISD,11,english,6,636,20,616,542,377,444,8,436,389,254
22,220920,WHITE SETTLEMEN,11,english,6,498,136,362,211,111,498,146,352,162,53
22,221801,TEXAS COLLEGE P,14,english,6,1230,282,948,562,282,1228,300,928,444,162
22,221901,ABILENE ISD,14,english,6,1040,475,565,278,139,1038,399,639,271,100
22,221904,MERKEL ISD,14,english,6,84,16,68,40,19,86,18,68,28,7
22,221905,TRENT ISD,14,english,6,10,3,7,2,1,10,3,7,3,1
22,221911,JIM NED CISD,14,english,6,108,17,91,63,35,110,12,98,53,23
22,221912,WYLIE ISD,14,english,6,376,66,310,216,134,376,42,334,176,69
22,222901,TERRELL COUNTY,18,english,6,12,1,11,8,4,12,0,12,7,6
22,223901,BROWNFIELD ISD,17,english,6,111,52,59,27,12,111,34,77,14,3
22,223902,MEADOW ISD,17,english,6,24,14,10,3,2,24,13,11,3,1
22,223904,WELLMAN-UNION C,17,english,6,14,3,11,7,4,14,3,11,6,0
22,224901,THROCKMORTON CO,9,english,6,5,3,2,2,1,5,3,2,0,0
22,224902,WOODSON ISD,9,english,6,15,2,13,8,3,15,3,12,6,3
22,225902,MOUNT PLEASANT,8,english,6,349,113,236,124,56,349,86,263,129,43
22,225906,CHAPEL HILL ISD,8,english,6,63,11,52,32,17,61,4,57,35,8
22,225907,HARTS BLUFF ISD,8,english,6,77,15,62,34,21,77,13,64,29,16
22,226801,TEXAS LEADERSHI,15,english,6,323,120,203,95,37,323,120,203,65,18
22,226901,CHRISTOVAL ISD,15,english,6,47,5,42,27,17,47,3,44,30,11
22,226903,SAN ANGELO ISD,15,english,6,993,457,536,281,136,997,395,602,194,41
22,226905,WATER VALLEY IS,15,english,6,29,9,20,9,4,29,8,21,8,2
22,226906,WALL ISD,15,english,6,109,4,105,92,58,109,0,109,90,47
22,226907,GRAPE CREEK ISD,15,english,6,81,40,41,26,11,81,28,53,22,9
22,226908,VERIBEST ISD,15,english,6,18,2,16,8,5,18,5,13,3,0
22,227803,WAYSIDE SCHOOLS,13,english,6,106,47,59,23,10,109,49,60,12,1
22,227804,NYOS CHARTER SC,13,english,6,154,36,118,84,46,154,42,112,56,25
22,227805,TEXAS EMPOWERME,13,english,6,30,9,21,14,4,29,0,29,17,8
22,227806,UNIVERSITY OF T,13,english,6,36,23,13,5,2,35,22,13,5,2
22,227814,CHAPARRAL STAR,13,english,6,30,1,29,24,14,30,1,29,21,9
22,227816,HARMONY PUBLIC,13,english,6,350,126,224,139,66,350,91,259,126,56
22,227817,CEDARS INTERNAT,13,english,6,37,6,31,18,12,37,3,34,19,5
22,227820,KIPP TEXAS PUBL,4,english,6,2675,974,1701,932,449,2675,1100,1575,639,174
22,227821,AUSTIN DISCOVER,13,english,6,23,4,19,12,8,23,11,12,2,0
22,227824,VALERE PUBLIC S,13,english,6,62,34,28,11,2,62,32,30,12,1
22,227825,AUSTIN ACHIEVE,13,english,6,196,111,85,27,10,196,91,105,31,8
22,227826,MONTESSORI FOR,13,english,6,22,12,10,6,2,22,8,14,7,2
22,227829,VALOR PUBLIC SC,13,english,6,126,12,114,84,46,126,6,120,86,44
22,227901,AUSTIN ISD,13,english,6,4827,1645,3182,2159,1345,4587,1713,2874,1506,622
22,227904,PFLUGERVILLE IS,13,english,6,1871,562,1309,817,450,1872,524,1348,722,284
22,227905,TEXAS SCH FOR T,13,english,6,0,,,,,0,,,,
22,227906,TEXAS SCH FOR T,13,english,6,30,20,10,3,1,30,19,11,5,0
22,227907,MANOR ISD,13,english,6,631,275,356,170,73,634,296,338,111,31
22,227909,EANES ISD,13,english,6,608,35,573,445,293,263,9,254,187,63
22,227910,DEL VALLE ISD,13,english,6,785,395,390,183,78,787,391,396,131,31
22,227912,LAGO VISTA ISD,13,english,6,129,32,97,68,35,129,21,108,64,27
22,227913,LAKE TRAVIS ISD,13,english,6,818,120,698,479,282,782,69,713,507,280
22,228901,GROVETON ISD,6,english,6,72,16,56,36,20,72,16,56,30,16
22,228903,TRINITY ISD,6,english,6,88,35,53,20,9,88,33,55,21,8
22,228904,CENTERVILLE ISD,6,english,6,13,2,11,8,4,13,1,12,8,1
22,228905,APPLE SPRINGS I,6,english,6,14,4,10,5,2,14,4,10,5,1
22,229901,COLMESNEIL ISD,5,english,6,39,11,28,19,11,39,8,31,15,3
22,229903,WOODVILLE ISD,5,english,6,103,60,43,19,10,103,66,37,7,0
22,229904,WARREN ISD,5,english,6,83,19,64,38,19,83,15,68,43,17
22,229905,SPURGER ISD,5,english,6,29,4,25,12,8,29,6,23,16,4
22,229906,CHESTER ISD,5,english,6,20,5,15,9,4,20,6,14,6,0
22,230901,BIG SANDY ISD,7,english,6,50,13,37,27,12,50,8,42,28,10
22,230902,GILMER ISD,7,english,6,203,73,130,71,38,203,60,143,75,31
22,230903,ORE CITY ISD,7,english,6,61,16,45,20,7,49,17,32,7,0
22,230904,UNION HILL ISD,7,english,6,15,3,12,7,2,15,5,10,6,3
22,230905,HARMONY ISD,7,english,6,75,9,66,44,22,75,11,64,29,7
22,230906,NEW DIANA ISD,7,english,6,102,14,88,56,30,102,21,81,37,10
22,230908,UNION GROVE ISD,7,english,6,58,6,52,38,28,57,4,53,36,13
22,231901,MCCAMEY ISD,18,english,6,42,20,22,8,4,42,17,25,6,1
22,231902,RANKIN ISD,18,english,6,30,8,22,6,2,30,5,25,11,4
22,232901,KNIPPA ISD,20,english,6,35,4,31,22,10,35,2,33,25,11
22,232902,SABINAL ISD,20,english,6,26,10,16,7,4,26,9,17,6,2
22,232903,UVALDE CISD,20,english,6,275,118,157,78,33,276,124,152,59,19
22,232904,UTOPIA ISD,20,english,6,18,5,13,7,2,18,9,9,4,0
22,233901,SAN FELIPE-DEL,15,english,6,711,243,468,296,148,710,173,537,282,129
22,233903,COMSTOCK ISD,15,english,6,18,6,12,8,5,18,7,11,2,1
22,234801,RANCH ACADEMY,7,english,6,0,,,,,0,,,,
22,234902,CANTON ISD,10,english,6,169,39,130,76,40,169,36,133,45,6
22,234903,EDGEWOOD ISD,7,english,6,75,20,55,38,21,75,18,57,22,9
22,234904,GRAND SALINE IS,7,english,6,102,46,56,36,8,102,30,72,29,7
22,234905,MARTINS MILL IS,7,english,6,39,10,29,22,14,39,4,35,24,12
22,234906,VAN ISD,7,english,6,188,52,136,83,38,188,35,153,69,20
22,234907,WILLS POINT ISD,10,english,6,154,58,96,49,19,154,55,99,43,14
22,234909,FRUITVALE ISD,7,english,6,30,6,24,14,9,30,5,25,15,4
22,235901,BLOOMINGTON ISD,3,english,6,65,38,27,13,7,64,38,26,5,0
22,235902,VICTORIA ISD,3,english,6,876,370,506,303,148,874,378,496,195,69
22,236802,SAM HOUSTON STA,6,english,6,18,0,18,15,12,18,0,18,17,13
22,236901,NEW WAVERLY ISD,6,english,6,87,20,67,37,18,87,18,69,34,11
22,236902,HUNTSVILLE ISD,6,english,6,1311,387,924,529,284,1314,485,829,312,96
22,237902,HEMPSTEAD ISD,4,english,6,111,74,37,15,8,112,83,29,6,1
22,237904,WALLER ISD,4,english,6,633,218,415,233,108,633,194,439,157,38
22,237905,ROYAL ISD,4,english,6,184,75,109,46,13,184,69,115,46,10
22,238902,MONAHANS-WICKET,18,english,6,156,53,103,61,33,156,43,113,50,15
22,238904,GRANDFALLS-ROYA,18,english,6,12,3,9,4,2,12,4,8,4,0
22,239901,BRENHAM ISD,6,english,6,335,94,241,132,65,334,74,260,132,48
22,239903,BURTON ISD,6,english,6,23,1,22,21,18,23,0,23,22,18
22,240901,LAREDO ISD,1,english,6,1304,581,723,366,177,1304,539,765,300,103
22,240903,UNITED ISD,1,english,6,2914,946,1968,1133,569,2899,686,2213,1049,394
22,240904,WEBB CISD,1,english,6,22,3,19,12,8,22,5,17,7,1
22,241901,BOLING ISD,3,english,6,84,38,46,21,12,84,22,62,28,11
22,241902,EAST BERNARD IS,3,english,6,74,6,68,45,23,74,6,68,42,16
22,241903,EL CAMPO ISD,3,english,6,221,69,152,79,41,222,62,160,81,22
22,241904,WHARTON ISD,3,english,6,144,81,63,30,9,143,95,48,23,6
22,241906,LOUISE ISD,3,english,6,45,20,25,9,4,45,9,36,12,4
22,242902,SHAMROCK ISD,16,english,6,21,6,15,8,6,21,5,16,8,0
22,242903,WHEELER ISD,16,english,6,29,8,21,13,7,29,6,23,13,2
22,242905,KELTON ISD,16,english,6,11,4,7,5,2,11,2,9,4,1
22,242906,FORT ELLIOTT CI,16,english,6,12,4,8,2,0,12,1,11,7,0
22,243901,BURKBURNETT ISD,9,english,6,249,83,166,81,40,248,53,195,86,22
22,243902,ELECTRA ISD,9,english,6,40,14,26,16,9,40,4,36,21,6
22,243903,IOWA PARK CISD,9,english,6,135,28,107,71,46,136,28,108,64,25
22,243905,WICHITA FALLS I,9,english,6,892,402,490,255,127,892,305,587,274,100
22,243906,CITY VIEW ISD,9,english,6,93,19,74,48,21,93,15,78,30,7
22,244901,HARROLD ISD,9,english,6,8,2,6,5,4,8,2,6,2,1
22,244903,VERNON ISD,9,english,6,120,66,54,28,12,119,61,58,16,5
22,244905,NORTHSIDE ISD,9,english,6,23,7,16,9,4,23,6,17,6,1
22,245901,LASARA ISD,1,english,6,20,5,15,7,3,20,12,8,1,1
22,245902,LYFORD CISD,1,english,6,97,53,44,19,6,97,62,35,9,0
22,245903,RAYMONDVILLE IS,1,english,6,130,37,93,56,27,131,32,99,48,14
22,245904,SAN PERLITA ISD,1,english,6,16,3,13,9,7,16,2,14,9,2
22,246801,MERIDIAN WORLD,13,english,6,150,13,137,104,64,118,12,106,61,23
22,246802,GOODWATER MONTE,13,english,6,18,2,16,6,2,19,7,12,3,1
22,246902,FLORENCE ISD,13,english,6,78,28,50,35,21,77,25,52,18,4
22,246904,GEORGETOWN ISD,13,english,6,875,335,540,268,116,759,286,473,155,21
22,246905,GRANGER ISD,13,english,6,39,16,23,14,8,38,12,26,8,2
22,246906,HUTTO ISD,13,english,6,689,227,462,252,125,692,241,451,182,57
22,246907,JARRELL ISD,13,english,6,210,95,115,59,19,209,75,134,28,4
22,246908,LIBERTY HILL IS,13,english,6,541,109,432,290,154,540,112,428,232,79
22,246909,ROUND ROCK ISD,13,english,6,3439,679,2760,2050,1361,2934,548,2386,1547,786
22,246911,TAYLOR ISD,13,english,6,220,107,113,50,17,220,102,118,27,2
22,246912,THRALL ISD,13,english,6,54,7,47,32,18,54,4,50,36,17
22,246913,LEANDER ISD,13,english,6,3149,667,2482,1705,1063,3162,438,2724,1735,799
22,246914,COUPLAND ISD,13,english,6,23,4,19,13,8,23,0,23,12,2
22,247901,FLORESVILLE ISD,20,english,6,318,99,219,140,80,318,103,215,81,19
22,247903,LA VERNIA ISD,20,english,6,260,52,208,121,68,259,34,225,116,47
22,247904,POTH ISD,20,english,6,61,8,53,36,25,61,5,56,37,14
22,247906,STOCKDALE ISD,20,english,6,50,16,34,26,10,50,8,42,17,4
22,248901,KERMIT ISD,18,english,6,92,42,50,25,8,92,31,61,22,2
22,248902,WINK-LOVING ISD,18,english,6,30,8,22,17,9,30,4,26,17,6
22,249901,ALVORD ISD,11,english,6,58,8,50,39,26,58,6,52,40,15
22,249902,BOYD ISD,11,english,6,93,29,64,37,12,93,33,60,21,8
22,249903,BRIDGEPORT ISD,11,english,6,146,52,94,54,28,145,41,104,40,7
22,249904,CHICO ISD,11,english,6,54,17,37,22,11,54,17,37,14,4
22,249905,DECATUR ISD,11,english,6,254,65,189,111,58,255,46,209,99,28
22,249906,PARADISE ISD,11,english,6,77,9,68,47,19,77,8,69,42,22
22,249908,SLIDELL ISD,11,english,6,26,12,14,7,4,26,8,18,9,0
22,250902,HAWKINS ISD,7,english,6,62,14,48,30,17,62,9,53,36,18
22,250903,MINEOLA ISD,7,english,6,114,22,92,56,30,114,6,108,64,23
22,250904,QUITMAN ISD,7,english,6,80,19,61,39,16,80,27,53,23,6
22,250905,YANTIS ISD,7,english,6,34,4,30,17,5,34,8,26,10,1
22,250906,ALBA-GOLDEN ISD,7,english,6,59,11,48,28,12,59,17,42,16,2
22,250907,WINNSBORO ISD,7,english,6,121,38,83,46,26,121,31,90,37,10
22,251901,DENVER CITY ISD,17,english,6,127,43,84,42,15,127,34,93,40,8
22,251902,PLAINS ISD,17,english,6,32,18,14,8,3,32,13,19,4,0
22,252901,GRAHAM ISD,9,english,6,164,60,104,52,20,164,30,134,69,25
22,252902,NEWCASTLE ISD,9,english,6,16,4,12,8,5,16,1,15,9,2
22,252903,OLNEY ISD,9,english,6,51,15,36,21,15,51,9,42,28,11
22,253901,ZAPATA COUNTY I,1,english,6,249,132,117,58,25,248,154,94,28,11
22,254901,CRYSTAL CITY IS,20,english,6,127,55,72,26,8,127,42,85,23,3
22,254902,LA PRYOR ISD,20,english,6,46,8,38,14,7,46,13,33,8,1
22,1902,CAYUGA ISD,7,english,7,59,9,50,43,27,59,5,54,39,18
22,1903,ELKHART ISD,7,english,7,100,13,87,67,50,101,24,77,47,21
22,1904,FRANKSTON ISD,7,english,7,65,10,55,42,24,65,21,44,26,6
22,1906,NECHES ISD,7,english,7,21,2,19,12,5,21,2,19,15,7
22,1907,PALESTINE ISD,7,english,7,259,67,192,128,71,259,91,168,89,38
22,1908,WESTWOOD ISD,7,english,7,102,29,73,47,29,81,55,26,6,0
22,1909,SLOCUM ISD,7,english,7,24,1,23,18,15,24,1,23,13,7
22,2901,ANDREWS ISD,18,english,7,320,84,236,151,79,320,104,216,127,59
22,3801,PINEYWOODS COMM,7,english,7,72,4,68,54,37,72,13,59,35,12
22,3902,HUDSON ISD,7,english,7,229,37,192,143,96,229,48,181,118,63
22,3903,LUFKIN ISD,7,english,7,504,142,362,235,149,505,215,290,152,71
22,3904,HUNTINGTON ISD,7,english,7,111,26,85,52,33,111,23,88,54,22
22,3905,DIBOLL ISD,7,english,7,120,28,92,57,33,120,25,95,50,21
22,3906,ZAVALLA ISD,7,english,7,26,4,22,15,12,26,11,15,4,1
22,3907,CENTRAL ISD,7,english,7,107,26,81,54,35,107,35,72,40,13
22,4901,ARANSAS COUNTY,2,english,7,207,48,159,109,77,208,86,122,73,34
22,5901,ARCHER CITY ISD,9,english,7,26,3,23,18,12,26,4,22,17,8
22,5902,HOLLIDAY ISD,9,english,7,100,11,89,71,52,100,15,85,69,36
22,5904,WINDTHORST ISD,9,english,7,37,1,36,27,17,37,2,35,26,11
22,6902,CLAUDE ISD,16,english,7,29,2,27,15,9,29,3,26,13,8
22,7901,CHARLOTTE ISD,20,english,7,35,10,25,11,5,35,21,14,8,0
22,7902,JOURDANTON ISD,20,english,7,135,30,105,78,52,135,29,106,70,36
22,7904,LYTLE ISD,20,english,7,138,35,103,55,35,139,51,88,24,5
22,7905,PLEASANTON ISD,20,english,7,255,37,218,132,75,254,93,161,77,33
22,7906,POTEET ISD,20,english,7,125,30,95,54,27,78,63,15,3,2
22,8901,BELLVILLE ISD,6,english,7,163,39,124,73,46,163,69,94,52,27
22,8902,SEALY ISD,6,english,7,225,56,169,104,63,164,70,94,25,3
22,8903,BRAZOS ISD,6,english,7,69,12,57,39,21,69,13,56,33,14
22,9901,MULESHOE ISD,17,english,7,104,38,66,39,25,104,71,33,11,1
22,10901,MEDINA ISD,20,english,7,16,1,15,10,7,16,4,12,6,0
22,10902,BANDERA ISD,20,english,7,192,55,137,83,51,149,80,69,26,7
22,11901,BASTROP ISD,13,english,7,965,350,615,368,215,615,434,181,43,7
22,11902,ELGIN ISD,13,english,7,360,128,232,151,81,0,,,,
22,11904,SMITHVILLE ISD,13,english,7,139,32,107,65,45,84,59,25,6,2
22,11905,MCDADE ISD,13,english,7,34,5,29,17,12,34,17,17,10,4
22,12901,SEYMOUR ISD,9,english,7,45,3,42,37,24,37,5,32,18,7
22,13901,BEEVILLE ISD,2,english,7,263,55,208,122,83,255,148,107,29,9
22,13902,PAWNEE ISD,2,english,7,14,1,13,10,8,14,4,10,6,1
22,13903,PETTUS ISD,2,english,7,24,1,23,10,7,24,9,15,5,2
22,13905,SKIDMORE-TYNAN,2,english,7,55,5,50,33,21,54,15,39,13,5
22,14803,PRIORITY CHARTE,12,english,7,63,10,53,39,23,63,32,31,11,4
22,14804,ORENDA CHARTER,12,english,7,162,8,154,125,85,159,28,131,75,24
22,14901,ACADEMY ISD,12,english,7,146,28,118,83,59,106,44,62,22,4
22,14902,BARTLETT ISD,13,english,7,24,7,17,10,4,24,14,10,5,0
22,14903,BELTON ISD,12,english,7,1003,189,814,575,388,589,318,271,68,12
22,14905,HOLLAND ISD,12,english,7,44,4,40,25,21,35,6,29,10,1
22,14906,KILLEEN ISD,12,english,7,3023,884,2139,1300,788,2829,1392,1437,557,143
22,14907,ROGERS ISD,12,english,7,50,10,40,28,15,49,17,32,12,7
22,14908,SALADO ISD,12,english,7,169,24,145,108,75,168,43,125,67,29
22,14909,TEMPLE ISD,12,english,7,574,166,408,240,166,568,248,320,169,63
22,14910,TROY ISD,12,english,7,130,16,114,76,44,121,32,89,52,13
22,15802,GEORGE GERVIN A,20,english,7,27,5,22,16,8,27,15,12,5,2
22,15806,LEGACY TRADITIO,20,english,7,17,8,9,4,3,17,9,8,0,0
22,15807,SOUTHWEST PREPA,20,english,7,49,19,30,19,12,49,33,16,4,2
22,15808,INSPIRE ACADEMI,20,english,7,40,9,31,23,17,40,21,19,6,1
22,15809,BEXAR COUNTY AC,20,english,7,20,6,14,6,4,20,14,6,1,0
22,15815,HERITAGE ACADEM,20,english,7,90,25,65,50,37,90,29,61,35,12
22,15822,JUBILEE ACADEMI,20,english,7,537,188,349,187,92,536,357,179,65,23
22,15825,LIGHTHOUSE PUBL,20,english,7,35,17,18,6,3,32,25,7,0,0
22,15827,SCHOOL OF SCIEN,20,english,7,296,33,263,192,124,296,88,208,105,40
22,15828,HARMONY PUBLIC,20,english,7,474,115,359,232,146,472,169,303,159,62
22,15830,BROOKS ACADEMIE,20,english,7,260,52,208,131,73,236,148,88,22,1
22,15831,SCHOOL OF SCIEN,20,english,7,355,44,311,237,173,355,96,259,138,59
22,15834,BASIS TEXAS,20,english,7,255,3,252,238,196,8,0,8,8,8
22,15835,GREAT HEARTS TE,20,english,7,643,35,608,473,329,643,111,532,324,154
22,15836,ELEANOR KOLITZ,20,english,7,33,1,32,27,17,19,6,13,9,6
22,15838,COMPASS ROSE PU,20,english,7,146,35,111,75,48,144,78,66,24,4
22,15840,SAN ANTONIO PRE,20,english,7,57,13,44,23,13,57,39,18,4,0
22,15901,ALAMO HEIGHTS I,20,english,7,349,35,314,259,196,155,68,87,23,2
22,15904,HARLANDALE ISD,20,english,7,888,256,632,350,192,661,388,273,45,6
22,15905,EDGEWOOD ISD,20,english,7,575,232,343,147,79,560,392,168,56,18
22,15906,RANDOLPH FIELD,20,english,7,120,9,111,85,67,64,16,48,26,12
22,15907,SAN ANTONIO ISD,20,english,7,3090,1126,1964,1108,652,3087,1855,1232,477,138
22,15908,SOUTH SAN ANTON,20,english,7,574,250,324,166,93,507,380,127,14,3
22,15909,SOMERSET ISD,20,english,7,280,58,222,150,92,281,81,200,111,56
22,15910,NORTH EAST ISD,20,english,7,4407,896,3511,2555,1785,2706,1324,1382,479,103
22,15911,EAST CENTRAL IS,20,english,7,788,285,503,253,126,8,8,0,0,0
22,15912,SOUTHWEST ISD,20,english,7,1018,262,756,439,266,1018,530,488,201,63
22,15913,LACKLAND ISD,20,english,7,69,6,63,51,36,49,18,31,8,3
22,15914,FT SAM HOUSTON,20,english,7,122,10,112,83,57,123,27,96,57,23
22,15915,NORTHSIDE ISD,20,english,7,7516,1522,5994,4187,2758,4517,2594,1923,507,100
22,15916,JUDSON ISD,20,english,7,1666,437,1229,731,461,1299,814,485,133,24
22,15917,SOUTHSIDE ISD,20,english,7,464,147,317,180,105,466,196,270,138,53
22,16901,JOHNSON CITY IS,13,english,7,53,10,43,34,22,38,16,22,5,0
22,16902,BLANCO ISD,13,english,7,90,13,77,59,42,61,19,42,10,1
22,17901,BORDEN COUNTY I,17,english,7,24,0,24,17,8,24,3,21,16,7
22,18901,CLIFTON ISD,12,english,7,74,3,71,47,35,74,19,55,30,11
22,18902,MERIDIAN ISD,12,english,7,45,6,39,19,13,45,26,19,9,1
22,18903,MORGAN ISD,12,english,7,9,3,6,1,1,9,5,4,1,1
22,18904,VALLEY MILLS IS,12,english,7,41,8,33,23,15,41,18,23,8,2
22,18905,WALNUT SPRINGS,12,english,7,12,3,9,5,4,12,6,6,3,1
22,18906,IREDELL ISD,12,english,7,8,1,7,5,3,8,2,6,5,2
22,18907,KOPPERL ISD,12,english,7,22,2,20,13,8,22,13,9,2,0
22,18908,CRANFILLS GAP I,12,english,7,14,2,12,7,5,14,0,14,9,3
22,19901,DEKALB ISD,8,english,7,61,21,40,23,17,61,19,42,15,6
22,19902,HOOKS ISD,8,english,7,66,8,58,40,23,55,19,36,15,1
22,19903,MAUD ISD,8,english,7,46,5,41,28,21,46,10,36,14,6
22,19905,NEW BOSTON ISD,8,english,7,76,11,65,47,35,76,23,53,34,15
22,19906,REDWATER ISD,8,english,7,97,9,88,60,43,77,15,62,33,4
22,19907,TEXARKANA ISD,8,english,7,503,132,371,233,158,526,215,311,153,50
22,19908,LIBERTY-EYLAU I,8,english,7,148,39,109,54,32,148,92,56,13,2
22,19909,SIMMS ISD,8,english,7,47,7,40,26,18,47,6,41,19,10
22,19911,RED LICK ISD,8,english,7,48,0,48,42,30,48,2,46,34,15
22,19912,PLEASANT GROVE,8,english,7,179,16,163,131,98,180,36,144,94,51
22,19913,HUBBARD ISD,8,english,7,0,,,,,0,,,,
22,19914,LEARY ISD,8,english,7,11,0,11,8,2,11,7,4,0,0
22,20901,ALVIN ISD,4,english,7,2207,408,1799,1279,886,1781,771,1010,442,128
22,20902,ANGLETON ISD,4,english,7,458,98,360,243,144,458,193,265,120,32
22,20904,DANBURY ISD,4,english,7,60,10,50,36,26,61,13,48,27,8
22,20905,BRAZOSPORT ISD,4,english,7,812,221,591,381,228,598,310,288,68,14
22,20906,SWEENY ISD,4,english,7,146,29,117,77,43,151,57,94,44,10
22,20907,COLUMBIA-BRAZOR,4,english,7,237,77,160,99,62,238,85,153,73,30
22,20908,PEARLAND ISD,4,english,7,1713,173,1540,1271,974,1656,315,1341,913,502
22,20910,DAMON ISD,4,english,7,8,4,4,2,2,8,3,5,2,0
22,21803,BRAZOS SCHOOL F,6,english,7,10,2,8,5,5,10,2,8,4,2
22,21901,COLLEGE STATION,6,english,7,1090,196,894,655,475,752,286,466,199,52
22,21902,BRYAN ISD,6,english,7,1097,378,719,420,265,663,481,182,33,9
22,22004,TERLINGUA CSD,18,english,7,10,4,6,2,1,10,5,5,3,1
22,22901,ALPINE ISD,18,english,7,66,8,58,46,31,66,19,47,22,8
22,22902,MARATHON ISD,18,english,7,5,0,5,3,2,5,0,5,1,0
22,22903,SAN VICENTE ISD,18,english,7,0,,,,,0,,,,
22,23902,SILVERTON ISD,16,english,7,18,0,18,12,12,18,3,15,9,6
22,24901,BROOKS COUNTY I,1,english,7,97,30,67,36,18,97,53,44,18,5
22,25901,BANGS ISD,15,english,7,57,10,47,34,16,57,16,41,21,5
22,25902,BROWNWOOD ISD,15,english,7,238,60,178,103,60,238,86,152,84,38
22,25904,BLANKET ISD,15,english,7,14,3,11,8,6,14,7,7,3,2
22,25905,MAY ISD,15,english,7,14,3,11,5,1,13,5,8,3,1
22,25906,ZEPHYR ISD,15,english,7,22,4,18,13,9,22,4,18,8,3
22,25908,BROOKESMITH ISD,15,english,7,17,7,10,5,4,17,9,8,4,2
22,25909,EARLY ISD,15,english,7,101,5,96,77,56,101,10,91,71,35
22,26901,CALDWELL ISD,6,english,7,140,24,116,80,59,140,50,90,57,26
22,26902,SOMERVILLE ISD,6,english,7,42,9,33,20,13,42,13,29,19,7
22,26903,SNOOK ISD,6,english,7,32,8,24,17,11,32,8,24,13,5
22,27903,BURNET CISD,13,english,7,234,60,174,115,75,234,104,130,56,20
22,27904,MARBLE FALLS IS,13,english,7,278,68,210,141,87,189,98,91,16,2
22,28902,LOCKHART ISD,13,english,7,449,148,301,172,100,362,119,243,74,15
22,28903,LULING ISD,13,english,7,109,31,78,51,28,83,46,37,8,2
22,28906,PRAIRIE LEA ISD,13,english,7,21,8,13,7,2,21,15,6,0,0
22,29901,CALHOUN COUNTY,3,english,7,244,72,172,97,56,164,96,68,18,1
22,30901,CROSS PLAINS IS,14,english,7,36,6,30,19,14,36,13,23,14,6
22,30902,CLYDE CISD,14,english,7,111,18,93,69,46,111,28,83,42,17
22,30903,BAIRD ISD,14,english,7,14,3,11,8,6,14,3,11,4,2
22,30906,EULA ISD,14,english,7,39,3,36,26,16,39,9,30,19,9
22,31901,BROWNSVILLE ISD,1,english,7,2785,646,2139,1400,880,2407,1318,1089,333,54
22,31903,HARLINGEN CISD,1,english,7,1245,284,961,637,406,1247,505,742,331,107
22,31905,LA FERIA ISD,1,english,7,229,53,176,103,62,226,105,121,48,17
22,31906,LOS FRESNOS CIS,1,english,7,790,166,624,397,247,789,313,476,245,94
22,31909,POINT ISABEL IS,1,english,7,146,27,119,77,41,146,77,69,19,7
22,31911,RIO HONDO ISD,1,english,7,132,38,94,59,39,132,93,39,11,1
22,31912,SAN BENITO CISD,1,english,7,725,207,518,293,170,695,401,294,99,39
22,31913,SANTA MARIA ISD,1,english,7,51,16,35,16,10,51,35,16,3,2
22,31914,SANTA ROSA ISD,1,english,7,86,23,63,33,19,86,37,49,17,3
22,31916,SOUTH TEXAS ISD,1,english,7,573,21,552,465,370,48,13,35,13,3
22,32902,PITTSBURG ISD,8,english,7,162,29,133,82,55,162,34,128,75,34
22,33901,GROOM ISD,16,english,7,16,1,15,11,8,16,2,14,9,4
22,33902,PANHANDLE ISD,16,english,7,63,5,58,47,37,63,5,58,45,21
22,33904,WHITE DEER ISD,16,english,7,22,3,19,14,10,22,8,14,6,2
22,34901,ATLANTA ISD,8,english,7,117,28,89,49,35,116,44,72,33,14
22,34902,AVINGER ISD,8,english,7,13,3,10,7,4,13,8,5,3,0
22,34903,HUGHES SPRINGS,8,english,7,88,12,76,54,38,88,25,63,34,12
22,34905,LINDEN-KILDARE,8,english,7,49,3,46,31,24,49,12,37,19,8
22,34906,MCLEOD ISD,8,english,7,35,7,28,20,13,35,8,27,15,5
22,34907,QUEEN CITY ISD,8,english,7,70,21,49,31,18,70,28,42,16,9
22,34909,BLOOMBURG ISD,8,english,7,17,0,17,8,3,17,2,15,6,2
22,35901,DIMMITT ISD,16,english,7,94,32,62,31,16,76,39,37,11,1
22,35902,HART ISD,16,english,7,14,0,14,8,6,14,1,13,9,5
22,35903,NAZARETH ISD,16,english,7,18,1,17,13,10,18,0,18,16,6
22,36901,ANAHUAC ISD,4,english,7,112,20,92,57,35,89,26,63,24,1
22,36902,BARBERS HILL IS,4,english,7,535,49,486,401,308,524,52,472,359,217
22,36903,EAST CHAMBERS I,5,english,7,109,19,90,61,48,109,51,58,31,10
22,37901,ALTO ISD,7,english,7,48,11,37,22,16,40,14,26,6,2
22,37904,JACKSONVILLE IS,7,english,7,362,99,263,169,96,363,186,177,86,26
22,37907,RUSK ISD,7,english,7,154,18,136,85,52,154,48,106,50,17
22,37908,NEW SUMMERFIELD,7,english,7,38,7,31,17,4,38,18,20,4,0
22,37909,WELLS ISD,7,english,7,22,4,18,8,2,22,11,11,2,1
22,38901,CHILDRESS ISD,16,english,7,94,17,77,61,41,94,17,77,42,17
22,39902,HENRIETTA ISD,9,english,7,75,8,67,51,32,75,17,58,23,6
22,39903,PETROLIA CISD,9,english,7,36,5,31,22,10,36,14,22,8,1
22,39904,BELLEVUE ISD,9,english,7,17,2,15,7,4,17,5,12,5,1
22,39905,MIDWAY ISD,9,english,7,10,2,8,8,2,10,1,9,3,1
22,40901,MORTON ISD,17,english,7,27,16,11,2,1,27,22,5,2,0
22,40902,WHITEFACE CISD,17,english,7,29,3,26,17,11,29,15,14,8,1
22,41901,BRONTE ISD,15,english,7,14,4,10,7,3,14,6,8,5,2
22,41902,ROBERT LEE ISD,15,english,7,20,6,14,5,2,20,12,8,4,1
22,42901,COLEMAN ISD,15,english,7,67,11,56,43,28,67,24,43,25,11
22,42903,SANTA ANNA ISD,15,english,7,13,2,11,8,5,13,3,10,1,0
22,42905,PANTHER CREEK C,15,english,7,15,2,13,7,4,15,7,8,4,0
22,43801,IMAGINE INTERNA,10,english,7,147,5,142,129,98,111,9,102,70,33
22,43901,ALLEN ISD,10,english,7,1688,162,1526,1282,1009,1680,216,1464,1101,715
22,43902,ANNA ISD,10,english,7,320,54,266,171,120,322,133,189,103,43
22,43903,CELINA ISD,10,english,7,259,14,245,198,147,259,29,230,146,61
22,43904,FARMERSVILLE IS,10,english,7,149,13,136,105,69,150,29,121,61,19
22,43905,FRISCO ISD,10,english,7,5181,320,4861,4223,3435,5109,629,4480,3473,2256
22,43907,MCKINNEY ISD,10,english,7,1870,260,1610,1200,835,1848,412,1436,898,479
22,43908,MELISSA ISD,10,english,7,385,27,358,293,231,407,64,343,233,112
22,43910,PLANO ISD,10,english,7,3765,582,3183,2513,1918,2036,889,1147,445,120
22,43911,PRINCETON ISD,10,english,7,521,106,415,292,204,521,131,390,235,132
22,43912,PROSPER ISD,10,english,7,1728,135,1593,1281,944,1721,273,1448,1012,550
22,43914,WYLIE ISD,10,english,7,1424,126,1298,1067,827,1423,213,1210,857,500
22,43917,BLUE RIDGE ISD,10,english,7,70,12,58,43,28,70,24,46,25,11
22,43918,COMMUNITY ISD,10,english,7,249,82,167,115,70,249,96,153,69,22
22,43919,LOVEJOY ISD,10,english,7,384,6,378,349,294,363,6,357,326,252
22,44902,WELLINGTON ISD,16,english,7,45,6,39,22,13,45,19,26,14,7
22,45902,COLUMBUS ISD,3,english,7,122,16,106,71,43,121,44,77,36,17
22,45903,RICE CISD,3,english,7,79,14,65,41,24,59,41,18,4,1
22,45905,WEIMAR ISD,3,english,7,50,5,45,32,19,50,5,45,30,9
22,46802,TRINITY CHARTER,20,english,7,44,23,21,10,3,44,35,9,4,1
22,46901,NEW BRAUNFELS I,13,english,7,724,108,616,416,265,727,228,499,304,138
22,46902,COMAL ISD,20,english,7,2157,248,1909,1504,1100,2155,400,1755,1170,613
22,47901,COMANCHE ISD,14,english,7,94,18,76,48,25,94,29,65,29,12
22,47902,DE LEON ISD,14,english,7,56,8,48,36,23,56,14,42,28,11
22,47903,GUSTINE ISD,14,english,7,10,1,9,5,2,10,3,7,3,1
22,47905,SIDNEY ISD,14,english,7,11,1,10,8,4,11,3,8,5,1
22,48901,EDEN CISD,15,english,7,15,6,9,7,7,15,7,8,6,2
22,48903,PAINT ROCK ISD,15,english,7,18,8,10,5,2,18,11,7,3,1
22,49901,GAINESVILLE ISD,11,english,7,216,47,169,105,66,216,90,126,52,16
22,49902,MUENSTER ISD,11,english,7,47,5,42,33,19,47,6,41,28,16
22,49903,VALLEY VIEW ISD,11,english,7,82,17,65,36,24,81,28,53,20,8
22,49905,CALLISBURG ISD,11,english,7,68,9,59,42,24,68,14,54,31,10
22,49906,ERA ISD,11,english,7,44,3,41,28,17,44,4,40,21,7
22,49907,LINDSAY ISD,11,english,7,33,0,33,26,15,33,2,31,27,17
22,49908,WALNUT BEND ISD,11,english,7,0,,,,,0,,,,
22,49909,SIVELLS BEND IS,11,english,7,0,,,,,0,,,,
22,50901,EVANT ISD,12,english,7,12,3,9,7,3,12,6,6,0,0
22,50902,GATESVILLE ISD,12,english,7,199,41,158,105,71,163,51,112,56,13
22,50904,OGLESBY ISD,12,english,7,21,4,17,13,6,21,7,14,6,4
22,50909,JONESBORO ISD,12,english,7,26,9,17,5,0,26,18,8,2,0
22,50910,COPPERAS COVE I,12,english,7,613,134,479,322,193,0,,,,
22,51901,PADUCAH ISD,17,english,7,17,2,15,10,4,17,7,10,3,1
22,52901,CRANE ISD,15,english,7,81,18,63,38,26,81,37,44,13,4
22,53001,CROCKETT COUNTY,15,english,7,50,6,44,32,20,50,14,36,19,8
22,54901,CROSBYTON CISD,17,english,7,28,7,21,14,11,28,12,16,5,3
22,54902,LORENZO ISD,17,english,7,19,10,9,3,2,19,7,12,2,1
22,54903,RALLS ISD,17,english,7,41,13,28,13,6,41,27,14,6,0
22,55901,CULBERSON COUNT,18,english,7,39,11,28,14,6,38,24,14,4,1
22,56901,DALHART ISD,16,english,7,125,25,100,67,40,125,43,82,44,20
22,56902,TEXLINE ISD,16,english,7,13,1,12,7,5,13,2,11,8,5
22,57802,PEGASUS SCHOOL,10,english,7,40,14,26,13,7,39,28,11,3,0
22,57803,UPLIFT EDUCATIO,10,english,7,1906,427,1479,962,598,1615,770,845,316,94
22,57806,ADVANTAGE ACADE,10,english,7,108,50,58,34,17,108,80,28,9,2
22,57807,LIFE SCHOOL,10,english,7,423,104,319,195,115,423,197,226,86,32
22,57808,UNIVERSAL ACADE,10,english,7,114,12,102,80,60,114,36,78,51,26
22,57810,ACADEMY OF DALL,10,english,7,19,6,13,8,4,19,14,5,2,1
22,57813,TRINITY BASIN P,10,english,7,398,86,312,194,110,397,157,240,120,48
22,57814,ACADEMY FOR ACA,10,english,7,19,13,6,1,0,21,18,3,1,0
22,57816,A W BROWN LEADE,10,english,7,56,17,39,27,16,56,25,31,10,3
22,57819,JEAN MASSIEU AC,10,english,7,13,2,11,7,5,13,7,6,5,3
22,57827,NOVA ACADEMY SO,10,english,7,59,7,52,35,21,59,25,34,12,3
22,57829,A+ ACADEMY,10,english,7,145,58,87,51,25,145,91,54,18,4
22,57830,INSPIRED VISION,10,english,7,115,45,70,35,15,115,74,41,7,2
22,57831,GATEWAY CHARTER,10,english,7,27,5,22,15,11,27,6,21,7,3
22,57833,EDUCATION CENTE,10,english,7,14,7,7,4,4,14,9,5,2,2
22,57835,GOLDEN RULE CHA,10,english,7,103,27,76,47,27,103,59,44,15,7
22,57836,ST ANTHONY SCHO,10,english,7,29,4,25,21,19,29,9,20,5,2
22,57839,LA ACADEMIA DE,10,english,7,100,26,74,47,31,101,54,47,20,6
22,57841,CITYSCAPE SCHOO,10,english,7,67,23,44,22,11,67,39,28,11,3
22,57844,MANARA ACADEMY,10,english,7,46,4,42,30,20,46,18,28,15,6
22,57845,UME PREPARATORY,10,english,7,108,10,98,78,50,80,16,64,21,7
22,57846,LEGACY PREPARAT,10,english,7,132,32,100,59,36,132,51,81,29,6
22,57847,VILLAGE TECH SC,10,english,7,109,19,90,52,23,109,49,60,20,7
22,57848,INTERNATIONAL L,10,english,7,1845,475,1370,923,623,1700,878,822,353,147
22,57850,PIONEER TECHNOL,10,english,7,263,30,233,160,100,228,101,127,50,12
22,57903,CARROLLTON-FARM,10,english,7,1780,487,1293,840,536,1055,559,496,153,46
22,57904,CEDAR HILL ISD,10,english,7,558,170,388,234,146,435,317,118,29,5
22,57905,DALLAS ISD,10,english,7,9686,2873,6813,4380,2840,4063,2689,1374,316,57
22,57906,DESOTO ISD,10,english,7,584,165,419,261,167,494,333,161,36,5
22,57907,DUNCANVILLE ISD,10,english,7,975,290,685,402,241,806,460,346,93,24
22,57909,GARLAND ISD,10,english,7,3886,969,2917,1918,1259,2867,1692,1175,404,129
22,57910,GRAND PRAIRIE I,10,english,7,2150,566,1584,1025,665,1934,963,971,383,98
22,57911,HIGHLAND PARK I,10,english,7,530,15,515,461,357,291,27,264,162,77
22,57912,IRVING ISD,10,english,7,2409,779,1630,1009,625,2373,1140,1233,545,183
22,57913,LANCASTER ISD,10,english,7,499,142,357,179,91,499,295,204,62,18
22,57914,MESQUITE ISD,10,english,7,3122,954,2168,1348,845,2093,1218,875,239,45
22,57916,RICHARDSON ISD,10,english,7,2792,673,2119,1531,1129,663,463,200,45,11
22,57919,SUNNYVALE ISD,10,english,7,178,13,165,139,98,101,26,75,32,7
22,57922,COPPELL ISD,10,english,7,1076,59,1017,895,746,1064,72,992,826,589
22,58902,DAWSON ISD,17,english,7,13,4,9,5,3,13,10,3,1,1
22,58905,KLONDIKE ISD,17,english,7,19,1,18,15,12,19,1,18,17,7
22,58906,LAMESA ISD,17,english,7,111,39,72,41,25,111,67,44,17,6
22,58909,SANDS CISD,17,english,7,11,0,11,4,2,11,2,9,3,1
22,59901,HEREFORD ISD,16,english,7,294,84,210,124,65,294,130,164,71,19
22,60902,COOPER ISD,8,english,7,59,13,46,29,14,60,20,40,14,2
22,60914,FANNINDEL ISD,8,english,7,14,6,8,4,1,14,10,4,1,0
22,61802,NORTH TEXAS COL,11,english,7,48,15,33,20,10,48,24,24,10,7
22,61804,LEADERSHIP PREP,10,english,7,111,9,102,86,67,60,29,31,10,1
22,61805,TRIVIUM ACADEMY,11,english,7,36,2,34,23,18,35,10,25,16,7
22,61901,DENTON ISD,11,english,7,2338,447,1891,1319,895,2330,925,1405,718,248
22,61902,LEWISVILLE ISD,11,english,7,3701,537,3164,2478,1885,2416,960,1456,633,186
22,61903,PILOT POINT ISD,11,english,7,113,22,91,63,36,113,46,67,27,8
22,61905,KRUM ISD,11,english,7,188,38,150,110,70,188,52,136,72,27
22,61906,PONDER ISD,11,english,7,136,20,116,86,62,136,31,105,65,29
22,61907,AUBREY ISD,11,english,7,246,49,197,140,90,198,74,124,42,8
22,61908,SANGER ISD,11,english,7,198,38,160,112,75,150,56,94,28,7
22,61910,ARGYLE ISD,11,english,7,338,19,319,266,212,265,26,239,159,81
22,61911,NORTHWEST ISD,11,english,7,2139,267,1872,1418,997,1241,558,683,194,35
22,61912,LAKE DALLAS ISD,11,english,7,306,52,254,179,107,306,64,242,137,53
22,61914,LITTLE ELM ISD,11,english,7,665,154,511,333,225,478,262,216,53,10
22,62901,CUERO ISD,3,english,7,156,43,113,65,36,157,71,86,39,14
22,62902,NORDHEIM ISD,3,english,7,11,3,8,6,6,11,4,7,5,3
22,62903,YOAKUM ISD,3,english,7,120,21,99,65,36,121,38,83,32,11
22,62904,YORKTOWN ISD,3,english,7,45,10,35,24,18,45,20,25,13,2
22,62905,WESTHOFF ISD,3,english,7,5,1,4,3,1,5,4,1,0,0
22,62906,MEYERSVILLE ISD,3,english,7,17,0,17,12,8,17,1,16,10,4
22,63903,SPUR ISD,17,english,7,18,3,15,12,8,18,7,11,3,2
22,63906,PATTON SPRINGS,17,english,7,9,2,7,5,3,9,4,5,3,1
22,64903,CARRIZO SPRINGS,20,english,7,132,46,86,47,25,132,62,70,23,7
22,65901,CLARENDON ISD,16,english,7,39,9,30,25,17,39,9,30,20,13
22,65902,HEDLEY ISD,16,english,7,9,2,7,5,4,9,3,6,3,1
22,66901,BENAVIDES ISD,2,english,7,17,3,14,6,4,17,15,2,0,0
22,66902,SAN DIEGO ISD,2,english,7,116,32,84,55,34,116,61,55,26,11
22,66903,FREER ISD,2,english,7,73,16,57,39,21,73,31,42,17,2
22,67902,CISCO ISD,14,english,7,49,2,47,37,27,49,5,44,26,15
22,67903,EASTLAND ISD,14,english,7,88,17,71,45,25,88,28,60,21,2
22,67904,GORMAN ISD,14,english,7,31,17,14,8,5,31,18,13,2,0
22,67907,RANGER ISD,14,english,7,11,6,5,3,1,11,8,3,1,0
22,67908,RISING STAR ISD,14,english,7,16,4,12,7,5,16,9,7,4,1
22,68802,COMPASS ACADEMY,18,english,7,114,8,106,70,44,115,30,85,39,15
22,68803,UTPB STEM ACADE,18,english,7,65,9,56,41,34,44,23,21,8,0
22,68901,ECTOR COUNTY IS,18,english,7,2425,809,1616,937,549,2421,1141,1280,607,243
22,69901,ROCKSPRINGS ISD,15,english,7,13,4,9,6,4,13,7,6,0,0
22,69902,NUECES CANYON C,15,english,7,23,3,20,17,11,25,12,13,5,1
22,70801,WAXAHACHIE FAIT,10,english,7,218,107,111,55,31,217,140,77,27,5
22,70901,AVALON ISD,10,english,7,25,9,16,9,5,25,11,14,4,1
22,70903,ENNIS ISD,10,english,7,414,103,311,201,130,413,160,253,132,43
22,70905,FERRIS ISD,10,english,7,214,46,168,109,61,0,,,,
22,70907,ITALY ISD,10,english,7,40,10,30,18,11,40,18,22,6,0
22,70908,MIDLOTHIAN ISD,10,english,7,844,148,696,497,320,543,181,362,132,22
22,70909,MILFORD ISD,10,english,7,20,4,16,6,4,20,15,5,1,0
22,70910,PALMER ISD,10,english,7,106,24,82,59,44,106,23,83,54,15
22,70911,RED OAK ISD,10,english,7,505,150,355,212,132,388,238,150,45,11
22,70912,WAXAHACHIE ISD,10,english,7,773,159,614,409,292,571,251,320,120,18
22,70915,MAYPEARL ISD,10,english,7,112,21,91,63,44,86,30,56,20,2
22,71801,BURNHAM WOOD CH,19,english,7,134,35,99,69,34,134,43,91,51,24
22,71806,HARMONY PUBLIC,19,english,7,438,63,375,263,163,438,107,331,209,91
22,71809,VISTA DEL FUTUR,19,english,7,26,6,20,14,9,26,14,12,5,3
22,71810,EL PASO LEADERS,19,english,7,61,23,38,20,10,61,28,33,11,5
22,71901,CLINT ISD,19,english,7,802,267,535,326,200,681,407,274,73,13
22,71902,EL PASO ISD,19,english,7,3412,869,2543,1708,1071,3377,1516,1861,857,336
22,71903,FABENS ISD,19,english,7,136,51,85,44,28,136,87,49,17,2
22,71904,SAN ELIZARIO IS,19,english,7,261,100,161,90,50,261,136,125,42,11
22,71905,YSLETA ISD,19,english,7,2810,643,2167,1429,923,1987,1082,905,276,69
22,71906,ANTHONY ISD,19,english,7,75,15,60,29,19,75,20,55,26,9
22,71907,CANUTILLO ISD,19,english,7,406,96,310,210,119,391,183,208,50,13
22,71908,TORNILLO ISD,19,english,7,75,26,49,30,17,75,48,27,4,1
22,71909,SOCORRO ISD,19,english,7,3559,650,2909,1910,1253,3555,1418,2137,917,304
22,72801,PREMIER HIGH SC,11,english,7,0,,,,,0,,,,
22,72802,ERATH EXCELS AC,11,english,7,0,,,,,0,,,,
22,72901,THREE WAY ISD,11,english,7,17,6,11,10,6,17,8,9,3,3
22,72902,DUBLIN ISD,11,english,7,72,8,64,46,35,72,16,56,34,15
22,72903,STEPHENVILLE IS,11,english,7,264,49,215,155,110,264,72,192,108,61
22,72904,BLUFF DALE ISD,11,english,7,14,0,14,10,5,14,2,12,5,2
22,72908,HUCKABAY ISD,11,english,7,24,1,23,16,9,24,1,23,15,5
22,72909,LINGLEVILLE ISD,11,english,7,21,1,20,11,6,21,5,16,6,0
22,72910,MORGAN MILL ISD,11,english,7,11,0,11,10,6,11,1,10,2,2
22,73901,CHILTON ISD,12,english,7,35,2,33,20,15,16,11,5,2,1
22,73903,MARLIN ISD,12,english,7,65,35,30,13,9,65,43,22,9,2
22,73904,WESTPHALIA ISD,12,english,7,16,0,16,12,11,16,1,15,12,7
22,73905,ROSEBUD-LOTT IS,12,english,7,46,9,37,24,13,46,12,34,13,2
22,74903,BONHAM ISD,10,english,7,132,29,103,68,36,109,52,57,15,4
22,74904,DODD CITY ISD,10,english,7,22,1,21,18,14,22,3,19,11,5
22,74905,ECTOR ISD,10,english,7,23,8,15,10,5,23,9,14,6,2
22,74907,HONEY GROVE ISD,8,english,7,46,18,28,20,10,46,10,36,15,6
22,74909,LEONARD ISD,10,english,7,60,10,50,37,29,42,19,23,7,1
22,74911,SAVOY ISD,10,english,7,16,4,12,7,5,16,7,9,3,0
22,74912,TRENTON ISD,10,english,7,43,8,35,25,11,43,12,31,14,3
22,74917,SAM RAYBURN ISD,10,english,7,37,2,35,25,15,37,10,27,7,3
22,75901,FLATONIA ISD,13,english,7,53,5,48,38,29,53,4,49,41,28
22,75902,LA GRANGE ISD,13,english,7,150,29,121,76,47,85,37,48,18,4
22,75903,SCHULENBURG ISD,13,english,7,60,8,52,31,15,62,21,41,22,9
22,75906,FAYETTEVILLE IS,13,english,7,22,1,21,17,11,22,6,16,13,7
22,75908,ROUND TOP-CARMI,13,english,7,20,2,18,16,13,20,2,18,11,8
22,76903,ROBY CISD,14,english,7,27,6,21,13,6,27,15,12,3,1
22,76904,ROTAN ISD,14,english,7,18,1,17,10,8,18,2,16,9,4
22,77901,FLOYDADA COLLEG,17,english,7,52,15,37,23,12,52,29,23,11,3
22,77902,LOCKNEY ISD,17,english,7,28,8,20,9,6,28,17,11,4,0
22,78901,CROWELL ISD,9,english,7,12,1,11,6,5,12,4,8,3,3
22,79901,LAMAR CISD,4,english,7,3065,446,2619,1932,1381,2027,813,1214,458,104
22,79906,NEEDVILLE ISD,4,english,7,263,31,232,178,116,263,42,221,151,71
22,79907,FORT BEND ISD,4,english,7,6076,859,5217,3988,2999,6073,1746,4327,2794,1575
22,79910,STAFFORD MSD,4,english,7,285,75,210,130,85,270,138,132,46,17
22,80901,MOUNT VERNON IS,8,english,7,110,15,95,67,41,110,22,88,48,18
22,81902,FAIRFIELD ISD,12,english,7,145,31,114,74,49,145,66,79,39,22
22,81904,TEAGUE ISD,12,english,7,90,14,76,48,33,90,37,53,26,9
22,81905,WORTHAM ISD,12,english,7,41,8,33,21,15,41,14,27,11,4
22,81906,DEW ISD,12,english,7,9,2,7,5,4,9,3,6,1,0
22,82902,DILLEY ISD,20,english,7,66,23,43,26,10,66,30,36,9,3
22,82903,PEARSALL ISD,20,english,7,148,51,97,53,29,148,101,47,11,5
22,83901,SEAGRAVES ISD,17,english,7,47,17,30,14,7,47,31,16,9,2
22,83902,LOOP ISD,17,english,7,11,0,11,8,6,11,3,8,4,2
22,83903,SEMINOLE ISD,17,english,7,230,56,174,121,82,230,70,160,105,59
22,84802,ODYSSEY ACADEMY,4,english,7,109,29,80,45,25,90,60,30,8,4
22,84804,AMBASSADORS PRE,4,english,7,12,1,11,8,4,12,3,9,5,2
22,84901,DICKINSON ISD,4,english,7,917,207,710,460,284,656,326,330,99,16
22,84902,GALVESTON ISD,4,english,7,477,140,337,221,146,346,208,138,38,10
22,84903,HIGH ISLAND ISD,5,english,7,10,1,9,5,4,10,2,8,3,1
22,84906,TEXAS CITY ISD,4,english,7,608,184,424,227,131,549,319,230,60,17
22,84908,HITCHCOCK ISD,4,english,7,127,33,94,62,40,127,69,58,31,8
22,84909,SANTA FE ISD,4,english,7,343,72,271,177,114,342,154,188,85,24
22,84910,CLEAR CREEK ISD,4,english,7,3124,478,2646,2015,1450,3108,834,2274,1334,622
22,84911,FRIENDSWOOD ISD,4,english,7,476,20,456,387,289,487,46,441,312,153
22,85902,POST ISD,17,english,7,78,21,57,29,15,78,24,54,31,8
22,85903,SOUTHLAND ISD,17,english,7,13,5,8,7,5,13,5,8,2,1
22,86024,DOSS CONSOLIDAT,13,english,7,0,,,,,0,,,,
22,86901,FREDERICKSBURG,13,english,7,242,49,193,140,101,188,71,117,53,16
22,86902,HARPER ISD,13,english,7,39,2,37,31,20,39,7,32,20,10
22,87901,GLASSCOCK COUNT,18,english,7,26,3,23,16,12,26,3,23,19,13
22,88902,GOLIAD ISD,3,english,7,102,16,86,63,46,65,41,24,5,0
22,89901,GONZALES ISD,13,english,7,187,55,132,78,52,187,89,98,44,17
22,89903,NIXON-SMILEY CI,13,english,7,89,16,73,47,34,71,35,36,10,0
22,89905,WAELDER ISD,13,english,7,21,8,13,11,5,21,10,11,3,1
22,90902,LEFORS ISD,16,english,7,13,3,10,3,2,13,7,6,2,1
22,90903,MCLEAN ISD,16,english,7,17,1,16,10,6,17,0,17,12,6
22,90904,PAMPA ISD,16,english,7,272,95,177,96,58,272,135,137,61,19
22,91901,BELLS ISD,10,english,7,56,6,50,44,26,43,2,41,25,11
22,91902,COLLINSVILLE IS,10,english,7,44,10,34,19,11,36,17,19,5,1
22,91903,DENISON ISD,10,english,7,369,80,289,178,115,369,141,228,116,40
22,91905,HOWE ISD,10,english,7,98,13,85,62,42,98,20,78,50,24
22,91906,SHERMAN ISD,10,english,7,549,133,416,247,146,538,255,283,130,45
22,91907,TIOGA ISD,10,english,7,51,7,44,33,18,37,10,27,8,0
22,91908,VAN ALSTYNE ISD,10,english,7,175,17,158,131,96,175,25,150,95,48
22,91909,WHITESBORO ISD,10,english,7,148,25,123,82,56,142,54,88,41,12
22,91910,WHITEWRIGHT ISD,10,english,7,71,6,65,51,39,71,13,58,32,14
22,91913,POTTSBORO ISD,10,english,7,131,21,110,75,45,113,41,72,22,3
22,91914,S AND S CISD,10,english,7,83,19,64,42,24,83,23,60,39,14
22,91917,GUNTER ISD,10,english,7,85,10,75,62,44,85,17,68,35,12
22,91918,TOM BEAN ISD,10,english,7,35,2,33,20,13,31,11,20,12,3
22,92901,GLADEWATER ISD,7,english,7,124,15,109,72,35,107,45,62,21,2
22,92902,KILGORE ISD,7,english,7,304,74,230,154,105,304,140,164,69,24
22,92903,LONGVIEW ISD,7,english,7,599,112,487,332,216,554,185,369,192,76
22,92904,PINE TREE ISD,7,english,7,335,72,263,183,110,281,123,158,58,10
22,92906,SABINE ISD,7,english,7,104,13,91,66,48,104,24,80,45,21
22,92907,SPRING HILL ISD,7,english,7,163,25,138,90,64,118,43,75,30,5
22,92908,WHITE OAK ISD,7,english,7,108,12,96,75,55,70,21,49,22,3
22,93901,ANDERSON-SHIRO,6,english,7,59,8,51,34,19,39,6,33,21,4
22,93903,IOLA ISD,6,english,7,45,3,42,36,30,45,4,41,26,16
22,93904,NAVASOTA ISD,6,english,7,240,76,164,95,59,183,97,86,17,2
22,93905,RICHARDS ISD,6,english,7,24,4,20,12,8,24,10,14,6,1
22,94901,SEGUIN ISD,20,english,7,540,176,364,205,114,398,292,106,24,6
22,94902,SCHERTZ-CIBOLO-,20,english,7,1263,243,1020,674,416,1264,309,955,582,249
22,94903,NAVARRO ISD,20,english,7,162,24,138,92,61,161,39,122,82,38
22,94904,MARION ISD,20,english,7,125,24,101,69,34,125,50,75,33,15
22,95901,ABERNATHY ISD,17,english,7,57,9,48,37,27,57,12,45,26,9
22,95902,COTTON CENTER I,17,english,7,8,0,8,6,4,8,6,2,2,0
22,95903,HALE CENTER ISD,17,english,7,44,6,38,21,11,44,18,26,12,2
22,95904,PETERSBURG ISD,17,english,7,30,6,24,16,12,30,5,25,13,7
22,95905,PLAINVIEW ISD,17,english,7,370,83,287,148,86,370,179,191,79,23
22,96904,MEMPHIS ISD,16,english,7,32,4,28,20,12,32,10,22,16,6
22,96905,TURKEY-QUITAQUE,16,english,7,12,1,11,6,5,12,2,10,4,2
22,97902,HAMILTON ISD,12,english,7,67,12,55,46,32,67,16,51,32,13
22,97903,HICO ISD,12,english,7,54,6,48,38,26,54,15,39,15,4
22,98901,GRUVER ISD,16,english,7,29,3,26,22,14,29,1,28,25,18
22,98903,PRINGLE-MORSE C,16,english,7,10,0,10,8,4,10,0,10,4,3
22,98904,SPEARMAN ISD,16,english,7,50,5,45,30,23,50,11,39,27,18
22,99902,CHILLICOTHE ISD,9,english,7,13,1,12,6,4,13,5,8,4,2
22,99903,QUANAH ISD,9,english,7,37,7,30,17,10,37,11,26,8,5
22,100903,KOUNTZE ISD,5,english,7,94,29,65,40,25,95,36,59,32,12
22,100904,SILSBEE ISD,5,english,7,200,54,146,108,65,131,89,42,5,0
22,100905,HARDIN-JEFFERSO,5,english,7,203,20,183,125,86,163,21,142,73,19
22,100907,LUMBERTON ISD,5,english,7,330,47,283,195,131,330,69,261,156,69
22,100908,WEST HARDIN COU,5,english,7,43,10,33,21,13,43,18,25,12,4
22,101802,SER-NINOS CHART,4,english,7,84,15,69,54,31,84,22,62,28,11
22,101803,ARISTOI CLASSIC,4,english,7,82,6,76,69,48,82,15,67,40,13
22,101804,GEORGE I SANCHE,4,english,7,117,41,76,35,13,117,71,46,8,2
22,101806,RAUL YZAGUIRRE,4,english,7,133,38,95,68,36,133,59,74,40,16
22,101810,ACADEMY OF ACCE,4,english,7,57,10,47,25,18,57,26,31,14,10
22,101811,EXCEL ACADEMY,4,english,7,5,5,0,0,0,6,6,0,0,0
22,101814,THE VARNETT PUB,4,english,7,102,20,82,46,32,102,35,67,36,12
22,101815,ALIEF MONTESSOR,4,english,7,15,1,14,8,6,15,2,13,10,5
22,101819,AMIGOS POR VIDA,4,english,7,49,4,45,34,22,49,8,41,31,18
22,101828,HOUSTON GATEWAY,4,english,7,141,4,137,118,86,141,4,137,116,79
22,101837,CALVIN NELMS CH,4,english,7,48,0,48,37,28,48,9,39,26,13
22,101838,SOUTHWEST SCHOO,4,english,7,91,38,53,26,14,91,59,32,6,1
22,101842,COMQUEST ACADEM,4,english,7,6,1,5,4,2,6,2,4,1,1
22,101845,YES PREP PUBLIC,4,english,7,2142,495,1647,1004,603,2140,728,1412,710,263
22,101846,HARMONY PUBLIC,4,english,7,356,56,300,211,143,356,119,237,133,67
22,101847,BEATRICE MAYES,4,english,7,42,6,36,21,15,42,18,24,10,4
22,101849,ACCELERATED INT,4,english,7,15,2,13,9,4,15,2,13,7,3
22,101853,PROMISE COMMUNI,4,english,7,48,15,33,22,11,48,21,27,13,3
22,101856,DRAW ACADEMY,4,english,7,60,23,37,24,15,60,33,27,12,7
22,101858,HARMONY PUBLIC,4,english,7,540,78,462,343,249,539,133,406,268,150
22,101859,STEP CHARTER SC,4,english,7,40,4,36,24,20,40,8,32,26,18
22,101861,THE RHODES SCHO,4,english,7,38,9,29,17,9,38,16,22,9,3
22,101862,HARMONY PUBLIC,4,english,7,377,30,347,284,207,381,40,341,237,145
22,101864,THE LAWSON ACAD,4,english,7,53,16,37,23,16,53,30,23,5,3
22,101868,THE PRO-VISION,4,english,7,37,15,22,12,7,37,29,8,3,2
22,101870,BETA ACADEMY,4,english,7,80,2,78,69,45,80,13,67,31,10
22,101871,A+ UNLIMITED PO,4,english,7,51,8,43,24,17,51,24,27,15,5
22,101872,ETOILE ACADEMY,4,english,7,96,37,59,36,20,96,48,48,17,5
22,101873,YELLOWSTONE COL,4,english,7,47,10,37,25,11,47,25,22,10,1
22,101874,LEGACY SCHOOL O,4,english,7,45,2,43,41,37,49,34,15,1,1
22,101902,ALDINE ISD,4,english,7,4761,1774,2987,1575,865,4296,2765,1531,458,120
22,101903,ALIEF ISD,4,english,7,2997,1014,1983,1233,751,2950,1319,1631,811,322
22,101905,CHANNELVIEW ISD,4,english,7,720,223,497,309,158,475,320,155,27,6
22,101906,CROSBY ISD,4,english,7,499,138,361,198,118,501,193,308,145,55
22,101907,CYPRESS-FAIRBAN,4,english,7,9115,1263,7852,6050,4352,9077,2582,6495,4064,2127
22,101908,DEER PARK ISD,4,english,7,1006,126,880,644,445,966,166,800,516,193
22,101910,GALENA PARK ISD,4,english,7,1669,407,1262,794,488,1310,631,679,205,55
22,101911,GOOSE CREEK CIS,4,english,7,1869,502,1367,834,524,1871,685,1186,640,281
22,101912,HOUSTON ISD,4,english,7,12692,3154,9538,6624,4488,12142,5605,6537,3222,1413
22,101913,HUMBLE ISD,4,english,7,3868,768,3100,2077,1355,2321,1333,988,265,51
22,101914,KATY ISD,4,english,7,7154,746,6408,5328,4212,3869,1070,2799,1460,507
22,101915,KLEIN ISD,4,english,7,4217,814,3403,2509,1712,4256,1404,2852,1557,707
22,101916,LA PORTE ISD,4,english,7,536,86,450,306,201,385,169,216,47,7
22,101917,PASADENA ISD,4,english,7,3774,971,2803,1669,966,3778,1796,1982,809,254
22,101919,SPRING ISD,4,english,7,2350,726,1624,990,599,2353,1273,1080,428,144
22,101920,SPRING BRANCH I,4,english,7,2490,635,1855,1390,1033,2490,818,1672,1130,682
22,101921,TOMBALL ISD,4,english,7,1655,130,1525,1227,944,1566,219,1347,916,465
22,101924,SHELDON ISD,4,english,7,844,262,582,333,186,845,451,394,118,35
22,101925,HUFFMAN ISD,4,english,7,276,62,214,129,78,196,115,81,18,6
22,102901,KARNACK ISD,7,english,7,13,3,10,3,2,13,5,8,1,0
22,102902,MARSHALL ISD,7,english,7,378,117,261,151,93,379,157,222,111,46
22,102903,WASKOM ISD,7,english,7,66,19,47,30,16,66,26,40,15,5
22,102904,HALLSVILLE ISD,7,english,7,2179,582,1597,981,578,2177,1299,878,350,153
22,102905,HARLETON ISD,7,english,7,51,4,47,34,25,51,3,48,33,11
22,102906,ELYSIAN FIELDS,7,english,7,63,2,61,42,24,63,8,55,40,18
22,103901,CHANNING ISD,16,english,7,17,3,14,9,4,17,2,15,8,4
22,103902,HARTLEY ISD,16,english,7,17,2,15,11,8,17,1,16,12,6
22,104901,HASKELL CISD,14,english,7,45,7,38,28,16,36,18,18,5,0
22,104903,RULE ISD,14,english,7,12,1,11,6,2,12,7,5,1,1
22,104907,PAINT CREEK ISD,14,english,7,0,,,,,0,,,,
22,105803,KI CHARTER ACAD,13,english,7,32,19,13,7,5,30,25,5,1,0
22,105902,SAN MARCOS CISD,13,english,7,570,232,338,187,110,194,46,148,66,24
22,105904,DRIPPING SPRING,13,english,7,618,35,583,465,321,651,63,588,396,156
22,105905,WIMBERLEY ISD,13,english,7,223,19,204,167,125,155,37,118,64,19
22,105906,HAYS CISD,13,english,7,1637,330,1307,920,623,1156,578,578,209,37
22,106901,CANADIAN ISD,16,english,7,60,7,53,37,25,60,12,48,31,12
22,107901,ATHENS ISD,10,english,7,213,51,162,110,71,213,91,122,68,32
22,107902,BROWNSBORO ISD,7,english,7,197,28,169,114,79,197,61,136,72,36
22,107904,CROSS ROADS ISD,7,english,7,41,1,40,30,18,41,3,38,34,16
22,107905,EUSTACE ISD,7,english,7,111,10,101,72,50,111,17,94,61,27
22,107906,MALAKOFF ISD,7,english,7,98,9,89,70,43,98,19,79,48,12
22,107907,TRINIDAD ISD,7,english,7,11,3,8,6,4,11,4,7,5,4
22,107908,MURCHISON ISD,7,english,7,21,4,17,13,7,21,6,15,5,1
22,107910,LAPOYNOR ISD,7,english,7,38,4,34,28,9,38,9,29,16,3
22,108802,HORIZON MONTESS,1,english,7,58,13,45,24,13,58,26,32,11,4
22,108807,IDEA PUBLIC SCH,1,english,7,5755,853,4902,3543,2309,5733,1629,4104,2343,1092
22,108808,VANGUARD ACADEM,1,english,7,365,37,328,242,165,364,133,231,101,44
22,108809,EXCELLENCE IN L,1,english,7,32,10,22,11,6,32,16,16,3,1
22,108902,DONNA ISD,1,english,7,1012,345,667,386,217,980,460,520,245,84
22,108903,EDCOUCH-ELSA IS,1,english,7,321,108,213,130,74,317,191,126,42,11
22,108904,EDINBURG CISD,1,english,7,2392,555,1837,1225,790,2401,1025,1376,619,266
22,108905,HIDALGO ISD,1,english,7,201,54,147,84,48,201,78,123,63,25
22,108906,MCALLEN ISD,1,english,7,1542,273,1269,955,663,1523,561,962,549,265
22,108907,MERCEDES ISD,1,english,7,333,110,223,110,63,336,199,137,42,7
22,108908,MISSION CISD,1,english,7,984,266,718,453,289,969,499,470,185,56
22,108909,PHARR-SAN JUAN-,1,english,7,2094,569,1525,937,570,1949,854,1095,485,157
22,108910,PROGRESO ISD,1,english,7,115,41,74,44,22,115,62,53,16,1
22,108911,SHARYLAND ISD,1,english,7,759,103,656,498,348,716,128,588,382,216
22,108912,LA JOYA ISD,1,english,7,1849,555,1294,762,453,1801,783,1018,490,186
22,108913,WESLACO ISD,1,english,7,1141,291,850,531,329,1140,452,688,362,180
22,108914,LA VILLA ISD,1,english,7,51,18,33,19,11,51,39,12,3,2
22,108915,MONTE ALTO ISD,1,english,7,70,18,52,38,19,70,22,48,25,10
22,108916,VALLEY VIEW ISD,1,english,7,318,71,247,163,111,319,92,227,103,38
22,109901,ABBOTT ISD,12,english,7,22,1,21,15,8,22,2,20,16,7
22,109902,BYNUM ISD,12,english,7,12,2,10,8,6,12,2,10,8,2
22,109903,COVINGTON ISD,12,english,7,21,2,19,14,8,21,12,9,2,0
22,109904,HILLSBORO ISD,12,english,7,121,18,103,70,46,121,25,96,61,31
22,109905,HUBBARD ISD,12,english,7,28,2,26,20,16,28,11,17,9,6
22,109907,ITASCA ISD,12,english,7,58,18,40,18,9,58,32,26,5,2
22,109908,MALONE ISD,12,english,7,16,5,11,6,4,14,7,7,3,0
22,109910,MOUNT CALM ISD,12,english,7,12,1,11,7,3,12,3,9,4,1
22,109911,WHITNEY ISD,12,english,7,118,31,87,52,26,118,32,86,48,18
22,109912,AQUILLA ISD,12,english,7,22,7,15,9,5,22,10,12,6,1
22,109913,BLUM ISD,12,english,7,17,0,17,10,3,17,1,16,7,2
22,109914,PENELOPE ISD,12,english,7,12,5,7,4,1,12,6,6,4,2
22,110901,ANTON ISD,17,english,7,13,3,10,6,3,13,7,6,0,0
22,110902,LEVELLAND ISD,17,english,7,203,39,164,100,44,203,54,149,65,18
22,110905,ROPES ISD,17,english,7,37,3,34,25,16,37,6,31,17,7
22,110906,SMYER ISD,17,english,7,27,2,25,20,12,27,7,20,12,4
22,110907,SUNDOWN ISD,17,english,7,52,5,47,33,19,52,3,49,31,12
22,110908,WHITHARRAL ISD,17,english,7,19,2,17,13,10,19,6,13,11,2
22,111901,GRANBURY ISD,11,english,7,604,104,500,360,223,604,189,415,236,95
22,111902,LIPAN ISD,11,english,7,42,6,36,26,17,42,11,31,17,3
22,111903,TOLAR ISD,11,english,7,68,5,63,40,25,50,10,40,18,4
22,112901,SULPHUR SPRINGS,8,english,7,322,61,261,183,132,240,72,168,76,15
22,112905,CUMBY ISD,8,english,7,32,9,23,15,4,32,13,19,5,2
22,112906,NORTH HOPKINS I,8,english,7,39,8,31,23,14,39,13,26,15,9
22,112907,MILLER GROVE IS,8,english,7,22,3,19,15,12,21,3,18,13,2
22,112908,COMO-PICKTON CI,8,english,7,55,12,43,21,14,55,22,33,14,7
22,112909,SALTILLO ISD,8,english,7,18,1,17,8,3,18,4,14,7,3
22,112910,SULPHUR BLUFF I,8,english,7,18,3,15,12,8,18,6,12,7,2
22,113901,CROCKETT ISD,6,english,7,97,30,67,32,17,97,53,44,11,3
22,113902,GRAPELAND ISD,6,english,7,55,14,41,27,14,55,18,37,20,8
22,113903,LOVELADY ISD,6,english,7,39,2,37,27,21,39,10,29,13,5
22,113905,LATEXO ISD,6,english,7,38,6,32,21,14,29,10,19,8,4
22,113906,KENNARD ISD,6,english,7,20,3,17,14,8,20,5,15,11,1
22,114901,BIG SPRING ISD,18,english,7,253,79,174,93,48,253,120,133,43,12
22,114902,COAHOMA ISD,18,english,7,83,22,61,34,21,83,35,48,16,1
22,114904,FORSAN ISD,18,english,7,59,7,52,34,25,59,14,45,31,13
22,115901,FT HANCOCK ISD,19,english,7,29,7,22,14,7,29,14,15,5,3
22,115902,SIERRA BLANCA I,19,english,7,8,0,8,6,1,8,2,6,1,0
22,115903,DELL CITY ISD,19,english,7,5,2,3,2,1,5,4,1,1,1
22,116901,CADDO MILLS ISD,10,english,7,199,23,176,133,95,199,39,160,88,38
22,116902,CELESTE ISD,10,english,7,30,1,29,23,16,30,6,24,16,8
22,116903,COMMERCE ISD,10,english,7,106,33,73,39,25,79,59,20,3,0
22,116905,GREENVILLE ISD,10,english,7,362,143,219,123,73,268,177,91,22,2
22,116906,LONE OAK ISD,10,english,7,86,22,64,51,34,87,27,60,30,15
22,116908,QUINLAN ISD,10,english,7,198,43,155,105,71,160,63,97,35,10
22,116909,WOLFE CITY ISD,10,english,7,48,4,44,30,20,48,10,38,24,9
22,116910,CAMPBELL ISD,10,english,7,20,4,16,9,6,20,9,11,4,1
22,116915,BLAND ISD,10,english,7,77,12,65,44,31,77,20,57,33,12
22,116916,BOLES ISD,10,english,7,48,8,40,22,14,45,16,29,9,2
22,117901,BORGER ISD,16,english,7,165,37,128,93,62,165,44,121,61,22
22,117903,SANFORD-FRITCH,16,english,7,60,15,45,32,20,53,21,32,15,4
22,117904,PLEMONS-STINNET,16,english,7,40,5,35,23,14,40,16,24,15,2
22,117907,SPRING CREEK IS,16,english,7,10,2,8,5,3,10,7,3,0,0
22,118902,IRION COUNTY IS,15,english,7,18,2,16,12,9,18,1,17,10,5
22,119901,BRYSON ISD,9,english,7,19,5,14,8,6,19,10,9,7,2
22,119902,JACKSBORO ISD,9,english,7,89,19,70,42,34,88,33,55,31,10
22,119903,PERRIN-WHITT CI,9,english,7,22,4,18,13,8,22,5,17,10,3
22,120901,EDNA ISD,3,english,7,95,17,78,53,31,95,26,69,43,23
22,120902,GANADO ISD,3,english,7,61,8,53,35,21,61,28,33,15,3
22,120905,INDUSTRIAL ISD,3,english,7,75,4,71,55,36,75,7,68,46,27
22,121902,BROOKELAND ISD,5,english,7,41,3,38,28,22,41,2,39,24,10
22,121903,BUNA ISD,5,english,7,110,20,90,67,36,110,33,77,32,11
22,121904,JASPER ISD,5,english,7,154,50,104,62,29,154,81,73,35,13
22,121905,KIRBYVILLE CISD,5,english,7,119,21,98,68,49,119,17,102,66,33
22,121906,EVADALE ISD,5,english,7,23,4,19,12,9,22,4,18,7,2
22,122901,FT DAVIS ISD,18,english,7,13,3,10,6,3,13,5,8,1,0
22,122902,VALENTINE ISD,18,english,7,0,,,,,0,,,,
22,123803,TEKOA ACADEMY O,5,english,7,17,5,12,9,6,17,11,6,2,0
22,123805,EHRHART SCHOOL,5,english,7,56,11,45,37,15,56,23,33,6,3
22,123807,BOB HOPE SCHOOL,5,english,7,184,31,153,105,73,184,46,138,83,47
22,123905,NEDERLAND ISD,5,english,7,363,43,320,247,172,363,77,286,181,82
22,123907,PORT ARTHUR ISD,5,english,7,527,196,331,172,87,527,333,194,58,11
22,123908,PORT NECHES-GRO,5,english,7,400,76,324,224,138,354,139,215,88,24
22,123910,BEAUMONT ISD,5,english,7,1222,491,731,390,229,1075,874,201,36,4
22,123913,SABINE PASS ISD,5,english,7,40,4,36,30,23,40,7,33,18,9
22,123914,HAMSHIRE-FANNET,5,english,7,153,34,119,77,52,128,64,64,15,1
22,124901,JIM HOGG COUNTY,1,english,7,91,27,64,38,25,91,46,45,21,8
22,125901,ALICE ISD,2,english,7,351,106,245,128,85,353,214,139,47,19
22,125902,BEN BOLT-PALITO,2,english,7,35,10,25,18,13,35,22,13,4,0
22,125903,ORANGE GROVE IS,2,english,7,130,20,110,84,54,130,53,77,36,17
22,125905,PREMONT ISD,2,english,7,38,6,32,16,8,38,13,25,8,6
22,126901,ALVARADO ISD,11,english,7,276,64,212,140,77,182,98,84,16,2
22,126902,BURLESON ISD,11,english,7,996,199,797,575,394,978,314,664,344,111
22,126903,CLEBURNE ISD,11,english,7,527,140,387,237,137,442,237,205,66,9
22,126904,GRANDVIEW ISD,11,english,7,94,14,80,67,40,94,14,80,51,18
22,126905,JOSHUA ISD,11,english,7,453,62,391,307,210,454,96,358,212,94
22,126906,KEENE ISD,11,english,7,81,11,70,50,36,81,24,57,30,8
22,126907,RIO VISTA ISD,11,english,7,60,8,52,37,22,61,35,26,6,2
22,126908,VENUS ISD,11,english,7,169,57,112,61,35,139,88,51,7,1
22,126911,GODLEY ISD,11,english,7,193,52,141,86,49,193,78,115,42,12
22,127901,ANSON ISD,14,english,7,51,10,41,30,18,51,20,31,18,8
22,127903,HAMLIN COLLEGIA,14,english,7,31,13,18,13,7,31,14,17,5,1
22,127904,HAWLEY ISD,14,english,7,62,7,55,40,23,62,16,46,18,3
22,127905,LUEDERS-AVOCA I,14,english,7,9,5,4,3,2,9,5,4,2,1
22,127906,STAMFORD ISD,14,english,7,47,12,35,17,10,47,12,35,19,10
22,128901,KARNES CITY ISD,20,english,7,74,16,58,36,24,74,30,44,27,9
22,128902,KENEDY ISD,3,english,7,54,10,44,28,15,53,25,28,15,3
22,128903,RUNGE ISD,3,english,7,14,6,8,3,2,14,10,4,2,1
22,128904,FALLS CITY ISD,20,english,7,28,3,25,19,12,28,2,26,21,14
22,129901,CRANDALL ISD,10,english,7,434,90,344,233,140,434,183,251,104,33
22,129902,FORNEY ISD,10,english,7,1234,296,938,670,449,908,489,419,105,17
22,129903,KAUFMAN ISD,10,english,7,354,86,268,181,114,354,144,210,115,53
22,129904,KEMP ISD,10,english,7,139,47,92,52,30,139,72,67,27,7
22,129905,MABANK ISD,10,english,7,290,43,247,177,124,199,71,128,71,20
22,129906,TERRELL ISD,10,english,7,373,132,241,129,71,374,212,162,52,21
22,129910,SCURRY-ROSSER I,10,english,7,88,11,77,54,42,88,8,80,53,20
22,130801,MEADOWLAND CHAR,20,english,7,0,,,,,0,,,,
22,130901,BOERNE ISD,20,english,7,868,84,784,642,472,865,108,757,547,282
22,130902,COMFORT ISD,13,english,7,82,9,73,49,33,82,27,55,24,5
22,132902,JAYTON-GIRARD I,17,english,7,11,0,11,9,7,11,0,11,4,1
22,133901,CENTER POINT IS,20,english,7,24,6,18,13,9,24,10,14,9,3
22,133902,HUNT ISD,20,english,7,23,3,20,13,10,13,3,10,3,0
22,133903,KERRVILLE ISD,20,english,7,359,74,285,203,137,357,156,201,102,43
22,133904,INGRAM ISD,20,english,7,82,12,70,40,29,83,28,55,24,9
22,134901,JUNCTION ISD,15,english,7,49,12,37,23,9,50,20,30,17,10
22,135001,GUTHRIE CSD,17,english,7,10,0,10,8,6,10,2,8,4,0
22,136901,BRACKETT ISD,20,english,7,38,5,33,19,11,29,17,12,2,0
22,137901,KINGSVILLE ISD,2,english,7,196,88,108,43,21,198,135,63,25,5
22,137902,RICARDO ISD,2,english,7,66,8,58,49,34,66,18,48,19,5
22,137903,RIVIERA ISD,2,english,7,40,1,39,27,20,40,15,25,14,1
22,137904,SANTA GERTRUDIS,2,english,7,53,4,49,41,29,53,6,47,32,17
22,138902,KNOX CITY-O'BRI,9,english,7,22,8,14,10,4,22,3,19,10,5
22,138903,MUNDAY CISD,9,english,7,24,6,18,11,6,24,13,11,5,2
22,138904,BENJAMIN ISD,9,english,7,10,1,9,5,3,10,3,7,3,1
22,139905,CHISUM ISD,8,english,7,80,13,67,49,34,80,12,68,43,23
22,139909,PARIS ISD,8,english,7,265,88,177,115,66,265,119,146,60,21
22,139911,NORTH LAMAR ISD,8,english,7,160,30,130,80,44,162,36,126,72,22
22,139912,PRAIRILAND ISD,8,english,7,68,4,64,50,21,66,10,56,23,12
22,140901,AMHERST ISD,17,english,7,7,1,6,4,2,7,5,2,1,0
22,140904,LITTLEFIELD ISD,17,english,7,83,25,58,36,16,83,40,43,19,4
22,140905,OLTON ISD,17,english,7,55,11,44,30,14,55,25,30,6,4
22,140907,SPRINGLAKE-EART,17,english,7,29,8,21,16,6,29,8,21,8,3
22,140908,SUDAN ISD,17,english,7,37,1,36,26,17,37,6,31,14,4
22,141901,LAMPASAS ISD,12,english,7,242,39,203,145,98,173,61,112,41,7
22,141902,LOMETA ISD,12,english,7,18,5,13,7,2,18,10,8,1,1
22,142901,COTULLA ISD,20,english,7,99,19,80,55,36,98,25,73,41,17
22,143901,HALLETTSVILLE I,3,english,7,85,22,63,50,30,85,28,57,30,18
22,143902,MOULTON ISD,3,english,7,21,2,19,15,11,21,1,20,12,5
22,143903,SHINER ISD,3,english,7,47,3,44,31,20,46,5,41,26,13
22,143904,VYSEHRAD ISD,3,english,7,15,0,15,10,6,15,2,13,8,5
22,143905,SWEET HOME ISD,3,english,7,13,2,11,11,9,13,2,11,7,2
22,143906,EZZELL ISD,3,english,7,9,4,5,4,4,9,3,6,4,3
22,144901,GIDDINGS ISD,13,english,7,155,23,132,97,65,129,56,73,32,9
22,144902,LEXINGTON ISD,13,english,7,97,16,81,57,31,77,18,59,32,10
22,144903,DIME BOX ISD,13,english,7,12,2,10,8,3,13,9,4,3,1
22,145901,BUFFALO ISD,6,english,7,72,14,58,45,29,72,20,52,29,11
22,145902,CENTERVILLE ISD,6,english,7,53,5,48,36,21,53,18,35,14,5
22,145906,NORMANGEE ISD,6,english,7,50,15,35,22,11,50,18,32,13,4
22,145907,OAKWOOD ISD,6,english,7,11,3,8,4,3,11,4,7,3,0
22,145911,LEON ISD,6,english,7,55,10,45,37,18,55,8,47,32,17
22,146901,CLEVELAND ISD,4,english,7,958,407,551,292,156,958,520,438,152,52
22,146902,DAYTON ISD,4,english,7,478,165,313,173,90,479,246,233,92,27
22,146903,DEVERS ISD,4,english,7,22,0,22,20,18,22,0,22,16,13
22,146904,HARDIN ISD,5,english,7,125,29,96,60,32,125,66,59,15,4
22,146905,HULL-DAISETTA I,5,english,7,30,8,22,16,8,30,15,15,4,0
22,146906,LIBERTY ISD,5,english,7,176,33,143,87,55,176,85,91,35,12
22,146907,TARKINGTON ISD,4,english,7,130,31,99,62,37,122,37,85,44,16
22,147901,COOLIDGE ISD,12,english,7,21,4,17,9,4,21,4,17,4,2
22,147902,GROESBECK ISD,12,english,7,136,35,101,67,36,136,51,85,44,14
22,147903,MEXIA ISD,12,english,7,120,37,83,42,29,120,61,59,20,5
22,148901,BOOKER ISD,16,english,7,32,6,26,21,16,32,13,19,10,2
22,148902,FOLLETT ISD,16,english,7,15,3,12,10,3,15,6,9,7,4
22,148905,DARROUZETT ISD,16,english,7,7,3,4,2,1,7,3,4,2,1
22,149901,GEORGE WEST ISD,2,english,7,73,5,68,58,43,64,17,47,23,5
22,149902,THREE RIVERS IS,2,english,7,48,6,42,27,16,48,19,29,10,3
22,150901,LLANO ISD,13,english,7,134,21,113,85,58,102,15,87,50,15
22,152504,TEXAS TECH UNIV,17,english,7,19,1,18,14,12,15,3,12,9,4
22,152802,RISE ACADEMY,17,english,7,15,2,13,11,10,15,2,13,9,5
22,152901,LUBBOCK ISD,17,english,7,1940,577,1363,885,597,1937,834,1103,543,231
22,152902,NEW DEAL ISD,17,english,7,63,15,48,35,24,63,21,42,15,5
22,152903,SLATON ISD,17,english,7,109,29,80,48,26,109,34,75,36,12
22,152906,LUBBOCK-COOPER,17,english,7,613,81,532,385,279,612,134,478,295,156
22,152907,FRENSHIP ISD,17,english,7,809,120,689,490,343,809,265,544,291,138
22,152908,ROOSEVELT ISD,17,english,7,84,30,54,29,16,84,55,29,10,3
22,152909,SHALLOWATER ISD,17,english,7,115,10,105,82,61,115,12,103,76,33
22,152910,IDALOU ISD,17,english,7,90,12,78,56,39,90,13,77,53,30
22,153903,O'DONNELL ISD,17,english,7,29,4,25,15,4,29,11,18,10,3
22,153904,TAHOKA ISD,17,english,7,43,8,35,23,12,43,7,36,21,5
22,153905,NEW HOME ISD,17,english,7,47,1,46,36,30,47,7,40,28,14
22,153907,WILSON ISD,17,english,7,10,3,7,4,3,10,6,4,3,1
22,154901,MADISONVILLE CI,6,english,7,183,35,148,94,59,183,43,140,82,32
22,154903,NORTH ZULCH ISD,6,english,7,27,6,21,15,11,27,4,23,15,4
22,155901,JEFFERSON ISD,8,english,7,95,29,66,37,17,82,58,24,13,1
22,156902,STANTON ISD,18,english,7,88,28,60,44,25,74,48,26,9,2
22,156905,GRADY ISD,18,english,7,21,1,20,16,12,21,1,20,13,6
22,157901,MASON ISD,15,english,7,50,9,41,36,29,50,10,40,28,14
22,158901,BAY CITY ISD,3,english,7,264,65,199,112,81,264,102,162,72,25
22,158902,TIDEHAVEN ISD,3,english,7,78,9,69,57,37,57,17,40,17,2
22,158904,MATAGORDA ISD,3,english,7,8,0,8,6,4,8,5,3,3,0
22,158905,PALACIOS ISD,3,english,7,107,23,84,49,26,107,57,50,24,4
22,158906,VAN VLECK ISD,3,english,7,83,8,75,65,43,82,14,68,39,17
22,159901,EAGLE PASS ISD,20,english,7,971,281,690,412,248,973,490,483,193,66
22,160901,BRADY ISD,15,english,7,60,12,48,31,21,60,14,46,27,13
22,160904,ROCHELLE ISD,15,english,7,20,1,19,16,13,20,1,19,18,16
22,160905,LOHN ISD,15,english,7,9,4,5,3,3,9,5,4,1,0
22,161802,RAPOPORT ACADEM,12,english,7,61,8,53,32,23,61,28,33,14,9
22,161807,HARMONY PUBLIC,12,english,7,935,171,764,535,380,911,343,568,316,140
22,161901,CRAWFORD ISD,12,english,7,50,1,49,39,33,50,5,45,36,27
22,161903,MIDWAY ISD,12,english,7,644,76,568,420,323,643,152,491,318,164
22,161906,LA VEGA ISD,12,english,7,214,48,166,88,47,213,115,98,20,5
22,161907,LORENA ISD,12,english,7,144,17,127,100,73,144,36,108,61,27
22,161908,MART ISD,12,english,7,50,2,48,30,17,38,19,19,7,2
22,161909,MCGREGOR ISD,12,english,7,104,21,83,48,26,104,20,84,42,21
22,161910,MOODY ISD,12,english,7,54,13,41,22,12,58,26,32,14,3
22,161912,RIESEL ISD,12,english,7,57,10,47,32,24,40,22,18,8,1
22,161914,WACO ISD,12,english,7,938,374,564,300,171,936,594,342,147,60
22,161916,WEST ISD,12,english,7,97,14,83,60,42,79,15,64,26,8
22,161918,AXTELL ISD,12,english,7,66,16,50,31,20,48,23,25,11,3
22,161919,BRUCEVILLE-EDDY,12,english,7,52,13,39,25,18,52,18,34,16,7
22,161920,CHINA SPRING IS,12,english,7,226,26,200,161,111,226,39,187,98,34
22,161921,CONNALLY ISD,12,english,7,174,63,111,56,32,142,109,33,6,1
22,161922,ROBINSON ISD,12,english,7,218,35,183,137,94,183,54,129,64,24
22,161923,BOSQUEVILLE ISD,12,english,7,53,3,50,35,22,42,8,34,14,4
22,161925,GHOLSON ISD,12,english,7,25,6,19,8,6,25,15,10,4,2
22,162904,MCMULLEN COUNTY,2,english,7,20,0,20,13,9,20,2,18,10,3
22,163901,DEVINE ISD,20,english,7,158,35,123,77,44,138,84,54,11,1
22,163902,D'HANIS ISD,20,english,7,25,3,22,13,9,25,9,16,9,4
22,163903,NATALIA ISD,20,english,7,91,29,62,31,12,92,37,55,16,5
22,163904,HONDO ISD,20,english,7,138,36,102,58,37,138,61,77,28,10
22,163908,MEDINA VALLEY I,20,english,7,556,81,475,352,250,555,132,423,275,122
22,164901,MENARD ISD,15,english,7,20,3,17,9,7,21,9,12,7,4
22,165802,MIDLAND ACADEMY,18,english,7,17,1,16,14,8,14,3,11,4,1
22,165901,MIDLAND ISD,18,english,7,1994,600,1394,897,556,1498,884,614,162,33
22,165902,GREENWOOD ISD,18,english,7,242,46,196,135,87,168,73,95,33,5
22,166901,CAMERON ISD,6,english,7,129,28,101,63,38,136,43,93,49,18
22,166902,GAUSE ISD,6,english,7,14,1,13,10,5,14,1,13,5,2
22,166903,MILANO ISD,6,english,7,22,4,18,14,7,20,5,15,5,0
22,166904,ROCKDALE ISD,6,english,7,113,31,82,49,28,113,48,65,28,11
22,166905,THORNDALE ISD,13,english,7,57,10,47,32,22,28,15,13,0,0
22,166907,BUCKHOLTS ISD,12,english,7,7,7,0,0,0,7,7,0,0,0
22,167901,GOLDTHWAITE ISD,12,english,7,40,4,36,29,21,40,4,36,28,16
22,167902,MULLIN ISD,12,english,7,0,,,,,0,,,,
22,167904,PRIDDY ISD,12,english,7,9,1,8,6,3,9,0,9,5,3
22,168901,COLORADO ISD,14,english,7,60,11,49,33,16,61,24,37,11,3
22,168902,LORAINE ISD,14,english,7,12,3,9,4,3,12,11,1,1,0
22,168903,WESTBROOK ISD,14,english,7,20,3,17,10,6,20,8,12,4,0
22,169901,BOWIE ISD,9,english,7,142,31,111,77,47,130,71,59,17,3
22,169902,NOCONA ISD,9,english,7,74,15,59,39,23,67,24,43,17,4
22,169906,GOLD BURG ISD,9,english,7,9,3,6,3,2,9,6,3,3,0
22,169908,MONTAGUE ISD,9,english,7,11,1,10,10,7,11,1,10,9,7
22,169909,PRAIRIE VALLEY,9,english,7,7,0,7,5,3,7,1,6,5,4
22,169910,FORESTBURG ISD,9,english,7,12,0,12,11,5,12,3,9,6,2
22,169911,SAINT JO ISD,9,english,7,21,1,20,11,4,21,10,11,5,2
22,170801,TEXAS SERENITY,6,english,7,38,8,30,12,8,38,20,18,9,3
22,170902,CONROE ISD,6,english,7,5352,821,4531,3390,2442,3334,1186,2148,927,237
22,170903,MONTGOMERY ISD,6,english,7,750,87,663,519,377,538,98,440,289,114
22,170904,WILLIS ISD,6,english,7,689,174,515,316,199,543,325,218,57,8
22,170906,MAGNOLIA ISD,6,english,7,1082,229,853,613,421,1080,371,709,381,184
22,170907,SPLENDORA ISD,6,english,7,372,94,278,160,96,280,152,128,25,7
22,170908,NEW CANEY ISD,6,english,7,1342,322,1020,651,420,1343,498,845,470,191
22,171901,DUMAS ISD,16,english,7,333,70,263,163,101,332,109,223,109,41
22,171902,SUNRAY COLLEGIA,16,english,7,52,7,45,28,20,52,18,34,9,1
22,172902,DAINGERFIELD-LO,8,english,7,78,34,44,20,12,73,45,28,4,1
22,172905,PEWITT CISD,8,english,7,71,9,62,33,16,71,24,47,18,5
22,173901,MOTLEY COUNTY I,17,english,7,11,3,8,7,4,11,2,9,5,2
22,174901,CHIRENO ISD,7,english,7,22,3,19,13,5,22,4,18,10,3
22,174902,CUSHING ISD,7,english,7,49,9,40,29,14,49,21,28,8,2
22,174903,GARRISON ISD,7,english,7,46,8,38,26,21,32,10,22,6,1
22,174904,NACOGDOCHES ISD,7,english,7,438,111,327,214,126,436,219,217,107,50
22,174906,WODEN ISD,7,english,7,46,1,45,35,25,47,8,39,29,6
22,174908,CENTRAL HEIGHTS,7,english,7,91,3,88,77,64,91,4,87,73,36
22,174909,MARTINSVILLE IS,7,english,7,28,3,25,19,12,28,9,19,10,5
22,174910,ETOILE ISD,7,english,7,11,0,11,6,5,11,2,9,4,1
22,174911,DOUGLASS ISD,7,english,7,31,3,28,21,15,31,10,21,18,8
22,175902,BLOOMING GROVE,12,english,7,77,19,58,41,26,77,23,54,28,11
22,175903,CORSICANA ISD,12,english,7,457,136,321,201,129,456,166,290,151,63
22,175904,DAWSON ISD,12,english,7,47,11,36,26,13,47,14,33,22,9
22,175905,FROST ISD,12,english,7,34,8,26,18,14,34,7,27,13,3
22,175907,KERENS ISD,12,english,7,41,11,30,21,15,41,18,23,9,4
22,175910,MILDRED ISD,12,english,7,68,6,62,45,31,68,10,58,38,24
22,175911,RICE ISD,12,english,7,94,31,63,29,15,93,34,59,30,11
22,176901,BURKEVILLE ISD,5,english,7,19,5,14,8,4,19,7,12,4,2
22,176902,NEWTON ISD,5,english,7,86,21,65,32,19,87,39,48,18,7
22,176903,DEWEYVILLE ISD,5,english,7,43,9,34,26,19,43,22,21,10,4
22,177901,ROSCOE COLLEGIA,14,english,7,43,6,37,28,16,43,16,27,12,3
22,177902,SWEETWATER ISD,14,english,7,139,44,95,64,42,127,68,59,23,3
22,177903,BLACKWELL CISD,14,english,7,15,2,13,10,6,15,5,10,4,0
22,177905,HIGHLAND ISD,14,english,7,16,2,14,9,5,16,0,16,12,7
22,178801,DR M L GARZA-GO,2,english,7,19,1,18,12,7,19,9,10,5,4
22,178807,CORPUS CHRISTI,2,english,7,12,4,8,4,4,11,8,3,0,0
22,178808,SEASHORE CHARTE,2,english,7,47,0,47,41,29,47,1,46,32,7
22,178901,AGUA DULCE ISD,2,english,7,33,3,30,19,14,33,8,25,11,4
22,178902,BISHOP CISD,2,english,7,127,17,110,76,50,127,27,100,57,30
22,178903,CALALLEN ISD,2,english,7,338,44,294,222,165,329,77,252,153,53
22,178904,CORPUS CHRISTI,2,english,7,2438,590,1848,1170,701,2055,1064,991,332,83
22,178905,DRISCOLL ISD,2,english,7,18,1,17,12,7,18,2,16,9,6
22,178906,LONDON ISD,2,english,7,111,3,108,89,72,102,6,96,72,36
22,178908,PORT ARANSAS IS,2,english,7,32,1,31,23,15,32,5,27,21,6
22,178909,ROBSTOWN ISD,2,english,7,183,76,107,62,35,183,111,72,23,8
22,178912,TULOSO-MIDWAY I,2,english,7,259,36,223,160,97,260,90,170,85,29
22,178913,BANQUETE ISD,2,english,7,70,8,62,38,20,70,11,59,35,16
22,178914,FLOUR BLUFF ISD,2,english,7,454,39,415,317,221,445,58,387,261,134
22,178915,WEST OSO ISD,2,english,7,143,44,99,48,22,143,94,49,15,4
22,179901,PERRYTON ISD,16,english,7,143,22,121,91,60,112,38,74,28,8
22,180901,BOYS RANCH ISD,16,english,7,12,4,8,4,2,12,6,6,4,0
22,180902,VEGA ISD,16,english,7,33,2,31,24,17,33,4,29,20,5
22,180903,ADRIAN ISD,16,english,7,9,0,9,5,2,9,4,5,1,1
22,180904,WILDORADO ISD,16,english,7,13,2,11,7,4,13,1,12,6,1
22,181901,BRIDGE CITY ISD,5,english,7,230,30,200,146,114,188,63,125,55,18
22,181905,ORANGEFIELD ISD,5,english,7,147,13,134,87,56,147,33,114,63,17
22,181906,WEST ORANGE-COV,5,english,7,161,41,120,70,32,161,93,68,24,5
22,181907,VIDOR ISD,5,english,7,321,79,242,157,109,321,123,198,82,29
22,181908,LITTLE CYPRESS-,5,english,7,271,56,215,131,79,221,96,125,48,11
22,182901,GORDON ISD,11,english,7,21,4,17,13,7,21,6,15,8,4
22,182902,GRAFORD ISD,11,english,7,16,5,11,6,5,16,4,12,6,1
22,182903,MINERAL WELLS I,11,english,7,236,64,172,105,62,197,111,86,18,1
22,182904,SANTO ISD,11,english,7,40,5,35,20,10,40,10,30,15,3
22,182905,STRAWN ISD,11,english,7,13,8,5,2,0,13,5,8,1,0
22,183901,BECKVILLE ISD,7,english,7,58,7,51,45,34,58,7,51,42,25
22,183902,CARTHAGE ISD,7,english,7,207,45,162,99,63,207,81,126,67,25
22,183904,GARY ISD,7,english,7,47,12,35,19,11,47,20,27,13,4
22,184901,POOLVILLE ISD,11,english,7,59,6,53,35,24,48,20,28,6,0
22,184902,SPRINGTOWN ISD,11,english,7,296,65,231,152,102,296,99,197,70,19
22,184903,WEATHERFORD ISD,11,english,7,597,118,479,338,215,598,182,416,220,81
22,184904,MILLSAP ISD,11,english,7,71,9,62,44,24,71,8,63,54,31
22,184907,ALEDO ISD,11,english,7,559,44,515,436,331,291,90,201,81,26
22,184908,PEASTER ISD,11,english,7,124,23,101,68,48,78,31,47,12,2
22,184909,BROCK ISD,11,english,7,143,7,136,117,99,142,21,121,84,38
22,184911,GARNER ISD,11,english,7,22,5,17,12,9,22,7,15,6,3
22,185901,BOVINA ISD,16,english,7,41,11,30,22,11,41,18,23,9,3
22,185902,FARWELL ISD,16,english,7,47,4,43,29,25,47,6,41,26,16
22,185903,FRIONA ISD,16,english,7,79,23,56,35,16,79,38,41,20,5
22,185904,LAZBUDDIE ISD,16,english,7,9,1,8,2,1,9,2,7,2,0
22,186901,BUENA VISTA ISD,18,english,7,17,3,14,13,9,17,2,15,9,3
22,186902,FORT STOCKTON I,18,english,7,198,58,140,82,48,197,94,103,55,22
22,186903,IRAAN-SHEFFIELD,18,english,7,23,4,19,14,9,23,11,12,5,3
22,187901,BIG SANDY ISD,6,english,7,40,6,34,23,11,40,16,24,11,6
22,187903,GOODRICH ISD,6,english,7,20,3,17,9,5,20,10,10,6,2
22,187904,CORRIGAN-CAMDEN,6,english,7,66,12,54,42,24,66,28,38,20,6
22,187906,LEGGETT ISD,6,english,7,19,7,12,6,5,19,10,9,2,0
22,187907,LIVINGSTON ISD,6,english,7,304,84,220,131,78,304,148,156,66,22
22,187910,ONALASKA ISD,6,english,7,97,11,86,54,32,96,28,68,32,10
22,188901,AMARILLO ISD,16,english,7,2296,508,1788,1181,756,1699,791,908,275,63
22,188902,RIVER ROAD ISD,16,english,7,120,32,88,55,37,94,50,44,14,1
22,188903,HIGHLAND PARK I,16,english,7,68,19,49,35,19,49,26,23,5,0
22,188904,BUSHLAND ISD,16,english,7,122,5,117,97,75,122,14,108,63,21
22,189901,MARFA ISD,18,english,7,24,2,22,16,9,17,6,11,4,1
22,189902,PRESIDIO ISD,18,english,7,55,12,43,22,13,55,21,34,17,10
22,190903,RAINS ISD,7,english,7,130,29,101,60,24,130,50,80,28,6
22,191901,CANYON ISD,16,english,7,848,105,743,540,377,848,129,719,485,242
22,192901,REAGAN COUNTY I,18,english,7,55,6,49,33,26,55,15,40,25,7
22,193801,BIG SPRINGS CHA,20,english,7,24,6,18,3,1,24,17,7,1,0
22,193902,LEAKEY ISD,20,english,7,22,6,16,10,9,22,4,18,12,6
22,194902,AVERY ISD,8,english,7,23,4,19,14,10,23,3,20,11,2
22,194903,RIVERCREST ISD,8,english,7,54,4,50,36,21,54,4,50,33,11
22,194904,CLARKSVILLE ISD,8,english,7,50,23,27,12,5,49,33,16,4,1
22,194905,DETROIT ISD,8,english,7,40,16,24,16,8,40,13,27,14,6
22,195901,PECOS-BARSTOW-T,18,english,7,224,60,164,84,46,224,120,104,33,9
22,195902,BALMORHEA ISD,18,english,7,11,4,7,3,1,11,6,5,1,0
22,196901,AUSTWELL-TIVOLI,3,english,7,8,0,8,4,3,8,2,6,4,0
22,196902,WOODSBORO ISD,3,english,7,29,5,24,16,10,29,10,19,8,2
22,196903,REFUGIO ISD,3,english,7,42,8,34,22,15,42,13,29,14,5
22,197902,MIAMI ISD,16,english,7,13,1,12,10,5,13,1,12,8,5
22,198901,BREMOND ISD,6,english,7,36,7,29,16,8,36,9,27,8,1
22,198902,CALVERT ISD,6,english,7,10,2,8,2,0,10,7,3,0,0
22,198903,FRANKLIN ISD,6,english,7,93,5,88,67,48,91,5,86,64,41
22,198905,HEARNE ISD,6,english,7,56,26,30,11,7,58,41,17,3,0
22,198906,MUMFORD ISD,6,english,7,39,1,38,36,29,39,1,38,30,16
22,199901,ROCKWALL ISD,10,english,7,1352,156,1196,944,678,635,252,383,155,37
22,199902,ROYSE CITY ISD,10,english,7,599,134,465,314,217,596,182,414,222,82
22,200901,BALLINGER ISD,15,english,7,62,9,53,32,18,62,28,34,17,5
22,200902,MILES ISD,15,english,7,40,6,34,25,11,40,12,28,14,7
22,200904,WINTERS ISD,15,english,7,32,8,24,15,10,32,14,18,8,5
22,200906,OLFEN ISD,15,english,7,15,3,12,5,4,15,3,12,7,3
22,201902,HENDERSON ISD,7,english,7,233,70,163,98,60,233,76,157,73,26
22,201903,LANEVILLE ISD,7,english,7,8,4,4,2,2,8,4,4,1,0
22,201904,LEVERETTS CHAPE,7,english,7,18,4,14,8,3,18,9,9,3,2
22,201907,MOUNT ENTERPRIS,7,english,7,37,7,30,19,14,37,19,18,3,1
22,201908,OVERTON ISD,7,english,7,49,10,39,27,16,49,24,25,16,2
22,201910,TATUM ISD,7,english,7,118,25,93,61,35,118,38,80,42,15
22,201913,CARLISLE ISD,7,english,7,50,12,38,28,16,48,16,32,13,4
22,201914,WEST RUSK COUNT,7,english,7,83,7,76,59,46,83,17,66,36,12
22,202903,HEMPHILL ISD,7,english,7,73,8,65,47,28,72,25,47,20,4
22,202905,WEST SABINE ISD,7,english,7,38,13,25,16,8,38,17,21,8,2
22,203901,SAN AUGUSTINE I,7,english,7,52,28,24,14,5,52,36,16,4,1
22,203902,BROADDUS ISD,7,english,7,30,2,28,17,11,30,4,26,22,10
22,204901,COLDSPRING-OAKH,6,english,7,108,35,73,37,21,108,57,51,16,4
22,204904,SHEPHERD ISD,6,english,7,172,56,116,62,38,172,76,96,43,15
22,205901,ARANSAS PASS IS,2,english,7,121,25,96,57,30,121,70,51,9,0
22,205902,GREGORY-PORTLAN,2,english,7,400,86,314,212,142,301,147,154,51,11
22,205903,INGLESIDE ISD,2,english,7,146,34,112,76,50,146,44,102,51,22
22,205904,MATHIS ISD,2,english,7,100,12,88,63,41,100,30,70,39,13
22,205905,ODEM-EDROY ISD,2,english,7,54,13,41,24,13,54,25,29,16,6
22,205906,SINTON ISD,2,english,7,155,27,128,81,53,116,71,45,12,2
22,205907,TAFT ISD,2,english,7,63,17,46,29,18,64,32,32,15,6
22,206901,SAN SABA ISD,15,english,7,59,13,46,28,17,59,16,43,25,11
22,206902,RICHLAND SPRING,15,english,7,8,1,7,3,2,8,3,5,1,0
22,206903,CHEROKEE ISD,15,english,7,11,0,11,7,5,11,1,10,4,1
22,207901,SCHLEICHER ISD,15,english,7,43,7,36,27,18,31,11,20,11,5
22,208901,HERMLEIGH ISD,14,english,7,23,8,15,11,5,23,19,4,2,0
22,208902,SNYDER ISD,14,english,7,176,63,113,60,36,175,93,82,32,14
22,208903,IRA ISD,14,english,7,28,4,24,21,14,28,7,21,12,3
22,209901,ALBANY ISD,14,english,7,40,6,34,16,5,40,15,25,6,1
22,209902,MORAN ISD,14,english,7,9,4,5,5,4,9,4,5,1,0
22,210901,CENTER ISD,7,english,7,191,31,160,98,54,191,56,135,74,29
22,210902,JOAQUIN ISD,7,english,7,55,2,53,41,23,55,9,46,20,7
22,210903,SHELBYVILLE ISD,7,english,7,56,6,50,34,22,56,10,46,21,10
22,210904,TENAHA ISD,7,english,7,39,10,29,15,4,39,12,27,10,2
22,210905,TIMPSON ISD,7,english,7,49,11,38,26,17,48,12,36,16,4
22,210906,EXCELSIOR ISD,7,english,7,7,0,7,5,2,7,2,5,3,1
22,211902,STRATFORD ISD,16,english,7,46,3,43,36,30,46,9,37,24,15
22,212801,CUMBERLAND ACAD,7,english,7,148,20,128,77,51,134,38,96,39,10
22,212804,UT TYLER UNIVER,7,english,7,77,4,73,61,45,77,16,61,42,22
22,212901,ARP ISD,7,english,7,70,18,52,35,20,57,31,26,4,1
22,212902,BULLARD ISD,7,english,7,223,15,208,173,122,223,19,204,142,78
22,212903,LINDALE ISD,7,english,7,333,16,317,262,207,332,22,310,234,148
22,212904,TROUP ISD,7,english,7,85,7,78,64,46,62,18,44,18,2
22,212905,TYLER ISD,7,english,7,1293,301,992,684,462,939,521,418,151,34
22,212906,WHITEHOUSE ISD,7,english,7,362,36,326,260,188,231,39,192,123,36
22,212909,CHAPEL HILL ISD,7,english,7,259,68,191,124,80,202,110,92,24,2
22,212910,WINONA ISD,7,english,7,76,8,68,57,43,76,24,52,29,11
22,213801,BRAZOS RIVER CH,11,english,7,14,10,4,1,1,16,12,4,2,0
22,213901,GLEN ROSE ISD,11,english,7,156,19,137,100,65,160,39,121,55,13
22,214901,RIO GRANDE CITY,1,english,7,642,193,449,258,154,641,325,316,133,50
22,214902,SAN ISIDRO ISD,1,english,7,17,2,15,9,4,17,6,11,3,0
22,214903,ROMA ISD,1,english,7,419,125,294,179,109,420,132,288,152,67
22,215901,BRECKENRIDGE IS,14,english,7,101,24,77,48,31,101,30,71,39,23
22,216901,STERLING CITY I,15,english,7,40,9,31,22,15,40,5,35,21,7
22,217901,ASPERMONT ISD,14,english,7,11,2,9,8,4,11,5,6,3,1
22,218901,SONORA ISD,15,english,7,60,11,49,30,21,60,20,40,24,10
22,219901,HAPPY ISD,16,english,7,20,2,18,12,7,20,2,18,13,4
22,219903,TULIA ISD,16,english,7,68,27,41,18,11,70,41,29,16,4
22,219905,KRESS ISD,16,english,7,23,5,18,11,3,23,8,15,5,0
22,220801,TREETOPS SCHOOL,11,english,7,31,1,30,20,15,31,5,26,16,5
22,220802,ARLINGTON CLASS,11,english,7,155,7,148,122,95,155,31,124,71,31
22,220809,FORT WORTH ACAD,11,english,7,85,2,83,70,54,65,23,42,16,4
22,220810,WESTLAKE ACADEM,11,english,7,72,4,68,63,49,0,,,,
22,220815,CHAPEL HILL ACA,11,english,7,80,13,67,40,21,80,44,36,13,4
22,220817,NEWMAN INTERNAT,11,english,7,238,35,203,135,86,204,115,89,30,8
22,220819,HIGH POINT ACAD,11,english,7,99,18,81,52,33,83,48,35,9,0
22,220901,ARLINGTON ISD,11,english,7,4045,1123,2922,1939,1280,3980,1853,2127,1054,431
22,220902,BIRDVILLE ISD,11,english,7,1702,344,1358,953,617,1701,524,1177,722,355
22,220904,EVERMAN ISD,11,english,7,463,138,325,194,108,463,262,201,82,25
22,220905,FORT WORTH ISD,11,english,7,5286,1852,3434,2011,1216,3966,2922,1044,211,34
22,220906,GRAPEVINE-COLLE,11,english,7,1104,115,989,831,648,549,202,347,143,54
22,220907,KELLER ISD,11,english,7,2591,338,2253,1739,1244,1746,647,1099,468,125
22,220908,MANSFIELD ISD,11,english,7,2806,417,2389,1749,1196,2804,782,2022,1213,586
22,220910,LAKE WORTH ISD,11,english,7,292,115,177,79,36,230,171,59,11,1
22,220912,CROWLEY ISD,11,english,7,1188,336,852,556,323,890,620,270,50,7
22,220914,KENNEDALE ISD,11,english,7,220,59,161,110,58,161,92,69,17,1
22,220915,AZLE ISD,11,english,7,554,105,449,303,192,491,171,320,133,34
22,220916,HURST-EULESS-BE,11,english,7,1735,207,1528,1157,813,1736,299,1437,957,507
22,220917,CASTLEBERRY ISD,11,english,7,278,72,206,132,93,194,121,73,9,1
22,220918,EAGLE MT-SAGINA,11,english,7,1755,366,1389,964,636,1238,645,593,176,35
22,220919,CARROLL ISD,11,english,7,684,18,666,611,537,684,30,654,571,423
22,220920,WHITE SETTLEMEN,11,english,7,509,111,398,259,165,506,181,325,145,58
22,221801,TEXAS COLLEGE P,14,english,7,1148,160,988,694,470,984,339,645,344,133
22,221901,ABILENE ISD,14,english,7,1032,321,711,426,263,1033,517,516,197,81
22,221904,MERKEL ISD,14,english,7,69,15,54,41,27,69,35,34,8,0
22,221905,TRENT ISD,14,english,7,13,3,10,4,2,13,11,2,2,0
22,221911,JIM NED CISD,14,english,7,0,,,,,147,22,125,78,33
22,221912,WYLIE ISD,14,english,7,399,25,374,307,248,399,39,360,248,131
22,222901,TERRELL COUNTY,18,english,7,12,2,10,7,5,12,5,7,3,3
22,223901,BROWNFIELD ISD,17,english,7,131,47,84,38,20,131,80,51,15,8
22,223902,MEADOW ISD,17,english,7,20,6,14,8,5,20,14,6,3,0
22,223904,WELLMAN-UNION C,17,english,7,20,4,16,10,5,20,7,13,6,2
22,224901,THROCKMORTON CO,9,english,7,17,0,17,9,5,17,9,8,6,0
22,224902,WOODSON ISD,9,english,7,13,2,11,10,7,13,1,12,8,1
22,225902,MOUNT PLEASANT,8,english,7,391,93,298,178,96,392,133,259,108,27
22,225906,CHAPEL HILL ISD,8,english,7,89,11,78,53,35,89,15,74,34,10
22,225907,HARTS BLUFF ISD,8,english,7,61,5,56,39,26,61,16,45,27,13
22,226801,TEXAS LEADERSHI,15,english,7,323,86,237,141,88,323,170,153,75,28
22,226901,CHRISTOVAL ISD,15,english,7,41,3,38,32,18,41,6,35,17,5
22,226903,SAN ANGELO ISD,15,english,7,1066,328,738,471,305,1073,543,530,224,76
22,226905,WATER VALLEY IS,15,english,7,29,5,24,12,5,29,10,19,9,2
22,226906,WALL ISD,15,english,7,93,5,88,76,56,93,5,88,69,41
22,226907,GRAPE CREEK ISD,15,english,7,99,30,69,44,15,99,44,55,17,4
22,226908,VERIBEST ISD,15,english,7,28,2,26,19,11,28,14,14,7,0
22,227622,TEXAS JUVENILE,13,english,7,0,,,,,0,,,,
22,227803,WAYSIDE SCHOOLS,13,english,7,96,42,54,26,15,0,,,,
22,227804,NYOS CHARTER SC,13,english,7,80,10,70,51,35,23,12,11,0,0
22,227805,TEXAS EMPOWERME,13,english,7,31,11,20,12,5,28,6,22,9,3
22,227806,UNIVERSITY OF T,13,english,7,56,30,26,14,8,56,40,16,6,4
22,227814,CHAPARRAL STAR,13,english,7,28,1,27,26,24,25,2,23,20,15
22,227816,HARMONY PUBLIC,13,english,7,321,78,243,170,109,321,107,214,113,42
22,227817,CEDARS INTERNAT,13,english,7,33,4,29,19,14,33,5,28,16,4
22,227820,KIPP TEXAS PUBL,4,english,7,2635,573,2062,1357,842,2633,1210,1423,576,201
22,227821,AUSTIN DISCOVER,13,english,7,32,8,24,16,12,32,15,17,2,0
22,227824,VALERE PUBLIC S,13,english,7,49,14,35,25,18,49,24,25,8,3
22,227825,AUSTIN ACHIEVE,13,english,7,152,60,92,53,26,152,84,68,23,8
22,227829,VALOR PUBLIC SC,13,english,7,120,10,110,89,69,70,27,43,22,7
22,227901,AUSTIN ISD,13,english,7,5067,1240,3827,2782,2025,3434,1918,1516,649,248
22,227904,PFLUGERVILLE IS,13,english,7,1829,395,1434,1014,704,1082,626,456,141,33
22,227905,TEXAS SCH FOR T,13,english,7,0,,,,,0,,,,
22,227906,TEXAS SCH FOR T,13,english,7,29,20,9,5,1,29,22,7,3,0
22,227907,MANOR ISD,13,english,7,514,207,307,152,72,533,385,148,26,4
22,227909,EANES ISD,13,english,7,598,18,580,523,430,612,30,582,465,290
22,227910,DEL VALLE ISD,13,english,7,884,338,546,302,173,676,498,178,35,2
22,227912,LAGO VISTA ISD,13,english,7,154,22,132,106,80,106,39,67,25,6
22,227913,LAKE TRAVIS ISD,13,english,7,911,78,833,670,498,506,133,373,178,51
22,228901,GROVETON ISD,6,english,7,54,3,51,39,26,54,9,45,26,8
22,228903,TRINITY ISD,6,english,7,80,26,54,29,19,80,40,40,22,6
22,228904,CENTERVILLE ISD,6,english,7,6,0,6,5,4,6,0,6,6,1
22,228905,APPLE SPRINGS I,6,english,7,15,1,14,12,5,15,2,13,5,0
22,229901,COLMESNEIL ISD,5,english,7,33,3,30,21,14,33,4,29,13,7
22,229903,WOODVILLE ISD,5,english,7,87,30,57,31,21,87,57,30,12,2
22,229904,WARREN ISD,5,english,7,102,26,76,56,33,101,33,68,33,14
22,229905,SPURGER ISD,5,english,7,28,6,22,12,10,28,12,16,6,3
22,229906,CHESTER ISD,5,english,7,22,1,21,16,9,22,3,19,13,3
22,230901,BIG SANDY ISD,7,english,7,44,5,39,29,20,34,6,28,17,5
22,230902,GILMER ISD,7,english,7,198,30,168,111,71,198,60,138,81,39
22,230903,ORE CITY ISD,7,english,7,66,14,52,28,19,65,33,32,12,3
22,230904,UNION HILL ISD,7,english,7,21,6,15,10,5,21,11,10,1,0
22,230905,HARMONY ISD,7,english,7,84,17,67,45,25,84,24,60,34,17
22,230906,NEW DIANA ISD,7,english,7,76,9,67,45,25,76,16,60,37,10
22,230908,UNION GROVE ISD,7,english,7,52,4,48,35,27,52,9,43,32,16
22,231901,MCCAMEY ISD,18,english,7,44,5,39,23,10,38,22,16,6,0
22,231902,RANKIN ISD,18,english,7,17,4,13,7,4,17,6,11,6,4
22,232901,KNIPPA ISD,20,english,7,27,2,25,17,13,27,4,23,12,6
22,232902,SABINAL ISD,20,english,7,36,7,29,15,6,36,15,21,5,1
22,232903,UVALDE CISD,20,english,7,339,118,221,130,70,262,201,61,19,3
22,232904,UTOPIA ISD,20,english,7,17,5,12,7,5,17,9,8,1,1
22,233901,SAN FELIPE-DEL,15,english,7,711,201,510,338,218,709,343,366,189,75
22,233903,COMSTOCK ISD,15,english,7,16,2,14,9,6,8,4,4,0,0
22,234801,RANCH ACADEMY,7,english,7,0,,,,,0,,,,
22,234902,CANTON ISD,10,english,7,180,18,162,121,89,180,39,141,78,27
22,234903,EDGEWOOD ISD,7,english,7,67,10,57,34,17,56,15,41,15,2
22,234904,GRAND SALINE IS,7,english,7,78,27,51,32,17,78,35,43,25,8
22,234905,MARTINS MILL IS,7,english,7,38,4,34,26,13,38,4,34,19,10
22,234906,VAN ISD,7,english,7,200,24,176,124,73,200,52,148,68,30
22,234907,WILLS POINT ISD,10,english,7,211,53,158,97,62,211,108,103,34,8
22,234909,FRUITVALE ISD,7,english,7,28,7,21,11,7,28,11,17,8,2
22,235901,BLOOMINGTON ISD,3,english,7,64,23,41,17,8,65,43,22,3,0
22,235902,VICTORIA ISD,3,english,7,975,318,657,414,266,870,562,308,111,44
22,236901,NEW WAVERLY ISD,6,english,7,77,7,70,46,28,67,23,44,14,3
22,236902,HUNTSVILLE ISD,6,english,7,1324,222,1102,782,509,1189,544,645,222,59
22,237902,HEMPSTEAD ISD,4,english,7,111,59,52,20,14,89,70,19,3,0
22,237904,WALLER ISD,4,english,7,700,184,516,341,192,699,331,368,163,39
22,237905,ROYAL ISD,4,english,7,207,81,126,70,47,209,87,122,51,23
22,238902,MONAHANS-WICKET,18,english,7,182,62,120,70,40,181,71,110,48,14
22,238904,GRANDFALLS-ROYA,18,english,7,12,5,7,0,0,12,10,2,0,0
22,239901,BRENHAM ISD,6,english,7,378,99,279,198,137,377,125,252,158,87
22,239903,BURTON ISD,6,english,7,43,4,39,24,20,43,7,36,21,5
22,240901,LAREDO ISD,1,english,7,1385,427,958,560,335,1384,692,692,282,91
22,240903,UNITED ISD,1,english,7,3132,589,2543,1745,1165,3119,973,2146,1099,434
22,240904,WEBB CISD,1,english,7,13,0,13,9,6,13,2,11,5,1
22,241901,BOLING ISD,3,english,7,106,21,85,57,31,106,20,86,42,14
22,241902,EAST BERNARD IS,3,english,7,62,6,56,44,31,62,16,46,31,12
22,241903,EL CAMPO ISD,3,english,7,242,57,185,117,81,243,81,162,105,45
22,241904,WHARTON ISD,3,english,7,130,60,70,42,22,109,85,24,2,1
22,241906,LOUISE ISD,3,english,7,31,5,26,12,5,19,9,10,3,0
22,242902,SHAMROCK ISD,16,english,7,27,6,21,11,8,27,13,14,8,3
22,242903,WHEELER ISD,16,english,7,21,1,20,17,13,21,0,21,12,4
22,242905,KELTON ISD,16,english,7,10,4,6,5,4,10,3,7,1,1
22,242906,FORT ELLIOTT CI,16,english,7,12,2,10,8,3,12,3,9,7,2
22,243901,BURKBURNETT ISD,9,english,7,242,43,199,127,76,177,69,108,33,8
22,243902,ELECTRA ISD,9,english,7,38,9,29,15,9,38,18,20,4,1
22,243903,IOWA PARK CISD,9,english,7,158,17,141,106,69,158,30,128,73,26
22,243905,WICHITA FALLS I,9,english,7,891,286,605,356,213,892,398,494,246,113
22,243906,CITY VIEW ISD,9,english,7,101,13,88,59,33,101,37,64,19,7
22,244901,HARROLD ISD,9,english,7,7,3,4,2,1,7,3,4,1,0
22,244903,VERNON ISD,9,english,7,129,49,80,40,16,129,74,55,22,5
22,244905,NORTHSIDE ISD,9,english,7,17,2,15,8,6,17,3,14,7,2
22,245901,LASARA ISD,1,english,7,29,4,25,18,10,29,13,16,5,2
22,245902,LYFORD CISD,1,english,7,104,22,82,51,30,103,47,56,24,5
22,245903,RAYMONDVILLE IS,1,english,7,123,21,102,69,41,123,39,84,39,9
22,245904,SAN PERLITA ISD,1,english,7,13,1,12,8,5,13,5,8,2,2
22,246801,MERIDIAN WORLD,13,english,7,144,2,142,127,100,0,,,,
22,246802,GOODWATER MONTE,13,english,7,18,5,13,10,7,18,9,9,6,2
22,246902,FLORENCE ISD,13,english,7,92,24,68,35,26,74,35,39,8,3
22,246904,GEORGETOWN ISD,13,english,7,940,227,713,499,324,886,386,500,222,87
22,246905,GRANGER ISD,13,english,7,43,8,35,21,15,43,16,27,12,0
22,246906,HUTTO ISD,13,english,7,685,122,563,409,284,481,236,245,92,19
22,246907,JARRELL ISD,13,english,7,226,49,177,108,59,173,82,91,10,1
22,246908,LIBERTY HILL IS,13,english,7,542,74,468,351,248,346,129,217,60,7
22,246909,ROUND ROCK ISD,13,english,7,3570,438,3132,2496,1900,1971,644,1327,816,506
22,246911,TAYLOR ISD,13,english,7,203,72,131,85,54,164,98,66,23,1
22,246912,THRALL ISD,13,english,7,63,8,55,43,33,41,5,36,19,9
22,246913,LEANDER ISD,13,english,7,3174,415,2759,2164,1577,1651,523,1128,411,120
22,246914,COUPLAND ISD,13,english,7,20,6,14,12,11,20,4,16,12,7
22,247901,FLORESVILLE ISD,20,english,7,294,62,232,158,89,293,117,176,92,37
22,247903,LA VERNIA ISD,20,english,7,270,35,235,182,135,270,45,225,141,67
22,247904,POTH ISD,20,english,7,70,1,69,60,45,70,0,70,63,46
22,247906,STOCKDALE ISD,20,english,7,73,7,66,51,35,73,13,60,25,14
22,248901,KERMIT ISD,18,english,7,99,28,71,42,24,99,52,47,16,7
22,248902,WINK-LOVING ISD,18,english,7,32,3,29,18,10,32,8,24,16,6
22,249901,ALVORD ISD,11,english,7,64,8,56,47,34,64,7,57,35,14
22,249902,BOYD ISD,11,english,7,88,11,77,52,29,88,29,59,25,6
22,249903,BRIDGEPORT ISD,11,english,7,146,39,107,71,45,147,22,125,59,22
22,249904,CHICO ISD,11,english,7,37,8,29,13,7,37,19,18,6,3
22,249905,DECATUR ISD,11,english,7,272,66,206,134,79,193,115,78,15,0
22,249906,PARADISE ISD,11,english,7,96,12,84,69,42,81,19,62,25,5
22,249908,SLIDELL ISD,11,english,7,27,10,17,15,8,27,8,19,11,5
22,250902,HAWKINS ISD,7,english,7,55,5,50,36,24,55,12,43,26,11
22,250903,MINEOLA ISD,7,english,7,142,21,121,79,54,142,31,111,58,27
22,250904,QUITMAN ISD,7,english,7,85,14,71,52,35,74,24,50,23,6
22,250905,YANTIS ISD,7,english,7,23,7,16,9,6,23,10,13,9,2
22,250906,ALBA-GOLDEN ISD,7,english,7,73,15,58,36,25,73,33,40,20,7
22,250907,WINNSBORO ISD,7,english,7,134,29,105,75,50,134,42,92,42,18
22,251901,DENVER CITY ISD,17,english,7,132,31,101,62,36,132,64,68,37,20
22,251902,PLAINS ISD,17,english,7,32,10,22,12,9,32,11,21,6,1
22,252901,GRAHAM ISD,9,english,7,205,45,160,106,62,206,71,135,79,31
22,252902,NEWCASTLE ISD,9,english,7,21,2,19,11,10,21,2,19,10,5
22,252903,OLNEY ISD,9,english,7,55,17,38,27,18,55,15,40,30,13
22,253901,ZAPATA COUNTY I,1,english,7,255,95,160,82,46,254,170,84,26,8
22,254901,CRYSTAL CITY IS,20,english,7,131,51,80,34,12,131,90,41,12,5
22,254902,LA PRYOR ISD,20,english,7,42,5,37,20,15,34,14,20,6,0
22,1902,CAYUGA ISD,7,english,8,51,9,42,38,26,51,8,43,32,13
22,1903,ELKHART ISD,7,english,8,84,8,76,62,46,71,11,60,30,12
22,1904,FRANKSTON ISD,7,english,8,64,13,51,39,17,38,9,29,12,0
22,1906,NECHES ISD,7,english,8,21,2,19,16,10,21,1,20,16,6
22,1907,PALESTINE ISD,7,english,8,228,34,194,130,81,228,52,176,116,53
22,1908,WESTWOOD ISD,7,english,8,112,43,69,37,26,108,44,64,30,3
22,1909,SLOCUM ISD,7,english,8,23,2,21,17,12,23,1,22,16,8
22,2901,ANDREWS ISD,18,english,8,318,59,259,184,112,318,52,266,190,78
22,3801,PINEYWOODS COMM,7,english,8,71,8,63,43,26,69,18,51,30,12
22,3902,HUDSON ISD,7,english,8,212,13,199,150,91,176,15,161,127,62
22,3903,LUFKIN ISD,7,english,8,535,162,373,241,147,458,225,233,106,25
22,3904,HUNTINGTON ISD,7,english,8,138,24,114,64,44,138,29,109,57,25
22,3905,DIBOLL ISD,7,english,8,142,34,108,69,39,117,28,89,50,14
22,3906,ZAVALLA ISD,7,english,8,20,6,14,10,7,18,10,8,4,1
22,3907,CENTRAL ISD,7,english,8,96,9,87,64,37,75,8,67,50,29
22,4901,ARANSAS COUNTY,2,english,8,240,70,170,110,77,224,84,140,88,44
22,5901,ARCHER CITY ISD,9,english,8,36,3,33,24,16,36,4,32,25,12
22,5902,HOLLIDAY ISD,9,english,8,95,10,85,70,50,66,14,52,26,4
22,5904,WINDTHORST ISD,9,english,8,40,9,31,27,21,40,9,31,26,8
22,6902,CLAUDE ISD,16,english,8,26,5,21,14,9,26,8,18,16,8
22,7901,CHARLOTTE ISD,20,english,8,28,7,21,12,6,28,14,14,6,3
22,7902,JOURDANTON ISD,20,english,8,125,7,118,98,68,86,28,58,32,5
22,7904,LYTLE ISD,20,english,8,122,19,103,60,35,93,39,54,13,2
22,7905,PLEASANTON ISD,20,english,8,234,36,198,137,79,207,59,148,70,11
22,7906,POTEET ISD,20,english,8,122,20,102,61,35,112,40,72,24,2
22,8901,BELLVILLE ISD,6,english,8,180,29,151,100,63,130,39,91,34,4
22,8902,SEALY ISD,6,english,8,248,67,181,112,68,237,84,153,74,17
22,8903,BRAZOS ISD,6,english,8,78,9,69,44,23,64,10,54,37,7
22,9901,MULESHOE ISD,17,english,8,100,21,79,48,26,99,40,59,36,10
22,10901,MEDINA ISD,20,english,8,18,4,14,10,8,12,4,8,0,0
22,10902,BANDERA ISD,20,english,8,185,32,153,104,61,167,61,106,37,4
22,11901,BASTROP ISD,13,english,8,941,300,641,402,216,964,376,588,300,67
22,11902,ELGIN ISD,13,english,8,437,168,269,148,88,379,155,224,97,28
22,11904,SMITHVILLE ISD,13,english,8,140,21,119,73,36,157,37,120,50,7
22,11905,MCDADE ISD,13,english,8,28,4,24,12,5,27,10,17,6,0
22,12901,SEYMOUR ISD,9,english,8,46,2,44,34,18,50,2,48,39,21
22,13901,BEEVILLE ISD,2,english,8,287,61,226,138,82,224,126,98,23,5
22,13902,PAWNEE ISD,2,english,8,8,1,7,5,3,6,1,5,4,0
22,13903,PETTUS ISD,2,english,8,46,9,37,22,12,46,7,39,22,4
22,13905,SKIDMORE-TYNAN,2,english,8,64,5,59,40,29,61,15,46,31,10
22,14803,PRIORITY CHARTE,12,english,8,56,10,46,32,19,53,27,26,9,1
22,14804,ORENDA CHARTER,12,english,8,168,17,151,124,92,53,26,27,11,2
22,14901,ACADEMY ISD,12,english,8,142,22,120,85,49,141,27,114,62,19
22,14902,BARTLETT ISD,13,english,8,36,8,28,17,9,34,19,15,1,0
22,14903,BELTON ISD,12,english,8,1030,190,840,575,371,1079,355,724,352,102
22,14905,HOLLAND ISD,12,english,8,47,4,43,32,19,46,6,40,34,18
22,14906,KILLEEN ISD,12,english,8,3090,747,2343,1442,815,2736,1142,1594,645,151
22,14907,ROGERS ISD,12,english,8,67,4,63,44,25,66,15,51,27,11
22,14908,SALADO ISD,12,english,8,181,31,150,99,64,106,54,52,7,0
22,14909,TEMPLE ISD,12,english,8,617,160,457,276,189,506,173,333,162,53
22,14910,TROY ISD,12,english,8,146,25,121,81,51,143,17,126,91,30
22,15802,GEORGE GERVIN A,20,english,8,34,7,27,13,9,34,10,24,8,2
22,15806,LEGACY TRADITIO,20,english,8,20,4,16,8,5,20,9,11,0,0
22,15807,SOUTHWEST PREPA,20,english,8,54,9,45,24,13,51,25,26,9,2
22,15808,INSPIRE ACADEMI,20,english,8,65,15,50,29,18,64,27,37,10,1
22,15809,BEXAR COUNTY AC,20,english,8,13,3,10,3,2,13,9,4,1,0
22,15815,HERITAGE ACADEM,20,english,8,84,18,66,39,24,80,36,44,18,1
22,15822,JUBILEE ACADEMI,20,english,8,511,119,392,238,129,465,246,219,95,34
22,15825,LIGHTHOUSE PUBL,20,english,8,35,16,19,10,4,35,25,10,4,0
22,15827,SCHOOL OF SCIEN,20,english,8,220,21,199,142,100,159,37,122,61,17
22,15828,HARMONY PUBLIC,20,english,8,450,79,371,258,165,235,44,191,98,28
22,15830,BROOKS ACADEMIE,20,english,8,276,50,226,163,108,232,114,118,26,2
22,15831,SCHOOL OF SCIEN,20,english,8,261,27,234,179,124,184,46,138,65,16
22,15834,BASIS TEXAS,20,english,8,153,2,151,145,114,153,4,149,129,75
22,15835,GREAT HEARTS TE,20,english,8,514,13,501,393,264,57,25,32,4,0
22,15836,ELEANOR KOLITZ,20,english,8,46,0,46,43,39,47,2,45,39,22
22,15838,COMPASS ROSE PU,20,english,8,127,34,93,53,30,100,74,26,2,0
22,15840,SAN ANTONIO PRE,20,english,8,28,8,20,14,9,0,,,,
22,15901,ALAMO HEIGHTS I,20,english,8,372,33,339,267,200,360,67,293,182,72
22,15904,HARLANDALE ISD,20,english,8,963,198,765,451,245,997,295,702,348,76
22,15905,EDGEWOOD ISD,20,english,8,629,277,352,185,101,0,,,,
22,15906,RANDOLPH FIELD,20,english,8,117,4,113,84,49,138,16,122,80,28
22,15907,SAN ANTONIO ISD,20,english,8,2780,993,1787,962,521,2153,1282,871,214,31
22,15908,SOUTH SAN ANTON,20,english,8,607,247,360,172,81,400,251,149,44,5
22,15909,SOMERSET ISD,20,english,8,282,47,235,148,82,0,,,,
22,15910,NORTH EAST ISD,20,english,8,4699,742,3957,2947,2014,4634,1095,3539,2128,726
22,15911,EAST CENTRAL IS,20,english,8,818,259,559,302,169,854,565,289,72,9
22,15912,SOUTHWEST ISD,20,english,8,1035,257,778,503,308,808,378,430,151,21
22,15913,LACKLAND ISD,20,english,8,59,5,54,33,17,64,8,56,36,17
22,15914,FT SAM HOUSTON,20,english,8,109,5,104,73,47,68,13,55,21,5
22,15915,NORTHSIDE ISD,20,english,8,7823,1412,6411,4357,2743,7670,2569,5101,2123,531
22,15916,JUDSON ISD,20,english,8,1732,353,1379,893,527,1670,633,1037,472,113
22,15917,SOUTHSIDE ISD,20,english,8,444,112,332,204,129,220,136,84,24,1
22,16901,JOHNSON CITY IS,13,english,8,54,7,47,37,25,53,5,48,32,11
22,16902,BLANCO ISD,13,english,8,80,18,62,40,35,89,19,70,41,9
22,17901,BORDEN COUNTY I,17,english,8,20,0,20,17,12,20,2,18,11,4
22,18901,CLIFTON ISD,12,english,8,83,5,78,61,35,71,20,51,25,1
22,18902,MERIDIAN ISD,12,english,8,37,4,33,23,13,31,19,12,4,1
22,18903,MORGAN ISD,12,english,8,17,4,13,7,4,17,10,7,1,0
22,18904,VALLEY MILLS IS,12,english,8,52,9,43,28,16,52,19,33,15,6
22,18905,WALNUT SPRINGS,12,english,8,14,3,11,7,1,15,5,10,5,0
22,18906,IREDELL ISD,12,english,8,16,2,14,10,4,16,5,11,2,0
22,18907,KOPPERL ISD,12,english,8,18,6,12,6,4,18,10,8,2,0
22,18908,CRANFILLS GAP I,12,english,8,14,3,11,6,3,14,2,12,8,5
22,19901,DEKALB ISD,8,english,8,62,14,48,31,17,41,9,32,20,3
22,19902,HOOKS ISD,8,english,8,62,8,54,37,22,58,12,46,25,12
22,19903,MAUD ISD,8,english,8,32,2,30,19,12,32,6,26,12,2
22,19905,NEW BOSTON ISD,8,english,8,86,12,74,51,30,64,25,39,13,1
22,19906,REDWATER ISD,8,english,8,102,6,96,70,50,104,6,98,77,31
22,19907,TEXARKANA ISD,8,english,8,477,94,383,237,133,409,150,259,100,33
22,19908,LIBERTY-EYLAU I,8,english,8,120,38,82,49,31,110,56,54,17,6
22,19909,SIMMS ISD,8,english,8,35,2,33,19,14,23,2,21,8,3
22,19911,RED LICK ISD,8,english,8,39,3,36,30,23,27,2,25,20,6
22,19912,PLEASANT GROVE,8,english,8,199,11,188,153,119,116,25,91,40,6
22,19913,HUBBARD ISD,8,english,8,6,1,5,4,2,6,0,6,5,2
22,19914,LEARY ISD,8,english,8,6,1,5,4,2,6,2,4,2,0
22,20901,ALVIN ISD,4,english,8,2298,358,1940,1339,850,2611,557,2054,1330,556
22,20902,ANGLETON ISD,4,english,8,516,75,441,312,195,515,130,385,224,71
22,20904,DANBURY ISD,4,english,8,58,9,49,27,18,40,8,32,12,1
22,20905,BRAZOSPORT ISD,4,english,8,868,192,676,412,249,852,200,652,396,114
22,20906,SWEENY ISD,4,english,8,135,35,100,67,46,136,34,102,59,24
22,20907,COLUMBIA-BRAZOR,4,english,8,254,55,199,122,72,205,61,144,73,20
22,20908,PEARLAND ISD,4,english,8,1712,139,1573,1297,952,1038,208,830,462,199
22,20910,DAMON ISD,4,english,8,12,4,8,5,2,12,5,7,5,1
22,21803,BRAZOS SCHOOL F,6,english,8,11,2,9,7,4,11,2,9,4,2
22,21901,COLLEGE STATION,6,english,8,1091,156,935,700,506,1053,204,849,616,315
22,21902,BRYAN ISD,6,english,8,1188,383,805,473,300,1274,641,633,227,58
22,22004,TERLINGUA CSD,18,english,8,9,7,2,1,1,9,7,2,0,0
22,22901,ALPINE ISD,18,english,8,69,6,63,42,26,70,14,56,32,11
22,22902,MARATHON ISD,18,english,8,0,,,,,0,,,,
22,22903,SAN VICENTE ISD,18,english,8,0,,,,,0,,,,
22,23902,SILVERTON ISD,16,english,8,16,2,14,14,12,16,1,15,12,5
22,24901,BROOKS COUNTY I,1,english,8,111,19,92,63,38,111,45,66,27,4
22,25901,BANGS ISD,15,english,8,67,11,56,44,27,56,10,46,16,3
22,25902,BROWNWOOD ISD,15,english,8,255,50,205,129,85,235,94,141,67,14
22,25904,BLANKET ISD,15,english,8,12,4,8,6,1,12,8,4,1,0
22,25905,MAY ISD,15,english,8,28,5,23,17,11,14,9,5,3,0
22,25906,ZEPHYR ISD,15,english,8,18,2,16,5,3,18,10,8,2,1
22,25908,BROOKESMITH ISD,15,english,8,24,9,15,6,3,25,10,15,6,3
22,25909,EARLY ISD,15,english,8,84,5,79,65,43,84,6,78,63,29
22,26901,CALDWELL ISD,6,english,8,144,17,127,90,52,106,19,87,44,10
22,26902,SOMERVILLE ISD,6,english,8,35,12,23,15,6,26,13,13,3,0
22,26903,SNOOK ISD,6,english,8,49,11,38,25,19,31,8,23,16,2
22,27903,BURNET CISD,13,english,8,272,79,193,108,74,209,94,115,34,3
22,27904,MARBLE FALLS IS,13,english,8,299,79,220,133,79,317,90,227,116,31
22,28902,LOCKHART ISD,13,english,8,483,145,338,174,102,526,153,373,193,56
22,28903,LULING ISD,13,english,8,96,28,68,39,27,78,34,44,21,4
22,28906,PRAIRIE LEA ISD,13,english,8,14,4,10,4,1,14,9,5,0,0
22,29901,CALHOUN COUNTY,3,english,8,264,60,204,121,72,282,86,196,85,15
22,30901,CROSS PLAINS IS,14,english,8,26,4,22,13,6,26,4,22,12,0
22,30902,CLYDE CISD,14,english,8,116,29,87,65,42,97,31,66,39,10
22,30903,BAIRD ISD,14,english,8,26,1,25,16,8,23,3,20,5,0
22,30906,EULA ISD,14,english,8,20,2,18,15,6,20,4,16,13,7
22,31901,BROWNSVILLE ISD,1,english,8,2578,588,1990,1283,753,2317,745,1572,833,265
22,31903,HARLINGEN CISD,1,english,8,1341,226,1115,724,441,780,292,488,186,41
22,31905,LA FERIA ISD,1,english,8,217,42,175,109,66,130,77,53,21,3
22,31906,LOS FRESNOS CIS,1,english,8,827,127,700,492,319,733,151,582,399,147
22,31909,POINT ISABEL IS,1,english,8,151,18,133,93,52,129,50,79,24,4
22,31911,RIO HONDO ISD,1,english,8,108,17,91,57,28,60,35,25,3,0
22,31912,SAN BENITO CISD,1,english,8,784,140,644,423,266,646,219,427,187,47
22,31913,SANTA MARIA ISD,1,english,8,45,21,24,13,4,45,22,23,7,0
22,31914,SANTA ROSA ISD,1,english,8,54,11,43,20,14,45,25,20,3,0
22,31916,SOUTH TEXAS ISD,1,english,8,586,16,570,486,358,557,62,495,357,180
22,32902,PITTSBURG ISD,8,english,8,211,18,193,123,76,182,23,159,108,40
22,33901,GROOM ISD,16,english,8,11,0,11,9,6,11,1,10,9,5
22,33902,PANHANDLE ISD,16,english,8,55,10,45,31,24,55,5,50,39,16
22,33904,WHITE DEER ISD,16,english,8,24,1,23,15,4,24,3,21,8,2
22,34901,ATLANTA ISD,8,english,8,114,14,100,69,35,83,35,48,19,5
22,34902,AVINGER ISD,8,english,8,10,1,9,6,3,10,4,6,3,0
22,34903,HUGHES SPRINGS,8,english,8,90,9,81,51,36,80,16,64,43,8
22,34905,LINDEN-KILDARE,8,english,8,56,8,48,28,20,56,12,44,25,9
22,34906,MCLEOD ISD,8,english,8,29,4,25,13,6,21,2,19,9,0
22,34907,QUEEN CITY ISD,8,english,8,67,11,56,44,33,50,8,42,27,5
22,34909,BLOOMBURG ISD,8,english,8,20,3,17,10,8,20,5,15,9,3
22,35901,DIMMITT ISD,16,english,8,83,21,62,30,17,84,26,58,37,16
22,35902,HART ISD,16,english,8,11,1,10,7,6,11,2,9,3,2
22,35903,NAZARETH ISD,16,english,8,18,0,18,15,14,8,0,8,6,0
22,36901,ANAHUAC ISD,4,english,8,116,20,96,73,44,114,20,94,58,27
22,36902,BARBERS HILL IS,4,english,8,507,37,470,370,256,370,37,333,251,110
22,36903,EAST CHAMBERS I,5,english,8,115,18,97,56,38,93,29,64,31,4
22,37901,ALTO ISD,7,english,8,32,3,29,22,19,34,2,32,26,11
22,37904,JACKSONVILLE IS,7,english,8,340,85,255,161,90,254,132,122,33,4
22,37907,RUSK ISD,7,english,8,170,28,142,105,73,138,29,109,56,9
22,37908,NEW SUMMERFIELD,7,english,8,44,11,33,27,18,44,14,30,10,1
22,37909,WELLS ISD,7,english,8,17,6,11,8,5,17,5,12,1,0
22,38901,CHILDRESS ISD,16,english,8,81,11,70,48,31,81,15,66,45,23
22,39902,HENRIETTA ISD,9,english,8,77,6,71,43,28,61,11,50,27,4
22,39903,PETROLIA CISD,9,english,8,33,5,28,23,14,33,5,28,16,6
22,39904,BELLEVUE ISD,9,english,8,13,2,11,5,2,12,5,7,3,0
22,39905,MIDWAY ISD,9,english,8,8,1,7,5,4,8,0,8,7,3
22,40901,MORTON ISD,17,english,8,32,8,24,12,5,32,13,19,6,1
22,40902,WHITEFACE CISD,17,english,8,24,4,20,13,8,24,7,17,7,2
22,41901,BRONTE ISD,15,english,8,20,3,17,16,8,20,3,17,8,2
22,41902,ROBERT LEE ISD,15,english,8,31,4,27,14,7,30,4,26,21,7
22,42901,COLEMAN ISD,15,english,8,57,14,43,30,19,57,19,38,25,9
22,42903,SANTA ANNA ISD,15,english,8,21,3,18,16,11,20,5,15,7,0
22,42905,PANTHER CREEK C,15,english,8,5,0,5,3,3,5,0,5,2,0
22,43801,IMAGINE INTERNA,10,english,8,123,3,120,110,91,41,0,41,38,18
22,43901,ALLEN ISD,10,english,8,1716,121,1595,1315,988,865,161,704,394,117
22,43902,ANNA ISD,10,english,8,357,68,289,178,107,296,107,189,78,15
22,43903,CELINA ISD,10,english,8,237,12,225,185,126,142,16,126,66,21
22,43904,FARMERSVILLE IS,10,english,8,163,11,152,108,74,79,18,61,28,4
22,43905,FRISCO ISD,10,english,8,5509,273,5236,4514,3560,3132,501,2631,1719,814
22,43907,MCKINNEY ISD,10,english,8,1864,209,1655,1239,876,1170,305,865,450,142
22,43908,MELISSA ISD,10,english,8,391,31,360,295,215,366,31,335,258,135
22,43910,PLANO ISD,10,english,8,3923,513,3410,2610,1891,4212,694,3518,2432,1184
22,43911,PRINCETON ISD,10,english,8,521,71,450,329,202,346,58,288,201,86
22,43912,PROSPER ISD,10,english,8,1722,106,1616,1304,936,818,196,622,302,76
22,43914,WYLIE ISD,10,english,8,1433,135,1298,1049,792,1000,152,848,563,209
22,43917,BLUE RIDGE ISD,10,english,8,68,11,57,47,30,50,17,33,17,4
22,43918,COMMUNITY ISD,10,english,8,256,46,210,137,84,152,62,90,20,3
22,43919,LOVEJOY ISD,10,english,8,389,13,376,338,260,164,7,157,138,77
22,44902,WELLINGTON ISD,16,english,8,39,5,34,21,15,39,7,32,21,7
22,45902,COLUMBUS ISD,3,english,8,113,18,95,61,23,113,31,82,38,8
22,45903,RICE CISD,3,english,8,108,20,88,51,33,99,39,60,21,7
22,45905,WEIMAR ISD,3,english,8,51,5,46,33,19,37,6,31,22,1
22,46802,TRINITY CHARTER,20,english,8,54,25,29,12,9,52,37,15,6,3
22,46901,NEW BRAUNFELS I,13,english,8,743,95,648,454,295,458,120,338,143,19
22,46902,COMAL ISD,20,english,8,2335,258,2077,1621,1163,1514,377,1137,619,179
22,47901,COMANCHE ISD,14,english,8,97,16,81,55,38,97,11,86,42,17
22,47902,DE LEON ISD,14,english,8,52,5,47,35,25,52,10,42,26,12
22,47903,GUSTINE ISD,14,english,8,9,2,7,6,3,9,2,7,7,3
22,47905,SIDNEY ISD,14,english,8,12,0,12,8,5,12,1,11,7,4
22,48901,EDEN CISD,15,english,8,18,2,16,7,1,18,7,11,6,1
22,48903,PAINT ROCK ISD,15,english,8,22,5,17,8,4,22,13,9,4,0
22,49901,GAINESVILLE ISD,11,english,8,127,41,86,36,16,149,37,112,40,3
22,49902,MUENSTER ISD,11,english,8,46,3,43,34,24,46,4,42,33,14
22,49903,VALLEY VIEW ISD,11,english,8,73,17,56,41,27,73,24,49,22,8
22,49905,CALLISBURG ISD,11,english,8,100,17,83,58,39,83,23,60,29,11
22,49906,ERA ISD,11,english,8,41,3,38,25,11,41,4,37,31,14
22,49907,LINDSAY ISD,11,english,8,45,1,44,35,22,21,0,21,17,3
22,49908,WALNUT BEND ISD,11,english,8,8,0,8,8,5,8,1,7,3,2
22,49909,SIVELLS BEND IS,11,english,8,5,0,5,2,1,5,1,4,2,1
22,50901,EVANT ISD,12,english,8,17,6,11,6,3,17,10,7,4,0
22,50902,GATESVILLE ISD,12,english,8,194,50,144,89,56,191,65,126,62,13
22,50904,OGLESBY ISD,12,english,8,16,3,13,9,7,16,3,13,7,1
22,50909,JONESBORO ISD,12,english,8,27,4,23,15,9,27,6,21,9,2
22,50910,COPPERAS COVE I,12,english,8,626,129,497,318,173,859,304,555,266,62
22,51901,PADUCAH ISD,17,english,8,6,2,4,3,2,6,1,5,3,2
22,52901,CRANE ISD,15,english,8,89,17,72,48,32,89,24,65,31,11
22,53001,CROCKETT COUNTY,15,english,8,67,9,58,44,22,67,6,61,46,28
22,54901,CROSBYTON CISD,17,english,8,22,6,16,7,3,22,15,7,2,0
22,54902,LORENZO ISD,17,english,8,27,11,16,8,5,27,12,15,7,1
22,54903,RALLS ISD,17,english,8,39,21,18,6,3,39,28,11,1,0
22,55901,CULBERSON COUNT,18,english,8,30,5,25,17,7,0,,,,
22,56901,DALHART ISD,16,english,8,125,34,91,58,39,125,27,98,73,32
22,56902,TEXLINE ISD,16,english,8,19,6,13,10,7,16,4,12,10,4
22,57802,PEGASUS SCHOOL,10,english,8,45,13,32,14,8,23,15,8,2,1
22,57803,UPLIFT EDUCATIO,10,english,8,1884,368,1516,971,611,1111,497,614,237,76
22,57806,ADVANTAGE ACADE,10,english,8,109,32,77,40,24,109,66,43,16,5
22,57807,LIFE SCHOOL,10,english,8,427,78,349,214,126,295,154,141,27,3
22,57808,UNIVERSAL ACADE,10,english,8,92,7,85,66,45,79,13,66,46,24
22,57810,ACADEMY OF DALL,10,english,8,26,4,22,12,4,26,20,6,3,0
22,57813,TRINITY BASIN P,10,english,8,309,46,263,179,106,288,91,197,97,31
22,57814,ACADEMY FOR ACA,10,english,8,45,24,21,8,4,44,34,10,1,0
22,57816,A W BROWN LEADE,10,english,8,37,5,32,14,3,37,15,22,5,0
22,57819,JEAN MASSIEU AC,10,english,8,19,1,18,13,9,19,2,17,10,3
22,57827,NOVA ACADEMY SO,10,english,8,51,11,40,30,16,51,11,40,11,6
22,57829,A+ ACADEMY,10,english,8,113,34,79,48,16,93,56,37,8,0
22,57830,INSPIRED VISION,10,english,8,113,44,69,29,11,89,63,26,2,1
22,57831,GATEWAY CHARTER,10,english,8,37,1,36,22,13,37,9,28,14,3
22,57833,EDUCATION CENTE,10,english,8,21,3,18,14,10,21,3,18,8,2
22,57835,GOLDEN RULE CHA,10,english,8,78,9,69,44,31,78,14,64,38,13
22,57836,ST ANTHONY SCHO,10,english,8,39,5,34,27,14,38,7,31,13,1
22,57839,LA ACADEMIA DE,10,english,8,94,13,81,50,27,86,29,57,21,1
22,57841,CITYSCAPE SCHOO,10,english,8,59,11,48,28,15,59,25,34,16,4
22,57844,MANARA ACADEMY,10,english,8,43,9,34,21,12,43,15,28,18,5
22,57845,UME PREPARATORY,10,english,8,105,8,97,70,50,107,9,98,68,30
22,57846,LEGACY PREPARAT,10,english,8,121,24,97,52,22,118,40,78,20,0
22,57847,VILLAGE TECH SC,10,english,8,0,,,,,0,,,,
22,57848,INTERNATIONAL L,10,english,8,1436,336,1100,637,373,1436,697,739,252,45
22,57850,PIONEER TECHNOL,10,english,8,239,29,210,139,81,219,76,143,54,14
22,57903,CARROLLTON-FARM,10,english,8,1663,367,1296,836,513,1901,587,1314,706,208
22,57904,CEDAR HILL ISD,10,english,8,597,146,451,262,153,537,260,277,79,16
22,57905,DALLAS ISD,10,english,8,9591,2316,7275,4632,2796,11330,3849,7481,4034,1344
22,57906,DESOTO ISD,10,english,8,621,116,505,307,167,588,241,347,144,35
22,57907,DUNCANVILLE ISD,10,english,8,948,194,754,443,254,920,284,636,329,93
22,57909,GARLAND ISD,10,english,8,4243,820,3423,2362,1520,4145,1228,2917,1436,403
22,57910,GRAND PRAIRIE I,10,english,8,1831,450,1381,805,433,1734,624,1110,517,120
22,57911,HIGHLAND PARK I,10,english,8,547,5,542,488,392,544,20,524,444,214
22,57912,IRVING ISD,10,english,8,2032,690,1342,721,392,1844,804,1040,395,110
22,57913,LANCASTER ISD,10,english,8,577,127,450,264,137,576,204,372,204,71
22,57914,MESQUITE ISD,10,english,8,3173,765,2408,1518,888,3300,979,2321,1218,318
22,57916,RICHARDSON ISD,10,english,8,2685,617,2068,1481,1028,3527,1398,2129,1066,382
22,57919,SUNNYVALE ISD,10,english,8,158,6,152,129,95,153,10,143,99,39
22,57922,COPPELL ISD,10,english,8,1065,46,1019,873,734,1074,69,1005,856,582
22,58902,DAWSON ISD,17,english,8,11,3,8,5,3,11,6,5,1,0
22,58905,KLONDIKE ISD,17,english,8,17,0,17,11,9,17,1,16,16,12
22,58906,LAMESA ISD,17,english,8,110,44,66,28,14,111,74,37,15,4
22,58909,SANDS CISD,17,english,8,15,0,15,8,4,15,3,12,8,4
22,59901,HEREFORD ISD,16,english,8,329,71,258,130,67,300,82,218,83,13
22,60902,COOPER ISD,8,english,8,48,12,36,23,12,48,20,28,10,0
22,60914,FANNINDEL ISD,8,english,8,13,5,8,5,3,13,7,6,1,1
22,61802,NORTH TEXAS COL,11,english,8,36,6,30,16,11,36,12,24,14,4
22,61804,LEADERSHIP PREP,10,english,8,110,13,97,69,46,126,34,92,42,13
22,61805,TRIVIUM ACADEMY,11,english,8,37,5,32,27,18,33,7,26,14,5
22,61901,DENTON ISD,11,english,8,2424,450,1974,1366,893,1865,804,1061,476,143
22,61902,LEWISVILLE ISD,11,english,8,3856,436,3420,2674,1940,3800,788,3012,1970,864
22,61903,PILOT POINT ISD,11,english,8,114,21,93,65,50,78,33,45,5,0
22,61905,KRUM ISD,11,english,8,171,27,144,109,79,129,47,82,20,3
22,61906,PONDER ISD,11,english,8,123,12,111,83,54,94,11,83,57,22
22,61907,AUBREY ISD,11,english,8,244,32,212,151,98,242,77,165,72,17
22,61908,SANGER ISD,11,english,8,233,41,192,143,93,241,59,182,80,17
22,61910,ARGYLE ISD,11,english,8,364,24,340,269,193,351,32,319,250,117
22,61911,NORTHWEST ISD,11,english,8,2184,255,1929,1399,931,2138,432,1706,995,355
22,61912,LAKE DALLAS ISD,11,english,8,305,45,260,189,116,228,70,158,57,11
22,61914,LITTLE ELM ISD,11,english,8,679,107,572,380,253,765,139,626,363,142
22,62901,CUERO ISD,3,english,8,151,17,134,88,52,126,16,110,85,21
22,62902,NORDHEIM ISD,3,english,8,12,1,11,7,5,12,2,10,7,4
22,62903,YOAKUM ISD,3,english,8,109,16,93,63,39,83,17,66,44,7
22,62904,YORKTOWN ISD,3,english,8,37,5,32,16,7,25,15,10,0,0
22,62905,WESTHOFF ISD,3,english,8,5,0,5,5,3,5,0,5,4,1
22,62906,MEYERSVILLE ISD,3,english,8,12,2,10,8,7,9,2,7,3,0
22,63903,SPUR ISD,17,english,8,20,4,16,14,9,20,6,14,7,1
22,63906,PATTON SPRINGS,17,english,8,5,0,5,3,1,5,1,4,2,2
22,64903,CARRIZO SPRINGS,20,english,8,159,40,119,74,41,114,47,67,25,2
22,65901,CLARENDON ISD,16,english,8,27,5,22,14,7,27,6,21,18,6
22,65902,HEDLEY ISD,16,english,8,12,0,12,8,3,12,1,11,8,2
22,66901,BENAVIDES ISD,2,english,8,0,,,,,0,,,,
22,66902,SAN DIEGO ISD,2,english,8,116,15,101,67,40,114,23,91,58,22
22,66903,FREER ISD,2,english,8,25,2,23,17,8,21,5,16,7,2
22,67902,CISCO ISD,14,english,8,63,8,55,36,26,63,12,51,33,11
22,67903,EASTLAND ISD,14,english,8,77,19,58,44,25,72,25,47,16,0
22,67904,GORMAN ISD,14,english,8,16,3,13,10,8,10,4,6,2,0
22,67907,RANGER ISD,14,english,8,18,7,11,6,4,18,14,4,2,1
22,67908,RISING STAR ISD,14,english,8,19,5,14,8,7,19,9,10,3,1
22,68802,COMPASS ACADEMY,18,english,8,117,14,103,67,43,117,20,97,57,15
22,68803,UTPB STEM ACADE,18,english,8,49,4,45,23,14,65,11,54,29,8
22,68901,ECTOR COUNTY IS,18,english,8,2343,695,1648,992,584,1792,955,837,232,17
22,69901,ROCKSPRINGS ISD,15,english,8,18,6,12,7,1,18,9,9,2,0
22,69902,NUECES CANYON C,15,english,8,20,2,18,14,10,20,7,13,10,4
22,70801,WAXAHACHIE FAIT,10,english,8,220,73,147,68,39,184,65,119,57,9
22,70901,AVALON ISD,10,english,8,26,6,20,11,7,26,5,21,9,3
22,70903,ENNIS ISD,10,english,8,428,72,356,224,151,318,131,187,59,8
22,70905,FERRIS ISD,10,english,8,228,44,184,105,59,281,108,173,69,15
22,70907,ITALY ISD,10,english,8,61,18,43,32,20,46,20,26,8,0
22,70908,MIDLOTHIAN ISD,10,english,8,889,168,721,459,294,876,192,684,393,136
22,70909,MILFORD ISD,10,english,8,19,5,14,7,5,18,7,11,5,3
22,70910,PALMER ISD,10,english,8,97,10,87,64,41,96,11,85,62,18
22,70911,RED OAK ISD,10,english,8,576,126,450,273,177,617,138,479,349,148
22,70912,WAXAHACHIE ISD,10,english,8,823,130,693,467,308,808,208,600,378,139
22,70915,MAYPEARL ISD,10,english,8,81,11,70,44,26,94,10,84,62,16
22,71801,BURNHAM WOOD CH,19,english,8,130,28,102,73,53,106,23,83,49,23
22,71806,HARMONY PUBLIC,19,english,8,416,64,352,253,155,307,44,263,183,66
22,71810,EL PASO LEADERS,19,english,8,82,30,52,26,15,43,33,10,1,0
22,71901,CLINT ISD,19,english,8,889,197,692,414,240,823,299,524,197,40
22,71902,EL PASO ISD,19,english,8,3627,678,2949,2045,1291,2590,893,1697,777,215
22,71903,FABENS ISD,19,english,8,176,53,123,61,24,163,73,90,37,6
22,71904,SAN ELIZARIO IS,19,english,8,247,61,186,117,63,207,65,142,70,13
22,71905,YSLETA ISD,19,english,8,2781,539,2242,1505,943,2742,714,2028,994,271
22,71906,ANTHONY ISD,19,english,8,68,11,57,34,23,59,7,52,43,11
22,71907,CANUTILLO ISD,19,english,8,483,90,393,268,171,604,181,423,222,87
22,71908,TORNILLO ISD,19,english,8,71,21,50,30,17,44,24,20,3,0
22,71909,SOCORRO ISD,19,english,8,3657,600,3057,2107,1331,657,300,357,122,17
22,72801,PREMIER HIGH SC,11,english,8,0,,,,,0,,,,
22,72802,ERATH EXCELS AC,11,english,8,0,,,,,7,7,0,0,0
22,72901,THREE WAY ISD,11,english,8,16,2,14,8,3,14,5,9,3,0
22,72902,DUBLIN ISD,11,english,8,94,11,83,62,36,94,17,77,36,12
22,72903,STEPHENVILLE IS,11,english,8,277,35,242,171,120,197,45,152,80,19
22,72904,BLUFF DALE ISD,11,english,8,13,1,12,9,5,8,2,6,2,0
22,72908,HUCKABAY ISD,11,english,8,23,3,20,17,8,9,1,8,2,0
22,72909,LINGLEVILLE ISD,11,english,8,12,1,11,7,2,12,4,8,3,1
22,72910,MORGAN MILL ISD,11,english,8,9,1,8,5,4,9,3,6,3,0
22,73901,CHILTON ISD,12,english,8,39,4,35,17,12,45,14,31,12,0
22,73903,MARLIN ISD,12,english,8,66,15,51,28,12,65,23,42,23,8
22,73904,WESTPHALIA ISD,12,english,8,12,2,10,10,8,0,,,,
22,73905,ROSEBUD-LOTT IS,12,english,8,34,9,25,14,7,32,10,22,8,2
22,74903,BONHAM ISD,10,english,8,146,28,118,74,49,147,51,96,37,10
22,74904,DODD CITY ISD,10,english,8,31,1,30,24,16,31,3,28,22,6
22,74905,ECTOR ISD,10,english,8,24,8,16,11,5,24,8,16,6,1
22,74907,HONEY GROVE ISD,8,english,8,61,9,52,36,23,60,5,55,38,16
22,74909,LEONARD ISD,10,english,8,59,7,52,36,19,62,2,60,36,16
22,74911,SAVOY ISD,10,english,8,25,5,20,15,11,19,8,11,2,1
22,74912,TRENTON ISD,10,english,8,53,13,40,21,12,53,13,40,20,6
22,74917,SAM RAYBURN ISD,10,english,8,43,5,38,25,16,28,7,21,13,2
22,75901,FLATONIA ISD,13,english,8,42,5,37,29,16,34,2,32,26,11
22,75902,LA GRANGE ISD,13,english,8,146,15,131,92,63,162,13,149,89,22
22,75903,SCHULENBURG ISD,13,english,8,52,8,44,26,17,40,13,27,12,0
22,75906,FAYETTEVILLE IS,13,english,8,20,0,20,15,11,20,0,20,16,7
22,75908,ROUND TOP-CARMI,13,english,8,23,1,22,18,15,7,0,7,6,1
22,76903,ROBY CISD,14,english,8,29,7,22,15,5,29,15,14,5,2
22,76904,ROTAN ISD,14,english,8,18,1,17,11,4,18,1,17,13,5
22,77901,FLOYDADA COLLEG,17,english,8,61,18,43,19,10,61,17,44,24,7
22,77902,LOCKNEY ISD,17,english,8,35,9,26,12,6,35,11,24,11,2
22,78901,CROWELL ISD,9,english,8,6,1,5,3,1,6,0,6,2,0
22,79901,LAMAR CISD,4,english,8,3001,423,2578,1889,1330,3225,660,2565,1711,754
22,79906,NEEDVILLE ISD,4,english,8,277,30,247,187,116,223,42,181,98,19
22,79907,FORT BEND ISD,4,english,8,6293,804,5489,4163,2927,4231,1539,2692,1248,344
22,79910,STAFFORD MSD,4,english,8,264,54,210,142,85,37,17,20,6,1
22,80901,MOUNT VERNON IS,8,english,8,127,15,112,78,46,104,11,93,70,19
22,81902,FAIRFIELD ISD,12,english,8,139,30,109,71,32,118,46,72,27,8
22,81904,TEAGUE ISD,12,english,8,94,16,78,47,23,94,24,70,38,10
22,81905,WORTHAM ISD,12,english,8,36,9,27,12,7,36,16,20,8,0
22,81906,DEW ISD,12,english,8,8,1,7,3,3,8,2,6,4,2
22,82902,DILLEY ISD,20,english,8,75,24,51,24,15,51,33,18,1,0
22,82903,PEARSALL ISD,20,english,8,178,72,106,59,30,178,112,66,19,3
22,83901,SEAGRAVES ISD,17,english,8,34,9,25,13,6,34,8,26,12,5
22,83902,LOOP ISD,17,english,8,16,4,12,9,5,16,6,10,5,3
22,83903,SEMINOLE ISD,17,english,8,223,56,167,104,62,223,62,161,94,37
22,84802,ODYSSEY ACADEMY,4,english,8,85,25,60,35,21,83,51,32,7,1
22,84804,AMBASSADORS PRE,4,english,8,12,1,11,11,6,12,1,11,10,6
22,84901,DICKINSON ISD,4,english,8,936,180,756,449,272,944,245,699,375,101
22,84902,GALVESTON ISD,4,english,8,460,106,354,224,134,424,194,230,123,50
22,84903,HIGH ISLAND ISD,5,english,8,12,1,11,7,4,10,1,9,5,2
22,84906,TEXAS CITY ISD,4,english,8,560,157,403,233,139,542,227,315,169,53
22,84908,HITCHCOCK ISD,4,english,8,119,28,91,55,32,119,39,80,35,14
22,84909,SANTA FE ISD,4,english,8,350,61,289,190,117,235,87,148,48,2
22,84910,CLEAR CREEK ISD,4,english,8,3258,374,2884,2158,1510,2261,491,1770,885,214
22,84911,FRIENDSWOOD ISD,4,english,8,508,36,472,368,250,468,29,439,320,143
22,85902,POST ISD,17,english,8,65,18,47,29,19,65,28,37,16,7
22,85903,SOUTHLAND ISD,17,english,8,9,2,7,5,1,9,4,5,1,0
22,86901,FREDERICKSBURG,13,english,8,223,51,172,114,77,221,77,144,84,27
22,86902,HARPER ISD,13,english,8,45,7,38,27,18,44,5,39,27,10
22,87901,GLASSCOCK COUNT,18,english,8,25,4,21,19,16,25,0,25,19,12
22,88902,GOLIAD ISD,3,english,8,108,14,94,57,32,108,28,80,42,13
22,89901,GONZALES ISD,13,english,8,199,58,141,78,45,176,84,92,35,3
22,89903,NIXON-SMILEY CI,13,english,8,73,11,62,43,25,74,21,53,28,5
22,89905,WAELDER ISD,13,english,8,26,8,18,11,6,17,10,7,1,0
22,90902,LEFORS ISD,16,english,8,19,3,16,6,5,17,9,8,2,0
22,90903,MCLEAN ISD,16,english,8,13,4,9,3,2,13,1,12,8,1
22,90904,PAMPA ISD,16,english,8,249,69,180,102,66,250,89,161,84,31
22,91901,BELLS ISD,10,english,8,91,10,81,64,45,88,9,79,71,47
22,91902,COLLINSVILLE IS,10,english,8,44,7,37,24,13,40,10,30,17,2
22,91903,DENISON ISD,10,english,8,348,61,287,184,121,279,91,188,70,10
22,91905,HOWE ISD,10,english,8,100,16,84,64,41,89,27,62,32,3
22,91906,SHERMAN ISD,10,english,8,580,136,444,282,154,512,238,274,117,40
22,91907,TIOGA ISD,10,english,8,70,8,62,47,31,67,13,54,31,8
22,91908,VAN ALSTYNE ISD,10,english,8,177,8,169,129,91,135,13,122,92,34
22,91909,WHITESBORO ISD,10,english,8,116,17,99,63,36,96,25,71,30,3
22,91910,WHITEWRIGHT ISD,10,english,8,39,4,35,26,21,29,3,26,17,6
22,91913,POTTSBORO ISD,10,english,8,108,14,94,61,37,115,34,81,48,7
22,91914,S AND S CISD,10,english,8,84,12,72,50,31,66,17,49,22,7
22,91917,GUNTER ISD,10,english,8,94,7,87,62,46,59,19,40,10,1
22,91918,TOM BEAN ISD,10,english,8,56,7,49,26,17,52,9,43,21,6
22,92901,GLADEWATER ISD,7,english,8,113,12,101,63,34,116,30,86,52,19
22,92902,KILGORE ISD,7,english,8,320,69,251,163,95,297,95,202,94,29
22,92903,LONGVIEW ISD,7,english,8,631,75,556,407,241,396,116,280,138,47
22,92904,PINE TREE ISD,7,english,8,330,55,275,171,96,328,72,256,135,39
22,92906,SABINE ISD,7,english,8,124,16,108,75,49,91,21,70,40,9
22,92907,SPRING HILL ISD,7,english,8,196,22,174,134,77,189,21,168,111,39
22,92908,WHITE OAK ISD,7,english,8,95,15,80,61,36,118,27,91,53,16
22,93901,ANDERSON-SHIRO,6,english,8,57,2,55,44,30,53,4,49,29,10
22,93903,IOLA ISD,6,english,8,53,8,45,28,22,42,12,30,12,4
22,93904,NAVASOTA ISD,6,english,8,259,70,189,105,62,262,93,169,101,24
22,93905,RICHARDS ISD,6,english,8,16,1,15,10,4,12,7,5,0,0
22,94901,SEGUIN ISD,20,english,8,512,162,350,193,106,496,259,237,77,15
22,94902,SCHERTZ-CIBOLO-,20,english,8,1308,180,1128,748,456,890,209,681,347,82
22,94903,NAVARRO ISD,20,english,8,169,11,158,109,61,141,23,118,59,22
22,94904,MARION ISD,20,english,8,104,10,94,69,48,76,6,70,31,5
22,95901,ABERNATHY ISD,17,english,8,56,6,50,41,27,46,11,35,19,6
22,95902,COTTON CENTER I,17,english,8,8,1,7,3,1,8,6,2,1,0
22,95903,HALE CENTER ISD,17,english,8,50,7,43,21,14,50,18,32,9,1
22,95904,PETERSBURG ISD,17,english,8,18,1,17,15,9,14,0,14,9,1
22,95905,PLAINVIEW ISD,17,english,8,337,94,243,148,88,269,112,157,58,9
22,96904,MEMPHIS ISD,16,english,8,34,8,26,16,8,34,10,24,10,5
22,96905,TURKEY-QUITAQUE,16,english,8,13,1,12,7,3,13,3,10,7,2
22,97902,HAMILTON ISD,12,english,8,71,8,63,51,38,65,10,55,36,14
22,97903,HICO ISD,12,english,8,40,7,33,22,16,30,9,21,8,2
22,98901,GRUVER ISD,16,english,8,31,0,31,18,12,25,0,25,24,15
22,98903,PRINGLE-MORSE C,16,english,8,10,1,9,6,3,7,0,7,5,0
22,98904,SPEARMAN ISD,16,english,8,53,7,46,37,28,39,4,35,29,16
22,99902,CHILLICOTHE ISD,9,english,8,14,2,12,9,4,14,2,12,7,2
22,99903,QUANAH ISD,9,english,8,41,3,38,25,17,35,3,32,17,6
22,100903,KOUNTZE ISD,5,english,8,87,17,70,45,28,75,18,57,30,7
22,100904,SILSBEE ISD,5,english,8,224,70,154,74,37,228,98,130,46,4
22,100905,HARDIN-JEFFERSO,5,english,8,188,22,166,124,81,193,21,172,136,65
22,100907,LUMBERTON ISD,5,english,8,313,49,264,169,106,249,64,185,86,12
22,100908,WEST HARDIN COU,5,english,8,52,7,45,34,18,52,12,40,18,7
22,101802,SER-NINOS CHART,4,english,8,70,10,60,39,18,47,5,42,20,2
22,101803,ARISTOI CLASSIC,4,english,8,85,8,77,64,49,65,18,47,18,1
22,101804,GEORGE I SANCHE,4,english,8,149,63,86,37,17,148,99,49,9,0
22,101806,RAUL YZAGUIRRE,4,english,8,150,18,132,82,54,89,19,70,27,4
22,101810,ACADEMY OF ACCE,4,english,8,37,6,31,21,11,33,17,16,10,2
22,101811,EXCEL ACADEMY,4,english,8,18,13,5,2,1,19,16,3,0,0
22,101814,THE VARNETT PUB,4,english,8,65,8,57,33,19,65,12,53,30,12
22,101815,ALIEF MONTESSOR,4,english,8,6,0,6,5,5,0,,,,
22,101819,AMIGOS POR VIDA,4,english,8,37,3,34,26,12,37,1,36,27,19
22,101828,HOUSTON GATEWAY,4,english,8,139,3,136,126,107,100,2,98,85,54
22,101837,CALVIN NELMS CH,4,english,8,51,0,51,44,28,35,7,28,14,5
22,101838,SOUTHWEST SCHOO,4,english,8,107,34,73,38,21,108,60,48,16,4
22,101842,COMQUEST ACADEM,4,english,8,5,1,4,3,3,5,3,2,0,0
22,101845,YES PREP PUBLIC,4,english,8,2199,405,1794,1107,646,2133,502,1631,915,337
22,101846,HARMONY PUBLIC,4,english,8,339,40,299,204,131,297,59,238,138,74
22,101847,BEATRICE MAYES,4,english,8,38,1,37,32,19,38,5,33,22,10
22,101853,PROMISE COMMUNI,4,english,8,53,19,34,17,6,53,31,22,8,3
22,101856,DRAW ACADEMY,4,english,8,67,15,52,34,18,67,21,46,27,7
22,101858,HARMONY PUBLIC,4,english,8,526,65,461,320,218,366,91,275,154,56
22,101859,STEP CHARTER SC,4,english,8,38,0,38,27,16,0,,,,
22,101861,THE RHODES SCHO,4,english,8,29,2,27,21,13,29,3,26,14,4
22,101862,HARMONY PUBLIC,4,english,8,378,20,358,294,208,272,44,228,160,74
22,101864,THE LAWSON ACAD,4,english,8,43,11,32,18,9,43,23,20,6,0
22,101868,THE PRO-VISION,4,english,8,45,23,22,6,3,45,41,4,0,0
22,101870,BETA ACADEMY,4,english,8,64,3,61,48,36,64,7,57,29,10
22,101871,A+ UNLIMITED PO,4,english,8,36,5,31,21,14,27,12,15,3,0
22,101872,ETOILE ACADEMY,4,english,8,99,23,76,57,41,99,39,60,35,8
22,101873,YELLOWSTONE COL,4,english,8,48,14,34,21,11,0,,,,
22,101874,LEGACY SCHOOL O,4,english,8,48,13,35,18,8,43,32,11,1,0
22,101902,ALDINE ISD,4,english,8,4707,1421,3286,1873,1056,4628,2171,2457,1012,316
22,101903,ALIEF ISD,4,english,8,2865,772,2093,1267,747,2510,836,1674,928,291
22,101905,CHANNELVIEW ISD,4,english,8,741,172,569,354,196,707,261,446,179,40
22,101906,CROSBY ISD,4,english,8,515,109,406,252,157,376,97,279,155,38
22,101907,CYPRESS-FAIRBAN,4,english,8,9107,990,8117,6224,4301,5402,1608,3794,1732,326
22,101908,DEER PARK ISD,4,english,8,1016,90,926,696,459,1013,100,913,665,288
22,101910,GALENA PARK ISD,4,english,8,1715,345,1370,917,566,1700,461,1239,754,257
22,101911,GOOSE CREEK CIS,4,english,8,1838,362,1476,968,596,1533,368,1165,697,270
22,101912,HOUSTON ISD,4,english,8,12943,2976,9967,7073,4754,10702,4144,6558,3317,1191
22,101913,HUMBLE ISD,4,english,8,3724,715,3009,1946,1248,3924,1169,2755,1453,426
22,101914,KATY ISD,4,english,8,7066,703,6363,5099,3711,7383,991,6392,4711,2496
22,101915,KLEIN ISD,4,english,8,4218,660,3558,2581,1771,2746,906,1840,851,308
22,101916,LA PORTE ISD,4,english,8,565,82,483,309,195,569,173,396,175,52
22,101917,PASADENA ISD,4,english,8,3773,756,3017,1949,1159,3637,1011,2626,1349,337
22,101919,SPRING ISD,4,english,8,2483,590,1893,1159,665,2264,965,1299,507,108
22,101920,SPRING BRANCH I,4,english,8,2497,514,1983,1457,990,1626,555,1071,576,214
22,101921,TOMBALL ISD,4,english,8,1595,109,1486,1191,856,1187,136,1051,733,291
22,101924,SHELDON ISD,4,english,8,865,271,594,333,175,647,388,259,47,5
22,101925,HUFFMAN ISD,4,english,8,258,43,215,123,69,261,47,214,133,42
22,102901,KARNACK ISD,7,english,8,13,3,10,9,5,13,5,8,3,1
22,102902,MARSHALL ISD,7,english,8,413,106,307,176,102,364,112,252,142,35
22,102903,WASKOM ISD,7,english,8,61,11,50,33,20,49,13,36,15,3
22,102904,HALLSVILLE ISD,7,english,8,2074,522,1552,877,491,2052,1227,825,289,83
22,102905,HARLETON ISD,7,english,8,46,0,46,35,29,46,4,42,30,13
22,102906,ELYSIAN FIELDS,7,english,8,71,6,65,55,32,55,11,44,17,1
22,103901,CHANNING ISD,16,english,8,14,3,11,10,7,14,1,13,7,5
22,103902,HARTLEY ISD,16,english,8,20,1,19,17,13,20,1,19,16,14
22,104901,HASKELL CISD,14,english,8,40,2,38,30,18,36,3,33,21,9
22,104903,RULE ISD,14,english,8,13,2,11,6,2,13,4,9,4,2
22,104907,PAINT CREEK ISD,14,english,8,12,2,10,7,4,12,2,10,8,3
22,105803,KI CHARTER ACAD,13,english,8,35,16,19,8,7,30,20,10,1,0
22,105902,SAN MARCOS CISD,13,english,8,613,208,405,243,149,570,384,186,69,21
22,105904,DRIPPING SPRING,13,english,8,584,33,551,449,318,577,43,534,410,192
22,105905,WIMBERLEY ISD,13,english,8,214,20,194,143,102,210,41,169,115,47
22,105906,HAYS CISD,13,english,8,1753,289,1464,1045,718,1636,442,1194,689,228
22,106901,CANADIAN ISD,16,english,8,74,7,67,46,23,53,11,42,21,3
22,107901,ATHENS ISD,10,english,8,223,66,157,106,66,223,74,149,96,34
22,107902,BROWNSBORO ISD,7,english,8,199,14,185,129,78,181,13,168,132,48
22,107904,CROSS ROADS ISD,7,english,8,43,4,39,33,21,43,1,42,38,15
22,107905,EUSTACE ISD,7,english,8,134,17,117,74,41,119,26,93,53,16
22,107906,MALAKOFF ISD,7,english,8,95,5,90,67,43,95,5,90,69,29
22,107907,TRINIDAD ISD,7,english,8,9,1,8,2,2,9,2,7,5,0
22,107908,MURCHISON ISD,7,english,8,12,1,11,4,4,12,5,7,3,1
22,107910,LAPOYNOR ISD,7,english,8,40,6,34,26,14,39,11,28,13,2
22,108802,HORIZON MONTESS,1,english,8,42,6,36,26,20,42,13,29,20,4
22,108807,IDEA PUBLIC SCH,1,english,8,4936,616,4320,3180,2116,24,4,20,13,5
22,108808,VANGUARD ACADEM,1,english,8,345,38,307,232,141,245,33,212,105,24
22,108809,EXCELLENCE IN L,1,english,8,18,5,13,8,3,18,10,8,3,0
22,108902,DONNA ISD,1,english,8,944,292,652,358,181,957,335,622,286,49
22,108903,EDCOUCH-ELSA IS,1,english,8,309,74,235,131,67,309,132,177,64,12
22,108904,EDINBURG CISD,1,english,8,2012,424,1588,1023,579,2029,647,1382,675,209
22,108905,HIDALGO ISD,1,english,8,211,42,169,123,78,146,37,109,37,7
22,108906,MCALLEN ISD,1,english,8,1519,192,1327,995,700,1282,276,1006,656,332
22,108907,MERCEDES ISD,1,english,8,324,113,211,105,56,315,138,177,55,11
22,108908,MISSION CISD,1,english,8,1038,245,793,508,311,994,387,607,291,66
22,108909,PHARR-SAN JUAN-,1,english,8,2081,444,1637,1033,633,1934,591,1343,762,319
22,108910,PROGRESO ISD,1,english,8,96,18,78,55,28,65,30,35,9,0
22,108911,SHARYLAND ISD,1,english,8,826,98,728,585,404,636,98,538,401,198
22,108912,LA JOYA ISD,1,english,8,1868,424,1444,952,572,1817,433,1384,874,342
22,108913,WESLACO ISD,1,english,8,1106,271,835,505,264,1029,333,696,377,107
22,108914,LA VILLA ISD,1,english,8,45,12,33,21,12,45,19,26,11,4
22,108915,MONTE ALTO ISD,1,english,8,67,17,50,35,24,67,28,39,20,8
22,108916,VALLEY VIEW ISD,1,english,8,269,55,214,137,76,286,71,215,126,43
22,109901,ABBOTT ISD,12,english,8,15,0,15,9,7,15,0,15,10,4
22,109902,BYNUM ISD,12,english,8,21,0,21,14,9,21,1,20,13,4
22,109903,COVINGTON ISD,12,english,8,27,4,23,12,8,26,9,17,5,0
22,109904,HILLSBORO ISD,12,english,8,160,24,136,91,60,146,30,116,64,25
22,109905,HUBBARD ISD,12,english,8,29,3,26,15,12,21,7,14,6,2
22,109907,ITASCA ISD,12,english,8,44,9,35,16,11,45,25,20,9,2
22,109908,MALONE ISD,12,english,8,11,1,10,8,5,13,3,10,7,4
22,109910,MOUNT CALM ISD,12,english,8,15,5,10,4,2,11,5,6,2,1
22,109911,WHITNEY ISD,12,english,8,111,20,91,55,33,110,30,80,51,25
22,109912,AQUILLA ISD,12,english,8,23,5,18,8,3,23,4,19,11,4
22,109913,BLUM ISD,12,english,8,20,3,17,12,3,18,3,15,7,2
22,109914,PENELOPE ISD,12,english,8,11,1,10,7,6,11,2,9,7,3
22,110901,ANTON ISD,17,english,8,18,3,15,7,4,18,11,7,0,0
22,110902,LEVELLAND ISD,17,english,8,209,42,167,90,50,201,49,152,59,7
22,110905,ROPES ISD,17,english,8,39,6,33,30,18,22,3,19,10,0
22,110906,SMYER ISD,17,english,8,32,7,25,19,15,22,12,10,9,1
22,110907,SUNDOWN ISD,17,english,8,45,2,43,33,18,45,5,40,34,12
22,110908,WHITHARRAL ISD,17,english,8,20,1,19,11,7,20,4,16,10,3
22,111801,LAKE GRANBURY A,11,english,8,0,,,,,0,,,,
22,111901,GRANBURY ISD,11,english,8,610,84,526,372,243,517,165,352,152,43
22,111902,LIPAN ISD,11,english,8,37,5,32,22,15,36,7,29,16,7
22,111903,TOLAR ISD,11,english,8,70,3,67,57,36,64,6,58,40,13
22,112901,SULPHUR SPRINGS,8,english,8,369,74,295,198,130,326,61,265,193,107
22,112905,CUMBY ISD,8,english,8,29,8,21,17,7,14,7,7,1,0
22,112906,NORTH HOPKINS I,8,english,8,34,6,28,22,14,34,10,24,13,5
22,112907,MILLER GROVE IS,8,english,8,17,1,16,11,4,8,1,7,2,1
22,112908,COMO-PICKTON CI,8,english,8,64,14,50,33,19,63,13,50,27,7
22,112909,SALTILLO ISD,8,english,8,23,1,22,16,7,23,5,18,9,3
22,112910,SULPHUR BLUFF I,8,english,8,18,2,16,11,7,18,3,15,6,3
22,113901,CROCKETT ISD,6,english,8,91,18,73,46,23,77,30,47,12,3
22,113902,GRAPELAND ISD,6,english,8,44,11,33,23,10,37,17,20,5,0
22,113903,LOVELADY ISD,6,english,8,45,2,43,29,16,30,10,20,4,0
22,113905,LATEXO ISD,6,english,8,35,5,30,25,16,29,4,25,18,6
22,113906,KENNARD ISD,6,english,8,19,5,14,8,5,16,5,11,6,3
22,114901,BIG SPRING ISD,18,english,8,265,96,169,96,58,266,137,129,64,19
22,114902,COAHOMA ISD,18,english,8,88,15,73,45,27,88,21,67,31,6
22,114904,FORSAN ISD,18,english,8,58,6,52,39,28,58,9,49,35,11
22,115901,FT HANCOCK ISD,19,english,8,20,2,18,14,10,12,1,11,2,0
22,115902,SIERRA BLANCA I,19,english,8,6,1,5,2,2,6,2,4,2,1
22,115903,DELL CITY ISD,19,english,8,0,,,,,0,,,,
22,116901,CADDO MILLS ISD,10,english,8,173,14,159,123,72,128,37,91,32,2
22,116902,CELESTE ISD,10,english,8,39,5,34,24,12,39,5,34,21,10
22,116903,COMMERCE ISD,10,english,8,122,26,96,55,34,125,48,77,24,4
22,116905,GREENVILLE ISD,10,english,8,391,115,276,155,90,394,171,223,74,17
22,116906,LONE OAK ISD,10,english,8,99,15,84,59,34,100,25,75,41,17
22,116908,QUINLAN ISD,10,english,8,192,39,153,91,55,202,67,135,58,21
22,116909,WOLFE CITY ISD,10,english,8,64,8,56,43,28,64,10,54,37,17
22,116910,CAMPBELL ISD,10,english,8,22,5,17,8,4,22,7,15,7,2
22,116915,BLAND ISD,10,english,8,57,8,49,33,21,57,8,49,38,21
22,116916,BOLES ISD,10,english,8,51,10,41,27,18,51,14,37,18,1
22,117901,BORGER ISD,16,english,8,170,23,147,97,63,99,10,89,56,19
22,117903,SANFORD-FRITCH,16,english,8,53,14,39,23,15,52,18,34,23,10
22,117904,PLEMONS-STINNET,16,english,8,61,11,50,33,24,50,10,40,14,7
22,117907,SPRING CREEK IS,16,english,8,7,0,7,6,4,7,0,7,2,1
22,118902,IRION COUNTY IS,15,english,8,26,6,20,15,10,26,5,21,11,7
22,119901,BRYSON ISD,9,english,8,13,0,13,9,7,13,0,13,12,4
22,119902,JACKSBORO ISD,9,english,8,83,12,71,53,30,64,8,56,31,5
22,119903,PERRIN-WHITT CI,9,english,8,31,3,28,19,9,31,6,25,6,3
22,120901,EDNA ISD,3,english,8,133,23,110,73,52,133,30,103,74,40
22,120902,GANADO ISD,3,english,8,48,5,43,23,16,33,16,17,4,0
22,120905,INDUSTRIAL ISD,3,english,8,99,3,96,73,61,73,4,69,58,19
22,121902,BROOKELAND ISD,5,english,8,23,3,20,16,12,13,7,6,1,0
22,121903,BUNA ISD,5,english,8,106,22,84,49,34,107,31,76,38,4
22,121904,JASPER ISD,5,english,8,162,38,124,67,29,135,53,82,39,12
22,121905,KIRBYVILLE CISD,5,english,8,125,26,99,64,40,104,24,80,40,4
22,121906,EVADALE ISD,5,english,8,30,4,26,18,12,31,5,26,19,6
22,122901,FT DAVIS ISD,18,english,8,14,4,10,4,2,12,3,9,1,0
22,122902,VALENTINE ISD,18,english,8,0,,,,,0,,,,
22,123803,TEKOA ACADEMY O,5,english,8,19,7,12,6,4,19,14,5,1,0
22,123805,EHRHART SCHOOL,5,english,8,46,3,43,28,14,46,10,36,11,3
22,123807,BOB HOPE SCHOOL,5,english,8,141,13,128,84,48,0,,,,
22,123905,NEDERLAND ISD,5,english,8,379,56,323,249,173,311,70,241,151,46
22,123907,PORT ARTHUR ISD,5,english,8,555,185,370,213,114,467,253,214,76,11
22,123908,PORT NECHES-GRO,5,english,8,443,72,371,230,138,433,115,318,134,30
22,123910,BEAUMONT ISD,5,english,8,1130,393,737,438,263,1174,672,502,236,99
22,123913,SABINE PASS ISD,5,english,8,34,2,32,26,21,34,5,29,5,0
22,123914,HAMSHIRE-FANNET,5,english,8,152,26,126,91,60,146,52,94,29,3
22,124901,JIM HOGG COUNTY,1,english,8,76,9,67,48,30,76,4,72,55,26
22,125901,ALICE ISD,2,english,8,302,112,190,109,60,277,137,140,38,2
22,125902,BEN BOLT-PALITO,2,english,8,33,6,27,12,5,34,20,14,3,0
22,125903,ORANGE GROVE IS,2,english,8,131,24,107,67,49,129,46,83,46,15
22,125905,PREMONT ISD,2,english,8,59,13,46,27,18,60,16,44,18,1
22,126901,ALVARADO ISD,11,english,8,289,73,216,136,75,309,125,184,85,13
22,126902,BURLESON ISD,11,english,8,1050,210,840,554,366,680,300,380,127,30
22,126903,CLEBURNE ISD,11,english,8,530,152,378,215,118,534,224,310,129,43
22,126904,GRANDVIEW ISD,11,english,8,112,18,94,65,45,92,21,71,39,11
22,126905,JOSHUA ISD,11,english,8,459,57,402,283,181,282,88,194,75,18
22,126906,KEENE ISD,11,english,8,79,12,67,41,22,68,13,55,30,6
22,126907,RIO VISTA ISD,11,english,8,54,8,46,36,19,53,18,35,16,8
22,126908,VENUS ISD,11,english,8,187,50,137,76,38,212,86,126,51,4
22,126911,GODLEY ISD,11,english,8,217,46,171,98,61,187,64,123,33,1
22,127901,ANSON ISD,14,english,8,46,4,42,32,19,46,7,39,20,9
22,127903,HAMLIN COLLEGIA,14,english,8,35,8,27,16,6,35,11,24,10,5
22,127904,HAWLEY ISD,14,english,8,37,5,32,19,13,36,7,29,12,4
22,127905,LUEDERS-AVOCA I,14,english,8,5,1,4,2,0,5,1,4,2,0
22,127906,STAMFORD ISD,14,english,8,46,6,40,26,12,38,7,31,18,4
22,128901,KARNES CITY ISD,20,english,8,80,13,67,47,28,59,24,35,10,0
22,128902,KENEDY ISD,3,english,8,57,7,50,29,15,51,15,36,12,4
22,128903,RUNGE ISD,3,english,8,14,8,6,3,0,15,10,5,0,0
22,128904,FALLS CITY ISD,20,english,8,32,0,32,28,17,32,1,31,27,15
22,129901,CRANDALL ISD,10,english,8,443,95,348,216,140,341,163,178,35,2
22,129902,FORNEY ISD,10,english,8,1172,202,970,656,393,1222,407,815,394,151
22,129903,KAUFMAN ISD,10,english,8,338,61,277,183,104,269,74,195,90,12
22,129904,KEMP ISD,10,english,8,137,34,103,60,31,120,48,72,28,5
22,129905,MABANK ISD,10,english,8,293,43,250,176,114,317,42,275,213,104
22,129906,TERRELL ISD,10,english,8,380,117,263,133,71,283,148,135,41,2
22,129910,SCURRY-ROSSER I,10,english,8,94,8,86,65,42,64,16,48,26,3
22,130801,MEADOWLAND CHAR,20,english,8,5,3,2,0,0,5,3,2,1,0
22,130901,BOERNE ISD,20,english,8,835,49,786,617,439,521,69,452,294,72
22,130902,COMFORT ISD,13,english,8,98,20,78,42,19,74,36,38,10,0
22,132902,JAYTON-GIRARD I,17,english,8,16,0,16,13,10,16,1,15,8,6
22,133901,CENTER POINT IS,20,english,8,50,13,37,22,11,46,18,28,11,1
22,133902,HUNT ISD,20,english,8,17,1,16,13,7,18,0,18,16,5
22,133903,KERRVILLE ISD,20,english,8,365,89,276,192,133,250,76,174,72,10
22,133904,INGRAM ISD,20,english,8,93,12,81,53,34,55,7,48,27,9
22,134901,JUNCTION ISD,15,english,8,50,3,47,32,16,48,13,35,22,9
22,135001,GUTHRIE CSD,17,english,8,12,0,12,10,8,12,1,11,8,4
22,136901,BRACKETT ISD,20,english,8,43,2,41,27,17,37,10,27,12,0
22,137901,KINGSVILLE ISD,2,english,8,213,67,146,89,50,193,75,118,66,18
22,137902,RICARDO ISD,2,english,8,52,3,49,42,30,36,1,35,34,24
22,137903,RIVIERA ISD,2,english,8,39,2,37,26,12,39,10,29,9,3
22,137904,SANTA GERTRUDIS,2,english,8,53,2,51,45,38,53,4,49,38,17
22,138902,KNOX CITY-O'BRI,9,english,8,16,0,16,6,4,16,1,15,12,4
22,138903,MUNDAY CISD,9,english,8,31,7,24,16,9,31,8,23,15,6
22,138904,BENJAMIN ISD,9,english,8,12,0,12,7,3,12,1,11,4,2
22,139905,CHISUM ISD,8,english,8,91,8,83,60,35,67,8,59,31,5
22,139909,PARIS ISD,8,english,8,264,61,203,123,77,242,65,177,91,19
22,139911,NORTH LAMAR ISD,8,english,8,197,41,156,92,59,177,38,139,84,21
22,139912,PRAIRILAND ISD,8,english,8,75,10,65,53,37,76,13,63,34,9
22,140901,AMHERST ISD,17,english,8,6,1,5,3,2,6,3,3,0,0
22,140904,LITTLEFIELD ISD,17,english,8,100,24,76,51,30,100,31,69,46,22
22,140905,OLTON ISD,17,english,8,42,4,38,18,10,42,12,30,13,4
22,140907,SPRINGLAKE-EART,17,english,8,28,7,21,11,7,28,12,16,4,2
22,140908,SUDAN ISD,17,english,8,43,4,39,26,23,43,14,29,18,3
22,141901,LAMPASAS ISD,12,english,8,309,38,271,182,127,301,67,234,142,34
22,141902,LOMETA ISD,12,english,8,24,5,19,14,8,24,11,13,7,2
22,142901,COTULLA ISD,20,english,8,82,16,66,39,19,64,13,51,29,10
22,143901,HALLETTSVILLE I,3,english,8,98,14,84,53,29,98,4,94,70,34
22,143902,MOULTON ISD,3,english,8,27,2,25,19,13,13,1,12,9,5
22,143903,SHINER ISD,3,english,8,53,6,47,36,30,53,5,48,33,21
22,143904,VYSEHRAD ISD,3,english,8,9,0,9,7,4,6,2,4,3,3
22,143905,SWEET HOME ISD,3,english,8,13,0,13,11,10,7,0,7,4,2
22,143906,EZZELL ISD,3,english,8,7,0,7,5,2,7,0,7,2,2
22,144901,GIDDINGS ISD,13,english,8,154,28,126,83,50,159,34,125,81,37
22,144902,LEXINGTON ISD,13,english,8,85,12,73,59,47,81,11,70,47,9
22,144903,DIME BOX ISD,13,english,8,11,2,9,5,2,11,2,9,2,1
22,145901,BUFFALO ISD,6,english,8,71,8,63,44,21,71,6,65,43,14
22,145902,CENTERVILLE ISD,6,english,8,57,8,49,40,18,57,12,45,26,4
22,145906,NORMANGEE ISD,6,english,8,54,16,38,24,10,54,12,42,19,6
22,145907,OAKWOOD ISD,6,english,8,14,3,11,7,5,14,4,10,5,1
22,145911,LEON ISD,6,english,8,54,5,49,40,30,38,4,34,24,5
22,146901,CLEVELAND ISD,4,english,8,944,342,602,318,170,748,403,345,90,16
22,146902,DAYTON ISD,4,english,8,453,116,337,195,120,361,137,224,94,16
22,146903,DEVERS ISD,4,english,8,16,0,16,14,12,9,1,8,5,1
22,146904,HARDIN ISD,5,english,8,129,22,107,71,46,116,32,84,26,6
22,146905,HULL-DAISETTA I,5,english,8,28,7,21,11,5,27,7,20,7,1
22,146906,LIBERTY ISD,5,english,8,156,20,136,98,60,139,43,96,43,5
22,146907,TARKINGTON ISD,4,english,8,134,23,111,74,46,130,28,102,70,24
22,147901,COOLIDGE ISD,12,english,8,17,2,15,10,6,17,3,14,7,1
22,147902,GROESBECK ISD,12,english,8,129,36,93,62,43,128,40,88,42,14
22,147903,MEXIA ISD,12,english,8,134,32,102,51,31,134,43,91,39,16
22,148901,BOOKER ISD,16,english,8,23,4,19,12,9,23,2,21,17,8
22,148902,FOLLETT ISD,16,english,8,13,0,13,6,5,13,1,12,2,0
22,148905,DARROUZETT ISD,16,english,8,10,4,6,3,2,10,5,5,3,1
22,149901,GEORGE WEST ISD,2,english,8,88,5,83,66,42,87,14,73,47,26
22,149902,THREE RIVERS IS,2,english,8,44,6,38,23,14,44,12,32,17,5
22,150901,LLANO ISD,13,english,8,137,30,107,82,52,139,36,103,66,33
22,152504,TEXAS TECH UNIV,17,english,8,18,1,17,14,9,19,3,16,12,4
22,152802,RISE ACADEMY,17,english,8,10,0,10,8,6,6,0,6,6,3
22,152901,LUBBOCK ISD,17,english,8,1863,500,1363,843,529,1251,632,619,181,24
22,152902,NEW DEAL ISD,17,english,8,67,4,63,38,23,67,19,48,19,6
22,152903,SLATON ISD,17,english,8,88,24,64,34,14,71,18,53,17,1
22,152906,LUBBOCK-COOPER,17,english,8,591,100,491,344,227,486,117,369,216,62
22,152907,FRENSHIP ISD,17,english,8,921,110,811,612,428,604,206,398,156,31
22,152908,ROOSEVELT ISD,17,english,8,91,16,75,42,23,92,22,70,32,9
22,152909,SHALLOWATER ISD,17,english,8,146,16,130,98,59,118,16,102,66,20
22,152910,IDALOU ISD,17,english,8,84,7,77,58,39,84,2,82,70,36
22,153903,O'DONNELL ISD,17,english,8,27,6,21,12,8,27,14,13,6,2
22,153904,TAHOKA ISD,17,english,8,41,9,32,21,13,41,5,36,19,8
22,153905,NEW HOME ISD,17,english,8,45,1,44,41,28,24,5,19,5,0
22,153907,WILSON ISD,17,english,8,11,3,8,4,2,11,3,8,2,2
22,154901,MADISONVILLE CI,6,english,8,183,25,158,112,67,146,20,126,59,6
22,154903,NORTH ZULCH ISD,6,english,8,21,4,17,10,6,16,1,15,8,2
22,155901,JEFFERSON ISD,8,english,8,96,24,72,46,27,96,57,39,11,2
22,156902,STANTON ISD,18,english,8,82,17,65,36,21,89,22,67,39,13
22,156905,GRADY ISD,18,english,8,20,3,17,13,7,20,5,15,8,3
22,157901,MASON ISD,15,english,8,57,2,55,48,38,40,6,34,20,6
22,158901,BAY CITY ISD,3,english,8,270,76,194,104,62,203,51,152,63,11
22,158902,TIDEHAVEN ISD,3,english,8,87,6,81,59,31,89,12,77,53,19
22,158904,MATAGORDA ISD,3,english,8,11,0,11,8,6,11,2,9,5,0
22,158905,PALACIOS ISD,3,english,8,101,16,85,55,31,81,19,62,32,13
22,158906,VAN VLECK ISD,3,english,8,94,20,74,39,19,95,19,76,52,21
22,159901,EAGLE PASS ISD,20,english,8,1018,210,808,530,327,1016,344,672,347,144
22,160901,BRADY ISD,15,english,8,75,8,67,46,22,75,7,68,59,19
22,160904,ROCHELLE ISD,15,english,8,18,1,17,14,8,18,0,18,16,15
22,160905,LOHN ISD,15,english,8,14,8,6,4,1,14,7,7,2,1
22,161802,RAPOPORT ACADEM,12,english,8,62,5,57,40,23,54,10,44,15,2
22,161807,HARMONY PUBLIC,12,english,8,885,106,779,539,348,623,178,445,210,67
22,161901,CRAWFORD ISD,12,english,8,30,0,30,25,15,20,2,18,15,2
22,161903,MIDWAY ISD,12,english,8,646,60,586,463,333,487,95,392,215,59
22,161906,LA VEGA ISD,12,english,8,212,39,173,107,64,212,80,132,51,14
22,161907,LORENA ISD,12,english,8,131,7,124,96,64,115,16,99,71,26
22,161908,MART ISD,12,english,8,31,4,27,16,8,32,5,27,14,4
22,161909,MCGREGOR ISD,12,english,8,103,13,90,63,38,86,20,66,39,18
22,161910,MOODY ISD,12,english,8,52,15,37,27,14,41,14,27,14,2
22,161912,RIESEL ISD,12,english,8,49,6,43,29,20,49,13,36,19,8
22,161914,WACO ISD,12,english,8,1010,279,731,418,216,874,447,427,134,22
22,161916,WEST ISD,12,english,8,85,14,71,46,24,92,13,79,59,25
22,161918,AXTELL ISD,12,english,8,56,7,49,35,23,52,19,33,11,1
22,161919,BRUCEVILLE-EDDY,12,english,8,36,7,29,20,11,28,12,16,2,0
22,161920,CHINA SPRING IS,12,english,8,215,14,201,141,90,148,18,130,79,13
22,161921,CONNALLY ISD,12,english,8,161,43,118,73,40,159,76,83,21,1
22,161922,ROBINSON ISD,12,english,8,203,28,175,143,99,190,31,159,97,36
22,161923,BOSQUEVILLE ISD,12,english,8,52,3,49,32,22,49,5,44,36,15
22,161925,GHOLSON ISD,12,english,8,21,2,19,16,10,21,6,15,6,2
22,162904,MCMULLEN COUNTY,2,english,8,27,0,27,22,14,15,1,14,4,0
22,163901,DEVINE ISD,20,english,8,157,37,120,76,39,158,45,113,62,10
22,163902,D'HANIS ISD,20,english,8,21,5,16,13,8,12,3,9,0,0
22,163903,NATALIA ISD,20,english,8,73,16,57,39,22,60,32,28,10,3
22,163904,HONDO ISD,20,english,8,137,19,118,80,49,105,34,71,24,4
22,163908,MEDINA VALLEY I,20,english,8,562,67,495,365,254,480,109,371,247,85
22,164901,MENARD ISD,15,english,8,30,1,29,22,15,30,4,26,14,2
22,165802,MIDLAND ACADEMY,18,english,8,20,1,19,17,13,17,1,16,15,11
22,165901,MIDLAND ISD,18,english,8,2000,520,1480,924,560,2086,784,1302,697,225
22,165902,GREENWOOD ISD,18,english,8,219,24,195,137,95,224,36,188,112,26
22,166901,CAMERON ISD,6,english,8,127,28,99,65,37,119,36,83,43,21
22,166902,GAUSE ISD,6,english,8,13,0,13,10,6,13,1,12,7,3
22,166903,MILANO ISD,6,english,8,27,3,24,17,14,27,4,23,14,4
22,166904,ROCKDALE ISD,6,english,8,127,33,94,65,35,80,43,37,7,0
22,166905,THORNDALE ISD,13,english,8,36,5,31,17,12,50,15,35,10,4
22,166907,BUCKHOLTS ISD,12,english,8,9,0,9,4,3,0,,,,
22,167901,GOLDTHWAITE ISD,12,english,8,42,1,41,32,19,29,2,27,15,2
22,167902,MULLIN ISD,12,english,8,18,5,13,6,2,18,9,9,5,1
22,167904,PRIDDY ISD,12,english,8,8,2,6,4,1,8,0,8,6,2
22,168901,COLORADO ISD,14,english,8,73,11,62,44,30,73,8,65,48,21
22,168902,LORAINE ISD,14,english,8,13,4,9,7,4,13,3,10,8,4
22,168903,WESTBROOK ISD,14,english,8,21,5,16,10,8,21,5,16,10,4
22,169901,BOWIE ISD,9,english,8,123,21,102,61,42,126,45,81,40,22
22,169902,NOCONA ISD,9,english,8,46,2,44,28,17,49,6,43,24,9
22,169906,GOLD BURG ISD,9,english,8,14,1,13,9,6,13,4,9,3,2
22,169908,MONTAGUE ISD,9,english,8,20,2,18,11,10,20,0,20,17,11
22,169909,PRAIRIE VALLEY,9,english,8,15,1,14,9,4,15,2,13,11,3
22,169910,FORESTBURG ISD,9,english,8,10,0,10,9,6,10,1,9,7,2
22,169911,SAINT JO ISD,9,english,8,22,2,20,14,10,14,2,12,5,0
22,170801,TEXAS SERENITY,6,english,8,35,5,30,15,6,35,15,20,3,0
22,170902,CONROE ISD,6,english,8,5284,769,4515,3348,2309,5528,832,4696,3476,1565
22,170903,MONTGOMERY ISD,6,english,8,770,90,680,487,331,763,70,693,608,376
22,170904,WILLIS ISD,6,english,8,637,172,465,287,159,603,261,342,115,22
22,170906,MAGNOLIA ISD,6,english,8,1134,202,932,673,435,782,227,555,266,45
22,170907,SPLENDORA ISD,6,english,8,328,83,245,144,88,360,101,259,107,23
22,170908,NEW CANEY ISD,6,english,8,1414,295,1119,724,431,1091,371,720,386,95
22,171901,DUMAS ISD,16,english,8,312,57,255,160,100,259,61,198,104,21
22,171902,SUNRAY COLLEGIA,16,english,8,57,6,51,35,18,57,15,42,15,4
22,172902,DAINGERFIELD-LO,8,english,8,88,21,67,37,22,85,26,59,21,3
22,172905,PEWITT CISD,8,english,8,72,9,63,35,24,54,13,41,17,2
22,173901,MOTLEY COUNTY I,17,english,8,13,0,13,8,3,13,2,11,7,1
22,174901,CHIRENO ISD,7,english,8,32,3,29,25,14,16,2,14,8,1
22,174902,CUSHING ISD,7,english,8,37,4,33,25,13,36,6,30,14,4
22,174903,GARRISON ISD,7,english,8,64,8,56,34,24,61,13,48,30,11
22,174904,NACOGDOCHES ISD,7,english,8,449,107,342,210,121,320,159,161,55,7
22,174906,WODEN ISD,7,english,8,65,3,62,50,33,55,1,54,45,22
22,174908,CENTRAL HEIGHTS,7,english,8,92,7,85,72,54,63,8,55,35,7
22,174909,MARTINSVILLE IS,7,english,8,23,3,20,12,6,19,8,11,6,3
22,174910,ETOILE ISD,7,english,8,0,,,,,0,,,,
22,174911,DOUGLASS ISD,7,english,8,50,8,42,32,22,34,9,25,15,3
22,175902,BLOOMING GROVE,12,english,8,62,7,55,35,26,61,12,49,30,9
22,175903,CORSICANA ISD,12,english,8,459,89,370,251,158,376,158,218,100,25
22,175904,DAWSON ISD,12,english,8,51,13,38,18,11,51,19,32,14,3
22,175905,FROST ISD,12,english,8,39,8,31,21,10,39,23,16,8,0
22,175907,KERENS ISD,12,english,8,39,6,33,19,10,30,6,24,13,1
22,175910,MILDRED ISD,12,english,8,55,3,52,31,25,55,5,50,33,17
22,175911,RICE ISD,12,english,8,74,17,57,40,28,74,17,57,33,12
22,176901,BURKEVILLE ISD,5,english,8,19,2,17,11,8,19,10,9,4,0
22,176902,NEWTON ISD,5,english,8,68,12,56,26,12,55,17,38,13,0
22,176903,DEWEYVILLE ISD,5,english,8,37,6,31,24,14,37,11,26,15,4
22,177901,ROSCOE COLLEGIA,14,english,8,50,8,42,26,19,0,,,,
22,177902,SWEETWATER ISD,14,english,8,149,48,101,65,25,140,66,74,33,9
22,177903,BLACKWELL CISD,14,english,8,16,0,16,10,7,16,4,12,5,1
22,177905,HIGHLAND ISD,14,english,8,16,2,14,9,7,16,1,15,14,5
22,178801,DR M L GARZA-GO,2,english,8,15,2,13,10,4,15,5,10,1,0
22,178807,CORPUS CHRISTI,2,english,8,14,2,12,9,8,8,5,3,0,0
22,178808,SEASHORE CHARTE,2,english,8,47,2,45,40,27,53,5,48,32,16
22,178901,AGUA DULCE ISD,2,english,8,45,3,42,34,19,26,9,17,2,1
22,178902,BISHOP CISD,2,english,8,109,15,94,62,44,93,19,74,46,21
22,178903,CALALLEN ISD,2,english,8,299,45,254,169,108,299,45,254,194,83
22,178904,CORPUS CHRISTI,2,english,8,2587,531,2056,1326,820,2176,883,1293,518,104
22,178905,DRISCOLL ISD,2,english,8,30,2,28,25,19,15,3,12,6,1
22,178906,LONDON ISD,2,english,8,116,2,114,97,70,80,7,73,53,21
22,178908,PORT ARANSAS IS,2,english,8,43,0,43,38,24,22,3,19,9,0
22,178909,ROBSTOWN ISD,2,english,8,180,51,129,77,33,148,82,66,20,2
22,178912,TULOSO-MIDWAY I,2,english,8,288,33,255,175,113,250,49,201,105,14
22,178913,BANQUETE ISD,2,english,8,76,8,68,50,27,53,13,40,28,2
22,178914,FLOUR BLUFF ISD,2,english,8,484,59,425,300,213,407,104,303,191,89
22,178915,WEST OSO ISD,2,english,8,168,46,122,75,52,142,57,85,37,7
22,179901,PERRYTON ISD,16,english,8,166,18,148,115,76,156,35,121,72,26
22,180901,BOYS RANCH ISD,16,english,8,18,4,14,10,5,18,5,13,10,3
22,180902,VEGA ISD,16,english,8,25,1,24,20,9,25,2,23,18,10
22,180903,ADRIAN ISD,16,english,8,13,0,13,10,3,13,6,7,0,0
22,180904,WILDORADO ISD,16,english,8,21,6,15,9,4,21,5,16,8,5
22,181901,BRIDGE CITY ISD,5,english,8,243,42,201,144,92,239,69,170,80,21
22,181905,ORANGEFIELD ISD,5,english,8,167,27,140,89,58,140,51,89,28,1
22,181906,WEST ORANGE-COV,5,english,8,167,33,134,73,33,151,45,106,44,10
22,181907,VIDOR ISD,5,english,8,305,81,224,145,84,258,88,170,56,6
22,181908,LITTLE CYPRESS-,5,english,8,254,52,202,122,68,249,75,174,84,26
22,182901,GORDON ISD,11,english,8,21,2,19,9,7,21,5,16,9,5
22,182902,GRAFORD ISD,11,english,8,27,7,20,11,5,27,13,14,3,1
22,182903,MINERAL WELLS I,11,english,8,205,44,161,80,45,240,60,180,78,13
22,182904,SANTO ISD,11,english,8,28,2,26,19,15,22,5,17,5,0
22,182905,STRAWN ISD,11,english,8,19,9,10,4,2,19,10,9,3,1
22,183801,PANOLA CHARTER,7,english,8,27,6,21,11,7,25,11,14,4,0
22,183901,BECKVILLE ISD,7,english,8,45,4,41,26,19,31,2,29,17,4
22,183902,CARTHAGE ISD,7,english,8,217,28,189,130,87,217,51,166,108,43
22,183904,GARY ISD,7,english,8,36,7,29,24,12,26,6,20,12,1
22,184901,POOLVILLE ISD,11,english,8,52,9,43,30,22,53,10,43,25,3
22,184902,SPRINGTOWN ISD,11,english,8,315,48,267,190,110,267,83,184,87,17
22,184903,WEATHERFORD ISD,11,english,8,627,107,520,364,239,413,147,266,106,19
22,184904,MILLSAP ISD,11,english,8,78,7,71,49,28,64,7,57,40,12
22,184907,ALEDO ISD,11,english,8,580,45,535,455,331,629,87,542,358,140
22,184908,PEASTER ISD,11,english,8,139,18,121,91,64,135,43,92,43,6
22,184909,BROCK ISD,11,english,8,168,10,158,126,81,146,13,133,78,12
22,184911,GARNER ISD,11,english,8,17,9,8,5,2,18,6,12,6,1
22,185901,BOVINA ISD,16,english,8,30,9,21,12,3,30,13,17,8,2
22,185902,FARWELL ISD,16,english,8,43,2,41,32,22,38,2,36,27,10
22,185903,FRIONA ISD,16,english,8,74,9,65,39,23,54,17,37,6,0
22,185904,LAZBUDDIE ISD,16,english,8,13,2,11,5,4,13,3,10,3,1
22,186901,BUENA VISTA ISD,18,english,8,20,4,16,10,6,20,5,15,10,4
22,186902,FORT STOCKTON I,18,english,8,190,59,131,77,43,190,66,124,70,21
22,186903,IRAAN-SHEFFIELD,18,english,8,33,3,30,22,15,33,14,19,3,0
22,187901,BIG SANDY ISD,6,english,8,36,6,30,21,12,36,7,29,16,3
22,187903,GOODRICH ISD,6,english,8,11,2,9,6,2,11,3,8,3,2
22,187904,CORRIGAN-CAMDEN,6,english,8,61,13,48,32,17,61,17,44,22,9
22,187906,LEGGETT ISD,6,english,8,13,4,9,6,2,13,7,6,3,1
22,187907,LIVINGSTON ISD,6,english,8,280,74,206,129,74,234,83,151,79,22
22,187910,ONALASKA ISD,6,english,8,90,10,80,47,21,83,12,71,37,7
22,188901,AMARILLO ISD,16,english,8,2298,421,1877,1253,779,2199,421,1778,1118,387
22,188902,RIVER ROAD ISD,16,english,8,101,15,86,59,31,106,22,84,42,8
22,188903,HIGHLAND PARK I,16,english,8,64,6,58,33,27,73,13,60,39,15
22,188904,BUSHLAND ISD,16,english,8,132,12,120,93,65,102,17,85,42,19
22,189901,MARFA ISD,18,english,8,15,1,14,9,5,18,3,15,11,6
22,189902,PRESIDIO ISD,18,english,8,88,29,59,42,21,88,21,67,47,19
22,190903,RAINS ISD,7,english,8,136,25,111,66,32,116,67,49,4,0
22,191901,CANYON ISD,16,english,8,863,83,780,594,408,604,82,522,304,83
22,192901,REAGAN COUNTY I,18,english,8,54,10,44,38,20,54,21,33,17,2
22,193801,BIG SPRINGS CHA,20,english,8,18,9,9,6,4,18,13,5,3,1
22,193902,LEAKEY ISD,20,english,8,29,5,24,15,10,16,8,8,4,2
22,194902,AVERY ISD,8,english,8,24,4,20,13,5,14,0,14,12,3
22,194903,RIVERCREST ISD,8,english,8,50,4,46,37,25,50,4,46,40,30
22,194904,CLARKSVILLE ISD,8,english,8,45,11,34,18,9,45,23,22,13,3
22,194905,DETROIT ISD,8,english,8,39,12,27,16,9,39,8,31,15,6
22,195901,PECOS-BARSTOW-T,18,english,8,221,48,173,96,42,201,41,160,85,17
22,195902,BALMORHEA ISD,18,english,8,24,2,22,15,8,24,8,16,5,1
22,196901,AUSTWELL-TIVOLI,3,english,8,12,3,9,4,1,12,5,7,1,1
22,196902,WOODSBORO ISD,3,english,8,37,3,34,24,16,37,13,24,12,4
22,196903,REFUGIO ISD,3,english,8,64,5,59,41,24,58,16,42,16,4
22,197902,MIAMI ISD,16,english,8,18,0,18,15,8,12,3,9,6,1
22,198901,BREMOND ISD,6,english,8,39,4,35,29,20,39,8,31,16,3
22,198902,CALVERT ISD,6,english,8,9,3,6,1,1,10,6,4,1,0
22,198903,FRANKLIN ISD,6,english,8,113,6,107,88,66,85,2,83,66,27
22,198905,HEARNE ISD,6,english,8,48,20,28,13,3,36,29,7,0,0
22,198906,MUMFORD ISD,6,english,8,42,3,39,37,28,21,2,19,17,1
22,199901,ROCKWALL ISD,10,english,8,1400,141,1259,954,648,1431,206,1225,837,360
22,199902,ROYSE CITY ISD,10,english,8,683,112,571,370,219,527,180,347,113,27
22,200901,BALLINGER ISD,15,english,8,68,12,56,30,21,68,29,39,19,3
22,200902,MILES ISD,15,english,8,43,5,38,31,20,43,4,39,33,16
22,200904,WINTERS ISD,15,english,8,45,4,41,25,17,45,18,27,14,4
22,200906,OLFEN ISD,15,english,8,11,5,6,3,2,11,3,8,4,1
22,201902,HENDERSON ISD,7,english,8,253,64,189,117,67,170,92,78,23,2
22,201903,LANEVILLE ISD,7,english,8,11,0,11,10,4,11,1,10,9,8
22,201904,LEVERETTS CHAPE,7,english,8,18,2,16,11,7,18,3,15,6,4
22,201907,MOUNT ENTERPRIS,7,english,8,43,8,35,17,8,37,17,20,4,0
22,201908,OVERTON ISD,7,english,8,46,6,40,25,13,39,15,24,7,0
22,201910,TATUM ISD,7,english,8,104,14,90,59,37,104,19,85,60,28
22,201913,CARLISLE ISD,7,english,8,55,9,46,26,15,54,16,38,15,1
22,201914,WEST RUSK COUNT,7,english,8,94,13,81,63,42,76,13,63,38,5
22,202903,HEMPHILL ISD,7,english,8,72,4,68,51,37,72,3,69,58,28
22,202905,WEST SABINE ISD,7,english,8,42,9,33,18,8,38,9,29,14,6
22,203901,SAN AUGUSTINE I,7,english,8,48,15,33,13,7,42,22,20,8,0
22,203902,BROADDUS ISD,7,english,8,20,5,15,6,4,20,4,16,12,4
22,204901,COLDSPRING-OAKH,6,english,8,134,34,100,67,38,112,54,58,10,0
22,204904,SHEPHERD ISD,6,english,8,165,33,132,81,51,143,38,105,55,13
22,205901,ARANSAS PASS IS,2,english,8,121,19,102,68,39,105,39,66,21,4
22,205902,GREGORY-PORTLAN,2,english,8,394,77,317,216,141,389,92,297,174,59
22,205903,INGLESIDE ISD,2,english,8,160,14,146,104,72,156,13,143,121,73
22,205904,MATHIS ISD,2,english,8,104,16,88,53,37,96,26,70,38,9
22,205905,ODEM-EDROY ISD,2,english,8,64,17,47,26,14,53,20,33,10,0
22,205906,SINTON ISD,2,english,8,142,32,110,69,32,138,43,95,54,16
22,205907,TAFT ISD,2,english,8,53,9,44,23,13,39,25,14,3,0
22,206901,SAN SABA ISD,15,english,8,53,5,48,24,15,46,8,38,19,10
22,206902,RICHLAND SPRING,15,english,8,10,1,9,5,3,10,3,7,3,1
22,206903,CHEROKEE ISD,15,english,8,11,3,8,8,5,11,4,7,0,0
22,207901,SCHLEICHER ISD,15,english,8,48,5,43,27,14,45,7,38,23,7
22,208901,HERMLEIGH ISD,14,english,8,15,6,9,7,3,15,10,5,0,0
22,208902,SNYDER ISD,14,english,8,174,48,126,72,41,172,53,119,58,14
22,208903,IRA ISD,14,english,8,20,0,20,15,7,20,1,19,13,5
22,209901,ALBANY ISD,14,english,8,41,9,32,20,11,34,13,21,11,0
22,209902,MORAN ISD,14,english,8,7,4,3,1,0,7,4,3,0,0
22,210901,CENTER ISD,7,english,8,174,28,146,95,54,175,15,160,111,28
22,210902,JOAQUIN ISD,7,english,8,59,4,55,40,24,59,5,54,36,10
22,210903,SHELBYVILLE ISD,7,english,8,59,10,49,29,18,59,12,47,27,15
22,210904,TENAHA ISD,7,english,8,28,5,23,16,9,21,2,19,6,1
22,210905,TIMPSON ISD,7,english,8,45,11,34,14,10,34,13,21,5,2
22,210906,EXCELSIOR ISD,7,english,8,8,1,7,4,2,8,4,4,3,2
22,211902,STRATFORD ISD,16,english,8,40,8,32,20,11,39,13,26,9,2
22,212801,CUMBERLAND ACAD,7,english,8,132,13,119,75,51,115,28,87,40,10
22,212804,UT TYLER UNIVER,7,english,8,64,1,63,56,45,12,3,9,4,0
22,212901,ARP ISD,7,english,8,83,12,71,47,27,85,18,67,46,9
22,212902,BULLARD ISD,7,english,8,219,11,208,165,120,151,32,119,75,33
22,212903,LINDALE ISD,7,english,8,324,22,302,255,197,249,16,233,209,140
22,212904,TROUP ISD,7,english,8,80,5,75,46,32,85,11,74,49,19
22,212905,TYLER ISD,7,english,8,1343,273,1070,716,432,1286,378,908,466,148
22,212906,WHITEHOUSE ISD,7,english,8,368,39,329,265,181,391,35,356,293,170
22,212909,CHAPEL HILL ISD,7,english,8,251,72,179,107,52,265,107,158,55,7
22,212910,WINONA ISD,7,english,8,71,10,61,41,24,57,15,42,24,6
22,213801,BRAZOS RIVER CH,11,english,8,15,5,10,2,1,15,11,4,1,0
22,213901,GLEN ROSE ISD,11,english,8,152,9,143,97,65,161,32,129,65,17
22,214901,RIO GRANDE CITY,1,english,8,668,173,495,289,166,562,258,304,109,25
22,214902,SAN ISIDRO ISD,1,english,8,16,2,14,7,2,16,4,12,4,0
22,214903,ROMA ISD,1,english,8,392,91,301,203,127,394,77,317,228,110
22,215901,BRECKENRIDGE IS,14,english,8,119,32,87,50,38,100,39,61,21,1
22,216901,STERLING CITY I,15,english,8,18,3,15,11,6,18,4,14,8,3
22,217901,ASPERMONT ISD,14,english,8,11,4,7,6,3,11,2,9,7,2
22,218901,SONORA ISD,15,english,8,48,6,42,27,14,46,13,33,11,2
22,219901,HAPPY ISD,16,english,8,17,0,17,15,10,17,0,17,14,7
22,219903,TULIA ISD,16,english,8,65,17,48,23,12,53,20,33,15,2
22,219905,KRESS ISD,16,english,8,33,7,26,19,9,33,16,17,5,1
22,220801,TREETOPS SCHOOL,11,english,8,23,1,22,21,16,23,2,21,15,6
22,220802,ARLINGTON CLASS,11,english,8,157,9,148,127,92,0,,,,
22,220809,FORT WORTH ACAD,11,english,8,83,7,76,66,46,73,13,60,31,10
22,220810,WESTLAKE ACADEM,11,english,8,74,0,74,71,59,72,7,65,49,27
22,220815,CHAPEL HILL ACA,11,english,8,44,3,41,25,19,44,18,26,10,4
22,220817,NEWMAN INTERNAT,11,english,8,233,18,215,151,103,228,62,166,76,12
22,220819,HIGH POINT ACAD,11,english,8,102,8,94,72,51,97,21,76,44,10
22,220901,ARLINGTON ISD,11,english,8,4288,994,3294,2173,1353,3339,1262,2077,871,220
22,220902,BIRDVILLE ISD,11,english,8,1747,335,1412,926,586,1216,402,814,431,155
22,220904,EVERMAN ISD,11,english,8,419,91,328,199,123,305,143,162,62,5
22,220905,FORT WORTH ISD,11,english,8,4410,1510,2900,1514,748,5752,2587,3165,1306,369
22,220906,GRAPEVINE-COLLE,11,english,8,1171,72,1099,932,717,1170,112,1058,824,415
22,220907,KELLER ISD,11,english,8,2103,290,1813,1241,747,2867,497,2370,1463,615
22,220908,MANSFIELD ISD,11,english,8,2955,398,2557,1807,1179,2216,642,1574,765,151
22,220910,LAKE WORTH ISD,11,english,8,275,98,177,96,53,287,173,114,25,3
22,220912,CROWLEY ISD,11,english,8,1290,300,990,604,362,1301,524,777,327,69
22,220914,KENNEDALE ISD,11,english,8,241,48,193,129,73,258,70,188,59,7
22,220915,AZLE ISD,11,english,8,526,73,453,304,182,494,122,372,206,75
22,220916,HURST-EULESS-BE,11,english,8,1708,186,1522,1150,766,1146,149,997,637,187
22,220917,CASTLEBERRY ISD,11,english,8,302,69,233,131,77,312,126,186,79,13
22,220918,EAGLE MT-SAGINA,11,english,8,1842,260,1582,1138,756,1830,471,1359,751,239
22,220919,CARROLL ISD,11,english,8,726,7,719,665,552,678,17,661,618,463
22,220920,WHITE SETTLEMEN,11,english,8,554,93,461,317,213,455,169,286,107,13
22,221801,TEXAS COLLEGE P,14,english,8,1055,128,927,667,436,733,225,508,250,76
22,221901,ABILENE ISD,14,english,8,1092,346,746,439,260,796,422,374,112,15
22,221904,MERKEL ISD,14,english,8,68,19,49,28,15,68,28,40,20,2
22,221905,TRENT ISD,14,english,8,12,3,9,3,3,11,4,7,3,0
22,221911,JIM NED CISD,14,english,8,113,9,104,84,60,80,11,69,51,18
22,221912,WYLIE ISD,14,english,8,418,23,395,327,235,336,33,303,216,74
22,222901,TERRELL COUNTY,18,english,8,7,0,7,5,4,7,4,3,1,0
22,223901,BROWNFIELD ISD,17,english,8,119,30,89,52,35,119,33,86,48,16
22,223902,MEADOW ISD,17,english,8,12,1,11,5,3,12,5,7,2,1
22,223904,WELLMAN-UNION C,17,english,8,21,1,20,14,7,21,4,17,8,3
22,224901,THROCKMORTON CO,9,english,8,9,5,4,0,0,9,5,4,0,0
22,224902,WOODSON ISD,9,english,8,13,2,11,8,8,12,1,11,8,5
22,225902,MOUNT PLEASANT,8,english,8,384,59,325,216,137,304,107,197,71,11
22,225906,CHAPEL HILL ISD,8,english,8,93,9,84,56,26,73,19,54,27,2
22,225907,HARTS BLUFF ISD,8,english,8,70,14,56,42,24,56,16,40,21,5
22,226801,TEXAS LEADERSHI,15,english,8,293,60,233,139,71,256,123,133,43,16
22,226901,CHRISTOVAL ISD,15,english,8,42,3,39,30,20,42,7,35,18,5
22,226903,SAN ANGELO ISD,15,english,8,1073,295,778,491,288,937,369,568,266,70
22,226905,WATER VALLEY IS,15,english,8,35,5,30,19,12,35,9,26,13,3
22,226906,WALL ISD,15,english,8,101,2,99,91,67,80,0,80,61,24
22,226907,GRAPE CREEK ISD,15,english,8,88,21,67,43,30,88,43,45,18,2
22,226908,VERIBEST ISD,15,english,8,21,1,20,18,14,21,1,20,14,7
22,227622,TEXAS JUVENILE,13,english,8,0,,,,,0,,,,
22,227803,WAYSIDE SCHOOLS,13,english,8,113,28,85,54,36,194,95,99,37,8
22,227804,NYOS CHARTER SC,13,english,8,79,9,70,56,38,83,14,69,37,8
22,227805,TEXAS EMPOWERME,13,english,8,34,2,32,21,10,0,,,,
22,227806,UNIVERSITY OF T,13,english,8,74,34,40,25,13,71,54,17,4,0
22,227814,CHAPARRAL STAR,13,english,8,34,0,34,29,22,29,1,28,22,13
22,227816,HARMONY PUBLIC,13,english,8,319,81,238,169,103,246,77,169,104,39
22,227817,CEDARS INTERNAT,13,english,8,32,2,30,23,13,16,2,14,8,1
22,227820,KIPP TEXAS PUBL,4,english,8,2366,446,1920,1316,829,15,2,13,13,8
22,227821,AUSTIN DISCOVER,13,english,8,18,0,18,14,9,17,5,12,4,1
22,227824,VALERE PUBLIC S,13,english,8,51,12,39,19,10,51,24,27,7,1
22,227825,AUSTIN ACHIEVE,13,english,8,156,54,102,53,28,7,7,0,0,0
22,227829,VALOR PUBLIC SC,13,english,8,107,9,98,79,57,58,11,47,24,13
22,227901,AUSTIN ISD,13,english,8,5049,1092,3957,2882,2043,5175,1672,3503,2066,833
22,227904,PFLUGERVILLE IS,13,english,8,1868,380,1488,1031,664,1848,616,1232,647,222
22,227905,TEXAS SCH FOR T,13,english,8,0,,,,,5,3,2,0,0
22,227906,TEXAS SCH FOR T,13,english,8,26,20,6,2,0,25,20,5,0,0
22,227907,MANOR ISD,13,english,8,687,236,451,247,137,662,370,292,93,18
22,227909,EANES ISD,13,english,8,673,15,658,579,455,700,34,666,541,314
22,227910,DEL VALLE ISD,13,english,8,926,281,645,399,238,908,410,498,214,69
22,227912,LAGO VISTA ISD,13,english,8,163,12,151,112,71,177,27,150,85,22
22,227913,LAKE TRAVIS ISD,13,english,8,922,55,867,705,506,1036,111,925,668,346
22,228901,GROVETON ISD,6,english,8,53,6,47,37,22,33,9,24,17,5
22,228903,TRINITY ISD,6,english,8,79,29,50,27,20,58,30,28,5,1
22,228904,CENTERVILLE ISD,6,english,8,9,0,9,7,4,9,0,9,6,1
22,228905,APPLE SPRINGS I,6,english,8,21,3,18,11,6,12,5,7,3,0
22,229901,COLMESNEIL ISD,5,english,8,23,4,19,12,7,15,5,10,4,0
22,229903,WOODVILLE ISD,5,english,8,105,25,80,53,31,105,35,70,33,8
22,229904,WARREN ISD,5,english,8,99,12,87,60,43,97,23,74,39,13
22,229905,SPURGER ISD,5,english,8,32,8,24,12,7,32,9,23,6,2
22,229906,CHESTER ISD,5,english,8,18,2,16,13,11,18,2,16,8,1
22,230901,BIG SANDY ISD,7,english,8,49,9,40,25,10,46,12,34,17,11
22,230902,GILMER ISD,7,english,8,199,28,171,117,69,171,39,132,60,13
22,230903,ORE CITY ISD,7,english,8,63,11,52,35,22,60,25,35,8,1
22,230904,UNION HILL ISD,7,english,8,29,3,26,15,8,29,9,20,8,2
22,230905,HARMONY ISD,7,english,8,73,6,67,54,37,73,10,63,47,25
22,230906,NEW DIANA ISD,7,english,8,97,5,92,67,45,76,17,59,24,2
22,230908,UNION GROVE ISD,7,english,8,61,7,54,43,26,61,4,57,39,25
22,231901,MCCAMEY ISD,18,english,8,40,7,33,18,13,43,6,37,15,5
22,231902,RANKIN ISD,18,english,8,23,5,18,13,6,23,2,21,17,9
22,232901,KNIPPA ISD,20,english,8,27,2,25,17,11,0,,,,
22,232902,SABINAL ISD,20,english,8,35,6,29,18,12,34,11,23,12,0
22,232903,UVALDE CISD,20,english,8,303,96,207,112,70,346,193,153,48,9
22,232904,UTOPIA ISD,20,english,8,23,5,18,18,12,0,,,,
22,233901,SAN FELIPE-DEL,15,english,8,615,185,430,236,122,608,196,412,187,37
22,233903,COMSTOCK ISD,15,english,8,20,1,19,15,9,21,5,16,7,2
22,234801,RANCH ACADEMY,7,english,8,0,,,,,0,,,,
22,234902,CANTON ISD,10,english,8,154,13,141,97,66,116,17,99,52,11
22,234903,EDGEWOOD ISD,7,english,8,78,7,71,49,31,75,15,60,32,6
22,234904,GRAND SALINE IS,7,english,8,84,11,73,40,27,59,17,42,11,0
22,234905,MARTINS MILL IS,7,english,8,38,8,30,20,14,20,6,14,10,2
22,234906,VAN ISD,7,english,8,211,26,185,130,88,174,59,115,63,14
22,234907,WILLS POINT ISD,10,english,8,215,50,165,101,55,217,69,148,74,19
22,234909,FRUITVALE ISD,7,english,8,31,6,25,14,11,28,14,14,6,0
22,235901,BLOOMINGTON ISD,3,english,8,75,20,55,34,15,75,44,31,12,2
22,235902,VICTORIA ISD,3,english,8,1043,269,774,503,311,938,467,471,200,56
22,236901,NEW WAVERLY ISD,6,english,8,80,15,65,54,37,74,22,52,27,10
22,236902,HUNTSVILLE ISD,6,english,8,1434,231,1203,825,523,1305,504,801,358,102
22,237902,HEMPSTEAD ISD,4,english,8,110,37,73,37,17,117,68,49,13,1
22,237904,WALLER ISD,4,english,8,684,141,543,360,218,508,193,315,110,9
22,237905,ROYAL ISD,4,english,8,224,57,167,93,49,164,61,103,46,7
22,238902,MONAHANS-WICKET,18,english,8,174,38,136,75,42,158,52,106,46,16
22,238904,GRANDFALLS-ROYA,18,english,8,15,8,7,1,0,15,10,5,1,0
22,239901,BRENHAM ISD,6,english,8,386,78,308,211,135,285,84,201,100,16
22,239903,BURTON ISD,6,english,8,33,3,30,16,11,20,8,12,5,0
22,240901,LAREDO ISD,1,english,8,1383,357,1026,659,390,1232,477,755,351,103
22,240903,UNITED ISD,1,english,8,3212,484,2728,1927,1270,2447,517,1930,1142,341
22,240904,WEBB CISD,1,english,8,21,3,18,12,7,21,2,19,10,3
22,241901,BOLING ISD,3,english,8,75,12,63,43,29,61,12,49,26,4
22,241902,EAST BERNARD IS,3,english,8,63,7,56,41,29,49,5,44,25,10
22,241903,EL CAMPO ISD,3,english,8,243,71,172,98,67,206,79,127,62,15
22,241904,WHARTON ISD,3,english,8,155,36,119,53,27,146,53,93,41,10
22,241906,LOUISE ISD,3,english,8,43,7,36,22,13,40,10,30,13,3
22,242902,SHAMROCK ISD,16,english,8,23,2,21,15,6,23,8,15,6,4
22,242903,WHEELER ISD,16,english,8,33,3,30,19,12,33,8,25,9,1
22,242905,KELTON ISD,16,english,8,14,2,12,5,2,14,5,9,5,4
22,242906,FORT ELLIOTT CI,16,english,8,13,1,12,10,6,13,0,13,9,3
22,243901,BURKBURNETT ISD,9,english,8,240,67,173,103,50,241,77,164,74,24
22,243902,ELECTRA ISD,9,english,8,27,2,25,13,4,27,6,21,9,3
22,243903,IOWA PARK CISD,9,english,8,160,12,148,107,73,160,22,138,89,28
22,243905,WICHITA FALLS I,9,english,8,917,262,655,401,226,721,295,426,166,32
22,243906,CITY VIEW ISD,9,english,8,104,23,81,53,38,104,27,77,32,15
22,244901,HARROLD ISD,9,english,8,12,0,12,7,6,12,0,12,7,2
22,244903,VERNON ISD,9,english,8,150,38,112,61,35,150,53,97,54,15
22,244905,NORTHSIDE ISD,9,english,8,22,2,20,10,8,22,4,18,5,4
22,245901,LASARA ISD,1,english,8,26,4,22,12,7,0,,,,
22,245902,LYFORD CISD,1,english,8,142,12,130,91,57,99,42,57,4,0
22,245903,RAYMONDVILLE IS,1,english,8,127,13,114,75,43,128,10,118,83,33
22,245904,SAN PERLITA ISD,1,english,8,18,1,17,7,4,18,2,16,8,1
22,246801,MERIDIAN WORLD,13,english,8,143,4,139,120,84,187,19,168,112,64
22,246802,GOODWATER MONTE,13,english,8,11,0,11,6,2,11,1,10,5,2
22,246902,FLORENCE ISD,13,english,8,99,25,74,48,18,84,39,45,23,12
22,246904,GEORGETOWN ISD,13,english,8,971,207,764,493,304,886,332,554,284,102
22,246905,GRANGER ISD,13,english,8,39,2,37,22,15,34,14,20,10,0
22,246906,HUTTO ISD,13,english,8,755,117,638,431,268,718,225,493,222,53
22,246907,JARRELL ISD,13,english,8,200,42,158,98,58,202,55,147,76,12
22,246908,LIBERTY HILL IS,13,english,8,541,72,469,326,213,546,110,436,236,70
22,246909,ROUND ROCK ISD,13,english,8,3615,406,3209,2605,1967,3723,713,3010,2200,1255
22,246911,TAYLOR ISD,13,english,8,209,59,150,86,54,179,96,83,33,4
22,246912,THRALL ISD,13,english,8,68,4,64,46,31,73,2,71,56,30
22,246913,LEANDER ISD,13,english,8,3349,404,2945,2222,1541,3491,552,2939,1910,808
22,246914,COUPLAND ISD,13,english,8,30,2,28,22,11,18,6,12,5,0
22,247901,FLORESVILLE ISD,20,english,8,296,60,236,159,105,274,87,187,93,24
22,247903,LA VERNIA ISD,20,english,8,228,29,199,136,92,144,27,117,49,5
22,247904,POTH ISD,20,english,8,75,4,71,60,47,58,7,51,44,21
22,247906,STOCKDALE ISD,20,english,8,66,7,59,38,24,66,12,54,34,12
22,248901,KERMIT ISD,18,english,8,102,23,79,52,27,102,33,69,37,19
22,248902,WINK-LOVING ISD,18,english,8,42,11,31,18,10,42,14,28,15,5
22,249901,ALVORD ISD,11,english,8,60,3,57,43,33,49,6,43,22,12
22,249902,BOYD ISD,11,english,8,94,9,85,56,37,77,16,61,23,2
22,249903,BRIDGEPORT ISD,11,english,8,164,37,127,88,59,117,13,104,68,15
22,249904,CHICO ISD,11,english,8,43,13,30,18,11,33,11,22,5,0
22,249905,DECATUR ISD,11,english,8,307,59,248,178,113,288,90,198,74,12
22,249906,PARADISE ISD,11,english,8,98,4,94,70,49,90,9,81,38,8
22,249908,SLIDELL ISD,11,english,8,36,5,31,18,10,20,3,17,3,0
22,250902,HAWKINS ISD,7,english,8,64,7,57,43,24,47,14,33,15,0
22,250903,MINEOLA ISD,7,english,8,115,12,103,80,49,92,9,83,53,11
22,250904,QUITMAN ISD,7,english,8,77,11,66,41,22,75,19,56,36,11
22,250905,YANTIS ISD,7,english,8,35,5,30,22,12,27,10,17,6,1
22,250906,ALBA-GOLDEN ISD,7,english,8,60,7,53,33,15,58,13,45,19,3
22,250907,WINNSBORO ISD,7,english,8,124,20,104,72,50,124,19,105,74,23
22,251901,DENVER CITY ISD,17,english,8,135,18,117,93,52,135,34,101,61,26
22,251902,PLAINS ISD,17,english,8,30,8,22,15,8,30,8,22,9,3
22,252901,GRAHAM ISD,9,english,8,165,29,136,94,54,137,36,101,44,4
22,252902,NEWCASTLE ISD,9,english,8,22,4,18,11,7,18,3,15,13,4
22,252903,OLNEY ISD,9,english,8,55,7,48,39,30,55,4,51,45,26
22,253901,ZAPATA COUNTY I,1,english,8,276,88,188,110,63,275,116,159,74,17
22,254901,CRYSTAL CITY IS,20,english,8,130,34,96,54,28,109,53,56,14,0
22,254902,LA PRYOR ISD,20,english,8,27,7,20,16,8,28,8,20,13,4
